ADM0_EN,ADM0_SW,ADM0_PCODE,ADM1_EN,ADM1_PCODE,ADM2_EN,ADM2_PCODE,ADM3_EN,ADM3_PCODE,TOTAL_BOTH,TOTAL_MALE,TOTAL_FEMA,RURAL_BOTH,RURAL_MALE,URBAN_BOTH,URBAN_MALE,URBAN_FEMA,RURAL_FEMA
United Republic of Tanzania,Jamhuri ya Muungano wa Tanzania,TZ,Dodoma,TZ01,Kondoa,TZ0101,Bumbuta,TZ0101011,8602 ,4433 ,4169 ,8602 ,4433 ,0 ,0 ,0 ,4169 
United Republic of Tanzania,Jamhuri ya Muungano wa Tanzania,TZ,Dodoma,TZ01,Kondoa,TZ0101,Pahi,TZ0101021,13944 ,7082 ,6862 ,13944 ,7082 ,0 ,0 ,0 ,6862 
United Republic of Tanzania,Jamhuri ya Muungano wa Tanzania,TZ,Dodoma,TZ01,Kondoa,TZ0101,Busi,TZ0101031,18724 ,9416 ,9308 ,18724 ,9416 ,0 ,0 ,0 ,9308 
United Republic of Tanzania,Jamhuri ya Muungano wa Tanzania,TZ,Dodoma,TZ01,Kondoa,TZ0101,Haubi,TZ0101041,13757 ,7027 ,6730 ,13757 ,7027 ,0 ,0 ,0 ,6730 
United Republic of Tanzania,Jamhuri ya Muungano wa Tanzania,TZ,Dodoma,TZ01,Kondoa,TZ0101,Kalamba,TZ0101051,13988 ,7023 ,6965 ,13988 ,7023 ,0 ,0 ,0 ,6965 
United Republic of Tanzania,Jamhuri ya Muungano wa Tanzania,TZ,Dodoma,TZ01,Kondoa,TZ0101,Kwadelo,TZ0101061,11593 ,5801 ,5792 ,11593 ,5801 ,0 ,0 ,0 ,5792 
United Republic of Tanzania,Jamhuri ya Muungano wa Tanzania,TZ,Dodoma,TZ01,Kondoa,TZ0101,Masange,TZ0101071,5388 ,2665 ,2723 ,5388 ,2665 ,0 ,0 ,0 ,2723 
United Republic of Tanzania,Jamhuri ya Muungano wa Tanzania,TZ,Dodoma,TZ01,Kondoa,TZ0101,Kikilo,TZ0101081,9318 ,4667 ,4651 ,9318 ,4667 ,0 ,0 ,0 ,4651 
United Republic of Tanzania,Jamhuri ya Muungano wa Tanzania,TZ,Dodoma,TZ01,Kondoa,TZ0101,Bereko,TZ0101091,7226 ,3655 ,3571 ,7226 ,3655 ,0 ,0 ,0 ,3571 
United Republic of Tanzania,Jamhuri ya Muungano wa Tanzania,TZ,Dodoma,TZ01,Kondoa,TZ0101,Kisese,TZ0101101,12989 ,6631 ,6358 ,12989 ,6631 ,0 ,0 ,0 ,6358 
United Republic of Tanzania,Jamhuri ya Muungano wa Tanzania,TZ,Dodoma,TZ01,Kondoa,TZ0101,Kikore,TZ0101111,13044 ,6724 ,6320 ,13044 ,6724 ,0 ,0 ,0 ,6320 
United Republic of Tanzania,Jamhuri ya Muungano wa Tanzania,TZ,Dodoma,TZ01,Kondoa,TZ0101,Serya,TZ0101121,6054 ,3188 ,2866 ,6054 ,3188 ,0 ,0 ,0 ,2866 
United Republic of Tanzania,Jamhuri ya Muungano wa Tanzania,TZ,Dodoma,TZ01,Kondoa,TZ0101,Kilimani,TZ0101133,7237 ,3503 ,3734 ,2150 ,1044 ,5087 ,2459 ,2628 ,1106 
United Republic of Tanzania,Jamhuri ya Muungano wa Tanzania,TZ,Dodoma,TZ01,Kondoa,TZ0101,Chemchem,TZ0101142,7914 ,3797 ,4117 ,0 ,0 ,7914 ,3797 ,4117 ,0 
United Republic of Tanzania,Jamhuri ya Muungano wa Tanzania,TZ,Dodoma,TZ01,Kondoa,TZ0101,Hondo mairo,TZ0101151,8114 ,4221 ,3893 ,8114 ,4221 ,0 ,0 ,0 ,3893 
United Republic of Tanzania,Jamhuri ya Muungano wa Tanzania,TZ,Dodoma,TZ01,Kondoa,TZ0101,Bolisa,TZ0101161,3644 ,1812 ,1832 ,3644 ,1812 ,0 ,0 ,0 ,1832 
United Republic of Tanzania,Jamhuri ya Muungano wa Tanzania,TZ,Dodoma,TZ01,Kondoa,TZ0101,Kinyasi,TZ0101171,8816 ,4508 ,4308 ,8816 ,4508 ,0 ,0 ,0 ,4308 
United Republic of Tanzania,Jamhuri ya Muungano wa Tanzania,TZ,Dodoma,TZ01,Kondoa,TZ0101,Salanka,TZ0101181,8632 ,4335 ,4297 ,8632 ,4335 ,0 ,0 ,0 ,4297 
United Republic of Tanzania,Jamhuri ya Muungano wa Tanzania,TZ,Dodoma,TZ01,Kondoa,TZ0101,Itololo,TZ0101191,7196 ,3717 ,3479 ,7196 ,3717 ,0 ,0 ,0 ,3479 
United Republic of Tanzania,Jamhuri ya Muungano wa Tanzania,TZ,Dodoma,TZ01,Kondoa,TZ0101,Itaswi,TZ0101201,9774 ,5159 ,4615 ,9774 ,5159 ,0 ,0 ,0 ,4615 
United Republic of Tanzania,Jamhuri ya Muungano wa Tanzania,TZ,Dodoma,TZ01,Kondoa,TZ0101,Suruke,TZ0101211,3545 ,1841 ,1704 ,3545 ,1841 ,0 ,0 ,0 ,1704 
United Republic of Tanzania,Jamhuri ya Muungano wa Tanzania,TZ,Dodoma,TZ01,Kondoa,TZ0101,Kingale,TZ0101221,11003 ,5602 ,5401 ,11003 ,5602 ,0 ,0 ,0 ,5401 
United Republic of Tanzania,Jamhuri ya Muungano wa Tanzania,TZ,Dodoma,TZ01,Kondoa,TZ0101,Kondoa mjini,TZ0101232,14382 ,6744 ,7638 ,0 ,0 ,14382 ,6744 ,7638 ,0 
United Republic of Tanzania,Jamhuri ya Muungano wa Tanzania,TZ,Dodoma,TZ01,Kondoa,TZ0101,Kolo,TZ0101241,5243 ,2690 ,2553 ,5243 ,2690 ,0 ,0 ,0 ,2553 
United Republic of Tanzania,Jamhuri ya Muungano wa Tanzania,TZ,Dodoma,TZ01,Kondoa,TZ0101,Changaa,TZ0101251,9634 ,5095 ,4539 ,9634 ,5095 ,0 ,0 ,0 ,4539 
United Republic of Tanzania,Jamhuri ya Muungano wa Tanzania,TZ,Dodoma,TZ01,Kondoa,TZ0101,Thawi,TZ0101261,10799 ,5449 ,5350 ,10799 ,5449 ,0 ,0 ,0 ,5350 
United Republic of Tanzania,Jamhuri ya Muungano wa Tanzania,TZ,Dodoma,TZ01,Kondoa,TZ0101,Mnenia,TZ0101271,11528 ,5905 ,5623 ,11528 ,5905 ,0 ,0 ,0 ,5623 
United Republic of Tanzania,Jamhuri ya Muungano wa Tanzania,TZ,Dodoma,TZ01,Kondoa,TZ0101,Soera,TZ0101281,7616 ,3828 ,3788 ,7616 ,3828 ,0 ,0 ,0 ,3788 
United Republic of Tanzania,Jamhuri ya Muungano wa Tanzania,TZ,Dodoma,TZ01,Mpwapwa,TZ0102,Mazae,TZ0102011,8021 ,3908 ,4113 ,8021 ,3908 ,0 ,0 ,0 ,4113 
United Republic of Tanzania,Jamhuri ya Muungano wa Tanzania,TZ,Dodoma,TZ01,Mpwapwa,TZ0102,Vingh'awe,TZ0102023,12277 ,5812 ,6465 ,6557 ,3183 ,5720 ,2629 ,3091 ,3374 
United Republic of Tanzania,Jamhuri ya Muungano wa Tanzania,TZ,Dodoma,TZ01,Mpwapwa,TZ0102,Matomondo,TZ0102031,17131 ,8355 ,8776 ,17131 ,8355 ,0 ,0 ,0 ,8776 
United Republic of Tanzania,Jamhuri ya Muungano wa Tanzania,TZ,Dodoma,TZ01,Mpwapwa,TZ0102,Kimagai,TZ0102041,7340 ,3570 ,3770 ,7340 ,3570 ,0 ,0 ,0 ,3770 
United Republic of Tanzania,Jamhuri ya Muungano wa Tanzania,TZ,Dodoma,TZ01,Mpwapwa,TZ0102,Kibakwe,TZ0102053,16705 ,8115 ,8590 ,11557 ,5615 ,5148 ,2500 ,2648 ,5942 
United Republic of Tanzania,Jamhuri ya Muungano wa Tanzania,TZ,Dodoma,TZ01,Mpwapwa,TZ0102,Lumuma,TZ0102061,3783 ,1874 ,1909 ,3783 ,1874 ,0 ,0 ,0 ,1909 
United Republic of Tanzania,Jamhuri ya Muungano wa Tanzania,TZ,Dodoma,TZ01,Mpwapwa,TZ0102,Luhundwa,TZ0102071,12161 ,5904 ,6257 ,12161 ,5904 ,0 ,0 ,0 ,6257 
United Republic of Tanzania,Jamhuri ya Muungano wa Tanzania,TZ,Dodoma,TZ01,Mpwapwa,TZ0102,Massa,TZ0102081,12561 ,6083 ,6478 ,12561 ,6083 ,0 ,0 ,0 ,6478 
United Republic of Tanzania,Jamhuri ya Muungano wa Tanzania,TZ,Dodoma,TZ01,Mpwapwa,TZ0102,Ipera,TZ0102091,12870 ,6304 ,6566 ,12870 ,6304 ,0 ,0 ,0 ,6566 
United Republic of Tanzania,Jamhuri ya Muungano wa Tanzania,TZ,Dodoma,TZ01,Mpwapwa,TZ0102,Rudi,TZ0102101,10029 ,4739 ,5290 ,10029 ,4739 ,0 ,0 ,0 ,5290 
United Republic of Tanzania,Jamhuri ya Muungano wa Tanzania,TZ,Dodoma,TZ01,Mpwapwa,TZ0102,Mlunduzi,TZ0102111,9668 ,4602 ,5066 ,9668 ,4602 ,0 ,0 ,0 ,5066 
United Republic of Tanzania,Jamhuri ya Muungano wa Tanzania,TZ,Dodoma,TZ01,Mpwapwa,TZ0102,Wotta,TZ0102121,13340 ,6359 ,6981 ,13340 ,6359 ,0 ,0 ,0 ,6981 
United Republic of Tanzania,Jamhuri ya Muungano wa Tanzania,TZ,Dodoma,TZ01,Mpwapwa,TZ0102,Mima,TZ0102131,14435 ,6926 ,7509 ,14435 ,6926 ,0 ,0 ,0 ,7509 
United Republic of Tanzania,Jamhuri ya Muungano wa Tanzania,TZ,Dodoma,TZ01,Mpwapwa,TZ0102,Berege,TZ0102141,10931 ,5373 ,5558 ,10931 ,5373 ,0 ,0 ,0 ,5558 
United Republic of Tanzania,Jamhuri ya Muungano wa Tanzania,TZ,Dodoma,TZ01,Mpwapwa,TZ0102,Chunyu,TZ0102151,11593 ,5458 ,6135 ,11593 ,5458 ,0 ,0 ,0 ,6135 
United Republic of Tanzania,Jamhuri ya Muungano wa Tanzania,TZ,Dodoma,TZ01,Mpwapwa,TZ0102,Mbuga,TZ0102161,5813 ,2924 ,2889 ,5813 ,2924 ,0 ,0 ,0 ,2889 
United Republic of Tanzania,Jamhuri ya Muungano wa Tanzania,TZ,Dodoma,TZ01,Mpwapwa,TZ0102,Godegode,TZ0102171,7884 ,3899 ,3985 ,7884 ,3899 ,0 ,0 ,0 ,3985 
United Republic of Tanzania,Jamhuri ya Muungano wa Tanzania,TZ,Dodoma,TZ01,Mpwapwa,TZ0102,Mpwapwa,TZ0102183,21337 ,10147 ,11190 ,5604 ,2726 ,15733 ,7421 ,8312 ,2878 
United Republic of Tanzania,Jamhuri ya Muungano wa Tanzania,TZ,Dodoma,TZ01,Mpwapwa,TZ0102,Lupeta,TZ0102191,8477 ,4081 ,4396 ,8477 ,4081 ,0 ,0 ,0 ,4396 
United Republic of Tanzania,Jamhuri ya Muungano wa Tanzania,TZ,Dodoma,TZ01,Mpwapwa,TZ0102,Gulwe,TZ0102201,10385 ,5059 ,5326 ,10385 ,5059 ,0 ,0 ,0 ,5326 
United Republic of Tanzania,Jamhuri ya Muungano wa Tanzania,TZ,Dodoma,TZ01,Mpwapwa,TZ0102,Nghambi,TZ0102211,8377 ,3987 ,4390 ,8377 ,3987 ,0 ,0 ,0 ,4390 
United Republic of Tanzania,Jamhuri ya Muungano wa Tanzania,TZ,Dodoma,TZ01,Mpwapwa,TZ0102,Chitemo,TZ0102221,7782 ,3765 ,4017 ,7782 ,3765 ,0 ,0 ,0 ,4017 
United Republic of Tanzania,Jamhuri ya Muungano wa Tanzania,TZ,Dodoma,TZ01,Mpwapwa,TZ0102,Iwondo,TZ0102231,7700 ,3651 ,4049 ,7700 ,3651 ,0 ,0 ,0 ,4049 
United Republic of Tanzania,Jamhuri ya Muungano wa Tanzania,TZ,Dodoma,TZ01,Mpwapwa,TZ0102,Kingiti,TZ0102241,7024 ,3410 ,3614 ,7024 ,3410 ,0 ,0 ,0 ,3614 
United Republic of Tanzania,Jamhuri ya Muungano wa Tanzania,TZ,Dodoma,TZ01,Mpwapwa,TZ0102,Lufu,TZ0102251,4937 ,2401 ,2536 ,4937 ,2401 ,0 ,0 ,0 ,2536 
United Republic of Tanzania,Jamhuri ya Muungano wa Tanzania,TZ,Dodoma,TZ01,Mpwapwa,TZ0102,Pwaga,TZ0102261,11217 ,5353 ,5864 ,11217 ,5353 ,0 ,0 ,0 ,5864 
United Republic of Tanzania,Jamhuri ya Muungano wa Tanzania,TZ,Dodoma,TZ01,Mpwapwa,TZ0102,Galigali,TZ0102271,4356 ,2145 ,2211 ,4356 ,2145 ,0 ,0 ,0 ,2211 
United Republic of Tanzania,Jamhuri ya Muungano wa Tanzania,TZ,Dodoma,TZ01,Mpwapwa,TZ0102,Mtera,TZ0102281,10934 ,5434 ,5500 ,10934 ,5434 ,0 ,0 ,0 ,5500 
United Republic of Tanzania,Jamhuri ya Muungano wa Tanzania,TZ,Dodoma,TZ01,Mpwapwa,TZ0102,Chipogoro,TZ0102291,10682 ,5076 ,5606 ,10682 ,5076 ,0 ,0 ,0 ,5606 
United Republic of Tanzania,Jamhuri ya Muungano wa Tanzania,TZ,Dodoma,TZ01,Mpwapwa,TZ0102,Malolo,TZ0102301,5306 ,2592 ,2714 ,5306 ,2592 ,0 ,0 ,0 ,2714 
United Republic of Tanzania,Jamhuri ya Muungano wa Tanzania,TZ,Dodoma,TZ01,Kongwa,TZ0103,Kongwa,TZ0103013,13531 ,6513 ,7018 ,3518 ,1713 ,10013 ,4800 ,5213 ,1805 
United Republic of Tanzania,Jamhuri ya Muungano wa Tanzania,TZ,Dodoma,TZ01,Kongwa,TZ0103,Sejeli,TZ0103021,19097 ,9315 ,9782 ,19097 ,9315 ,0 ,0 ,0 ,9782 
United Republic of Tanzania,Jamhuri ya Muungano wa Tanzania,TZ,Dodoma,TZ01,Kongwa,TZ0103,Hogoro,TZ0103031,17129 ,8374 ,8755 ,17129 ,8374 ,0 ,0 ,0 ,8755 
United Republic of Tanzania,Jamhuri ya Muungano wa Tanzania,TZ,Dodoma,TZ01,Kongwa,TZ0103,Zoissa,TZ0103041,6105 ,2981 ,3124 ,6105 ,2981 ,0 ,0 ,0 ,3124 
United Republic of Tanzania,Jamhuri ya Muungano wa Tanzania,TZ,Dodoma,TZ01,Kongwa,TZ0103,Mkoka,TZ0103051,11925 ,5766 ,6159 ,11925 ,5766 ,0 ,0 ,0 ,6159 
United Republic of Tanzania,Jamhuri ya Muungano wa Tanzania,TZ,Dodoma,TZ01,Kongwa,TZ0103,Njoge,TZ0103061,10063 ,4874 ,5189 ,10063 ,4874 ,0 ,0 ,0 ,5189 
United Republic of Tanzania,Jamhuri ya Muungano wa Tanzania,TZ,Dodoma,TZ01,Kongwa,TZ0103,Mtanana,TZ0103071,12559 ,6113 ,6446 ,12559 ,6113 ,0 ,0 ,0 ,6446 
United Republic of Tanzania,Jamhuri ya Muungano wa Tanzania,TZ,Dodoma,TZ01,Kongwa,TZ0103,Pandambili,TZ0103081,8004 ,3848 ,4156 ,8004 ,3848 ,0 ,0 ,0 ,4156 
United Republic of Tanzania,Jamhuri ya Muungano wa Tanzania,TZ,Dodoma,TZ01,Kongwa,TZ0103,Mlali,TZ0103091,19623 ,9305 ,10318 ,19623 ,9305 ,0 ,0 ,0 ,10318 
United Republic of Tanzania,Jamhuri ya Muungano wa Tanzania,TZ,Dodoma,TZ01,Kongwa,TZ0103,Iduo,TZ0103101,11197 ,5424 ,5773 ,11197 ,5424 ,0 ,0 ,0 ,5773 
United Republic of Tanzania,Jamhuri ya Muungano wa Tanzania,TZ,Dodoma,TZ01,Kongwa,TZ0103,Sagara,TZ0103111,22066 ,10505 ,11561 ,22066 ,10505 ,0 ,0 ,0 ,11561 
United Republic of Tanzania,Jamhuri ya Muungano wa Tanzania,TZ,Dodoma,TZ01,Kongwa,TZ0103,Kibaigwa,TZ0103123,24761 ,11808 ,12953 ,7128 ,3391 ,17633 ,8417 ,9216 ,3737 
United Republic of Tanzania,Jamhuri ya Muungano wa Tanzania,TZ,Dodoma,TZ01,Kongwa,TZ0103,Ugogoni,TZ0103133,17048 ,8059 ,8989 ,14682 ,6949 ,2366 ,1110 ,1256 ,7733 
United Republic of Tanzania,Jamhuri ya Muungano wa Tanzania,TZ,Dodoma,TZ01,Kongwa,TZ0103,Chamkoroma,TZ0103141,14675 ,7286 ,7389 ,14675 ,7286 ,0 ,0 ,0 ,7389 
United Republic of Tanzania,Jamhuri ya Muungano wa Tanzania,TZ,Dodoma,TZ01,Kongwa,TZ0103,Makawa,TZ0103151,8622 ,4198 ,4424 ,8622 ,4198 ,0 ,0 ,0 ,4424 
United Republic of Tanzania,Jamhuri ya Muungano wa Tanzania,TZ,Dodoma,TZ01,Kongwa,TZ0103,Chitego,TZ0103161,9799 ,4698 ,5101 ,9799 ,4698 ,0 ,0 ,0 ,5101 
United Republic of Tanzania,Jamhuri ya Muungano wa Tanzania,TZ,Dodoma,TZ01,Kongwa,TZ0103,Matongoro,TZ0103171,10095 ,4900 ,5195 ,10095 ,4900 ,0 ,0 ,0 ,5195 
United Republic of Tanzania,Jamhuri ya Muungano wa Tanzania,TZ,Dodoma,TZ01,Kongwa,TZ0103,Ngomai,TZ0103181,10534 ,5105 ,5429 ,10534 ,5105 ,0 ,0 ,0 ,5429 
United Republic of Tanzania,Jamhuri ya Muungano wa Tanzania,TZ,Dodoma,TZ01,Kongwa,TZ0103,Songambele,TZ0103191,17712 ,8405 ,9307 ,17712 ,8405 ,0 ,0 ,0 ,9307 
United Republic of Tanzania,Jamhuri ya Muungano wa Tanzania,TZ,Dodoma,TZ01,Kongwa,TZ0103,Chiwe,TZ0103201,19479 ,9287 ,10192 ,19479 ,9287 ,0 ,0 ,0 ,10192 
United Republic of Tanzania,Jamhuri ya Muungano wa Tanzania,TZ,Dodoma,TZ01,Kongwa,TZ0103,Lenjulu,TZ0103211,14440 ,6938 ,7502 ,14440 ,6938 ,0 ,0 ,0 ,7502 
United Republic of Tanzania,Jamhuri ya Muungano wa Tanzania,TZ,Dodoma,TZ01,Kongwa,TZ0103,Nghumbi,TZ0103221,11509 ,5519 ,5990 ,11509 ,5519 ,0 ,0 ,0 ,5990 
United Republic of Tanzania,Jamhuri ya Muungano wa Tanzania,TZ,Dodoma,TZ01,Chamwino,TZ0104,Haneti,TZ0104011,13128 ,6454 ,6674 ,13128 ,6454 ,0 ,0 ,0 ,6674 
United Republic of Tanzania,Jamhuri ya Muungano wa Tanzania,TZ,Dodoma,TZ01,Chamwino,TZ0104,Segala,TZ0104021,12791 ,6544 ,6247 ,12791 ,6544 ,0 ,0 ,0 ,6247 
United Republic of Tanzania,Jamhuri ya Muungano wa Tanzania,TZ,Dodoma,TZ01,Chamwino,TZ0104,Itiso,TZ0104031,12636 ,6293 ,6343 ,12636 ,6293 ,0 ,0 ,0 ,6343 
United Republic of Tanzania,Jamhuri ya Muungano wa Tanzania,TZ,Dodoma,TZ01,Chamwino,TZ0104,Dabalo,TZ0104041,16115 ,8003 ,8112 ,16115 ,8003 ,0 ,0 ,0 ,8112 
United Republic of Tanzania,Jamhuri ya Muungano wa Tanzania,TZ,Dodoma,TZ01,Chamwino,TZ0104,Membe,TZ0104051,8726 ,4300 ,4426 ,8726 ,4300 ,0 ,0 ,0 ,4426 
United Republic of Tanzania,Jamhuri ya Muungano wa Tanzania,TZ,Dodoma,TZ01,Chamwino,TZ0104,Msanga,TZ0104061,9663 ,4642 ,5021 ,9663 ,4642 ,0 ,0 ,0 ,5021 
United Republic of Tanzania,Jamhuri ya Muungano wa Tanzania,TZ,Dodoma,TZ01,Chamwino,TZ0104,Chilonwa,TZ0104071,7907 ,3852 ,4055 ,7907 ,3852 ,0 ,0 ,0 ,4055 
United Republic of Tanzania,Jamhuri ya Muungano wa Tanzania,TZ,Dodoma,TZ01,Chamwino,TZ0104,Buigiri,TZ0104083,16821 ,7934 ,8887 ,8329 ,3925 ,8492 ,4009 ,4483 ,4404 
United Republic of Tanzania,Jamhuri ya Muungano wa Tanzania,TZ,Dodoma,TZ01,Chamwino,TZ0104,Majeleko,TZ0104091,6886 ,3284 ,3602 ,6886 ,3284 ,0 ,0 ,0 ,3602 
United Republic of Tanzania,Jamhuri ya Muungano wa Tanzania,TZ,Dodoma,TZ01,Chamwino,TZ0104,Manchali,TZ0104101,10485 ,4993 ,5492 ,10485 ,4993 ,0 ,0 ,0 ,5492 
United Republic of Tanzania,Jamhuri ya Muungano wa Tanzania,TZ,Dodoma,TZ01,Chamwino,TZ0104,Ikowa,TZ0104111,6325 ,3000 ,3325 ,6325 ,3000 ,0 ,0 ,0 ,3325 
United Republic of Tanzania,Jamhuri ya Muungano wa Tanzania,TZ,Dodoma,TZ01,Chamwino,TZ0104,Msamalo,TZ0104121,14142 ,6683 ,7459 ,14142 ,6683 ,0 ,0 ,0 ,7459 
United Republic of Tanzania,Jamhuri ya Muungano wa Tanzania,TZ,Dodoma,TZ01,Chamwino,TZ0104,Igandu,TZ0104131,14880 ,6939 ,7941 ,14880 ,6939 ,0 ,0 ,0 ,7941 
United Republic of Tanzania,Jamhuri ya Muungano wa Tanzania,TZ,Dodoma,TZ01,Chamwino,TZ0104,Muungano,TZ0104141,10745 ,5084 ,5661 ,10745 ,5084 ,0 ,0 ,0 ,5661 
United Republic of Tanzania,Jamhuri ya Muungano wa Tanzania,TZ,Dodoma,TZ01,Chamwino,TZ0104,Mvumi Makulu,TZ0104151,7460 ,3410 ,4050 ,7460 ,3410 ,0 ,0 ,0 ,4050 
United Republic of Tanzania,Jamhuri ya Muungano wa Tanzania,TZ,Dodoma,TZ01,Chamwino,TZ0104,Handali,TZ0104161,9854 ,4679 ,5175 ,9854 ,4679 ,0 ,0 ,0 ,5175 
United Republic of Tanzania,Jamhuri ya Muungano wa Tanzania,TZ,Dodoma,TZ01,Chamwino,TZ0104,Mvumi Mission,TZ0104173,16514 ,7748 ,8766 ,5983 ,2841 ,10531 ,4907 ,5624 ,3142 
United Republic of Tanzania,Jamhuri ya Muungano wa Tanzania,TZ,Dodoma,TZ01,Chamwino,TZ0104,Idifu,TZ0104181,9609 ,4584 ,5025 ,9609 ,4584 ,0 ,0 ,0 ,5025 
United Republic of Tanzania,Jamhuri ya Muungano wa Tanzania,TZ,Dodoma,TZ01,Chamwino,TZ0104,Makang'wa,TZ0104191,20337 ,9494 ,10843 ,20337 ,9494 ,0 ,0 ,0 ,10843 
United Republic of Tanzania,Jamhuri ya Muungano wa Tanzania,TZ,Dodoma,TZ01,Chamwino,TZ0104,Iringamvumi,TZ0104201,11313 ,5415 ,5898 ,11313 ,5415 ,0 ,0 ,0 ,5898 
United Republic of Tanzania,Jamhuri ya Muungano wa Tanzania,TZ,Dodoma,TZ01,Chamwino,TZ0104,Manzase,TZ0104211,11485 ,5478 ,6007 ,11485 ,5478 ,0 ,0 ,0 ,6007 
United Republic of Tanzania,Jamhuri ya Muungano wa Tanzania,TZ,Dodoma,TZ01,Chamwino,TZ0104,Fufu,TZ0104221,3469 ,1668 ,1801 ,3469 ,1668 ,0 ,0 ,0 ,1801 
United Republic of Tanzania,Jamhuri ya Muungano wa Tanzania,TZ,Dodoma,TZ01,Chamwino,TZ0104,Mlowa Bwawani,TZ0104231,9031 ,4291 ,4740 ,9031 ,4291 ,0 ,0 ,0 ,4740 
United Republic of Tanzania,Jamhuri ya Muungano wa Tanzania,TZ,Dodoma,TZ01,Chamwino,TZ0104,Mpwayungu,TZ0104241,12634 ,6091 ,6543 ,12634 ,6091 ,0 ,0 ,0 ,6543 
United Republic of Tanzania,Jamhuri ya Muungano wa Tanzania,TZ,Dodoma,TZ01,Chamwino,TZ0104,Nghambaku,TZ0104251,7339 ,3657 ,3682 ,7339 ,3657 ,0 ,0 ,0 ,3682 
United Republic of Tanzania,Jamhuri ya Muungano wa Tanzania,TZ,Dodoma,TZ01,Chamwino,TZ0104,Chinugulu,TZ0104261,5216 ,2553 ,2663 ,5216 ,2553 ,0 ,0 ,0 ,2663 
United Republic of Tanzania,Jamhuri ya Muungano wa Tanzania,TZ,Dodoma,TZ01,Chamwino,TZ0104,Manda,TZ0104271,9874 ,4762 ,5112 ,9874 ,4762 ,0 ,0 ,0 ,5112 
United Republic of Tanzania,Jamhuri ya Muungano wa Tanzania,TZ,Dodoma,TZ01,Chamwino,TZ0104,Huzi,TZ0104281,7589 ,3653 ,3936 ,7589 ,3653 ,0 ,0 ,0 ,3936 
United Republic of Tanzania,Jamhuri ya Muungano wa Tanzania,TZ,Dodoma,TZ01,Chamwino,TZ0104,Loje,TZ0104291,5134 ,2493 ,2641 ,5134 ,2493 ,0 ,0 ,0 ,2641 
United Republic of Tanzania,Jamhuri ya Muungano wa Tanzania,TZ,Dodoma,TZ01,Chamwino,TZ0104,Chiboli,TZ0104301,4679 ,2306 ,2373 ,4679 ,2306 ,0 ,0 ,0 ,2373 
United Republic of Tanzania,Jamhuri ya Muungano wa Tanzania,TZ,Dodoma,TZ01,Chamwino,TZ0104,Nhinhi,TZ0104311,7203 ,3371 ,3832 ,7203 ,3371 ,0 ,0 ,0 ,3832 
United Republic of Tanzania,Jamhuri ya Muungano wa Tanzania,TZ,Dodoma,TZ01,Chamwino,TZ0104,Zajilwa,TZ0104321,10553 ,5224 ,5329 ,10553 ,5224 ,0 ,0 ,0 ,5329 
United Republic of Tanzania,Jamhuri ya Muungano wa Tanzania,TZ,Dodoma,TZ01,Dodoma Urban,TZ0105,Viwandani,TZ0105012,4883 ,2437 ,2446 ,0 ,0 ,4883 ,2437 ,2446 ,0 
United Republic of Tanzania,Jamhuri ya Muungano wa Tanzania,TZ,Dodoma,TZ01,Dodoma Urban,TZ0105,Uhuru,TZ0105022,2419 ,1229 ,1190 ,0 ,0 ,2419 ,1229 ,1190 ,0 
United Republic of Tanzania,Jamhuri ya Muungano wa Tanzania,TZ,Dodoma,TZ01,Dodoma Urban,TZ0105,Chamwino,TZ0105032,19175 ,9063 ,10112 ,0 ,0 ,19175 ,9063 ,10112 ,0 
United Republic of Tanzania,Jamhuri ya Muungano wa Tanzania,TZ,Dodoma,TZ01,Dodoma Urban,TZ0105,Kiwanja cha ndege,TZ0105042,10129 ,4629 ,5500 ,0 ,0 ,10129 ,4629 ,5500 ,0 
United Republic of Tanzania,Jamhuri ya Muungano wa Tanzania,TZ,Dodoma,TZ01,Dodoma Urban,TZ0105,Makole,TZ0105052,10504 ,4953 ,5551 ,0 ,0 ,10504 ,4953 ,5551 ,0 
United Republic of Tanzania,Jamhuri ya Muungano wa Tanzania,TZ,Dodoma,TZ01,Dodoma Urban,TZ0105,Miyuji,TZ0105062,14965 ,7187 ,7778 ,0 ,0 ,14965 ,7187 ,7778 ,0 
United Republic of Tanzania,Jamhuri ya Muungano wa Tanzania,TZ,Dodoma,TZ01,Dodoma Urban,TZ0105,Msalato,TZ0105071,6718 ,3356 ,3362 ,6718 ,3356 ,0 ,0 ,0 ,3362 
United Republic of Tanzania,Jamhuri ya Muungano wa Tanzania,TZ,Dodoma,TZ01,Dodoma Urban,TZ0105,Makutupora,TZ0105081,14430 ,7762 ,6668 ,14430 ,7762 ,0 ,0 ,0 ,6668 
United Republic of Tanzania,Jamhuri ya Muungano wa Tanzania,TZ,Dodoma,TZ01,Dodoma Urban,TZ0105,Chihanga,TZ0105091,11004 ,5366 ,5638 ,11004 ,5366 ,0 ,0 ,0 ,5638 
United Republic of Tanzania,Jamhuri ya Muungano wa Tanzania,TZ,Dodoma,TZ01,Dodoma Urban,TZ0105,Hombolo,TZ0105101,22457 ,10845 ,11612 ,22457 ,10845 ,0 ,0 ,0 ,11612 
United Republic of Tanzania,Jamhuri ya Muungano wa Tanzania,TZ,Dodoma,TZ01,Dodoma Urban,TZ0105,Ipala,TZ0105111,6026 ,2903 ,3123 ,6026 ,2903 ,0 ,0 ,0 ,3123 
United Republic of Tanzania,Jamhuri ya Muungano wa Tanzania,TZ,Dodoma,TZ01,Dodoma Urban,TZ0105,Nzuguni,TZ0105121,15466 ,7412 ,8054 ,15196 ,7272 ,270 ,140 ,130 ,7924 
United Republic of Tanzania,Jamhuri ya Muungano wa Tanzania,TZ,Dodoma,TZ01,Dodoma Urban,TZ0105,Dom-Makulu,TZ0105131,17097 ,8219 ,8878 ,17097 ,8219 ,0 ,0 ,0 ,8878 
United Republic of Tanzania,Jamhuri ya Muungano wa Tanzania,TZ,Dodoma,TZ01,Dodoma Urban,TZ0105,Mtumba,TZ0105141,17268 ,8440 ,8828 ,17268 ,8440 ,0 ,0 ,0 ,8828 
United Republic of Tanzania,Jamhuri ya Muungano wa Tanzania,TZ,Dodoma,TZ01,Dodoma Urban,TZ0105,Kikombo,TZ0105151,8343 ,4025 ,4318 ,8343 ,4025 ,0 ,0 ,0 ,4318 
United Republic of Tanzania,Jamhuri ya Muungano wa Tanzania,TZ,Dodoma,TZ01,Dodoma Urban,TZ0105,Ngh'ongh'onha,TZ0105161,9536 ,4513 ,5023 ,9536 ,4513 ,0 ,0 ,0 ,5023 
United Republic of Tanzania,Jamhuri ya Muungano wa Tanzania,TZ,Dodoma,TZ01,Dodoma Urban,TZ0105,Mpunguzi,TZ0105171,17891 ,8650 ,9241 ,17891 ,8650 ,0 ,0 ,0 ,9241 
United Republic of Tanzania,Jamhuri ya Muungano wa Tanzania,TZ,Dodoma,TZ01,Dodoma Urban,TZ0105,Tambukareli,TZ0105182,6584 ,3222 ,3362 ,0 ,0 ,6584 ,3222 ,3362 ,0 
United Republic of Tanzania,Jamhuri ya Muungano wa Tanzania,TZ,Dodoma,TZ01,Dodoma Urban,TZ0105,Kilimani,TZ0105192,6471 ,3137 ,3334 ,0 ,0 ,6471 ,3137 ,3334 ,0 
United Republic of Tanzania,Jamhuri ya Muungano wa Tanzania,TZ,Dodoma,TZ01,Dodoma Urban,TZ0105,Kikuyu Kusini,TZ0105202,5974 ,2724 ,3250 ,0 ,0 ,5974 ,2724 ,3250 ,0 
United Republic of Tanzania,Jamhuri ya Muungano wa Tanzania,TZ,Dodoma,TZ01,Dodoma Urban,TZ0105,Kikuyu Kaskazini,TZ0105212,9852 ,4814 ,5038 ,0 ,0 ,9852 ,4814 ,5038 ,0 
United Republic of Tanzania,Jamhuri ya Muungano wa Tanzania,TZ,Dodoma,TZ01,Dodoma Urban,TZ0105,Mkonze,TZ0105221,12515 ,6134 ,6381 ,12515 ,6134 ,0 ,0 ,0 ,6381 
United Republic of Tanzania,Jamhuri ya Muungano wa Tanzania,TZ,Dodoma,TZ01,Dodoma Urban,TZ0105,Mbabala,TZ0105231,11901 ,5683 ,6218 ,11901 ,5683 ,0 ,0 ,0 ,6218 
United Republic of Tanzania,Jamhuri ya Muungano wa Tanzania,TZ,Dodoma,TZ01,Dodoma Urban,TZ0105,Zuzu,TZ0105241,6485 ,3103 ,3382 ,6485 ,3103 ,0 ,0 ,0 ,3382 
United Republic of Tanzania,Jamhuri ya Muungano wa Tanzania,TZ,Dodoma,TZ01,Dodoma Urban,TZ0105,Hazina,TZ0105252,9540 ,5182 ,4358 ,0 ,0 ,9540 ,5182 ,4358 ,0 
United Republic of Tanzania,Jamhuri ya Muungano wa Tanzania,TZ,Dodoma,TZ01,Dodoma Urban,TZ0105,Madukani,TZ0105262,2421 ,1101 ,1320 ,0 ,0 ,2421 ,1101 ,1320 ,0 
United Republic of Tanzania,Jamhuri ya Muungano wa Tanzania,TZ,Dodoma,TZ01,Dodoma Urban,TZ0105,Majengo,TZ0105272,5214 ,2531 ,2683 ,0 ,0 ,5214 ,2531 ,2683 ,0 
United Republic of Tanzania,Jamhuri ya Muungano wa Tanzania,TZ,Dodoma,TZ01,Dodoma Urban,TZ0105,Kizota,TZ0105282,34453 ,16506 ,17947 ,0 ,0 ,34453 ,16506 ,17947 ,0 
United Republic of Tanzania,Jamhuri ya Muungano wa Tanzania,TZ,Dodoma,TZ01,Dodoma Urban,TZ0105,Nala,TZ0105291,5567 ,2735 ,2832 ,0 ,0 ,5567 ,2735 ,2832 ,0 
United Republic of Tanzania,Jamhuri ya Muungano wa Tanzania,TZ,Dodoma,TZ01,Dodoma Urban,TZ0105,Mbalawala,TZ0105301,8830 ,4204 ,4626 ,8830 ,4204 ,0 ,0 ,0 ,4626 
United Republic of Tanzania,Jamhuri ya Muungano wa Tanzania,TZ,Dodoma,TZ01,Dodoma Urban,TZ0105,Ntyuka,TZ0105311,4558 ,2165 ,2393 ,4558 ,2165 ,0 ,0 ,0 ,2393 
United Republic of Tanzania,Jamhuri ya Muungano wa Tanzania,TZ,Dodoma,TZ01,Dodoma Urban,TZ0105,Chigongwe,TZ0105322,7281 ,3447 ,3834 ,0 ,0 ,7281 ,3447 ,3834 ,0 
United Republic of Tanzania,Jamhuri ya Muungano wa Tanzania,TZ,Dodoma,TZ01,Dodoma Urban,TZ0105,Chang'ombe,TZ0105332,25415 ,12583 ,12832 ,0 ,0 ,25415 ,12583 ,12832 ,0 
United Republic of Tanzania,Jamhuri ya Muungano wa Tanzania,TZ,Dodoma,TZ01,Dodoma Urban,TZ0105,Iyumbu,TZ0105341,2700 ,1332 ,1368 ,2700 ,1332 ,0 ,0 ,0 ,1368 
United Republic of Tanzania,Jamhuri ya Muungano wa Tanzania,TZ,Dodoma,TZ01,Dodoma Urban,TZ0105,Chahwa,TZ0105351,4365 ,2092 ,2273 ,4365 ,2092 ,0 ,0 ,0 ,2273 
United Republic of Tanzania,Jamhuri ya Muungano wa Tanzania,TZ,Dodoma,TZ01,Dodoma Urban,TZ0105,Mnadani,TZ0105362,14373 ,7087 ,7286 ,0 ,0 ,14373 ,7087 ,7286 ,0 
United Republic of Tanzania,Jamhuri ya Muungano wa Tanzania,TZ,Dodoma,TZ01,Dodoma Urban,TZ0105,Ipagala,TZ0105372,18146 ,8716 ,9430 ,0 ,0 ,18146 ,8716 ,9430 ,0 
United Republic of Tanzania,Jamhuri ya Muungano wa Tanzania,TZ,Dodoma,TZ01,Bahi,TZ0106,Makanda,TZ0106011,7896 ,3808 ,4088 ,7896 ,3808 ,0 ,0 ,0 ,4088 
United Republic of Tanzania,Jamhuri ya Muungano wa Tanzania,TZ,Dodoma,TZ01,Bahi,TZ0106,Lamaiti,TZ0106021,12268 ,5971 ,6297 ,12268 ,5971 ,0 ,0 ,0 ,6297 
United Republic of Tanzania,Jamhuri ya Muungano wa Tanzania,TZ,Dodoma,TZ01,Bahi,TZ0106,Babayu,TZ0106031,10126 ,4942 ,5184 ,10126 ,4942 ,0 ,0 ,0 ,5184 
United Republic of Tanzania,Jamhuri ya Muungano wa Tanzania,TZ,Dodoma,TZ01,Bahi,TZ0106,Zanka,TZ0106041,9886 ,4866 ,5020 ,9886 ,4866 ,0 ,0 ,0 ,5020 
United Republic of Tanzania,Jamhuri ya Muungano wa Tanzania,TZ,Dodoma,TZ01,Bahi,TZ0106,Msisi,TZ0106051,11847 ,5736 ,6111 ,11847 ,5736 ,0 ,0 ,0 ,6111 
United Republic of Tanzania,Jamhuri ya Muungano wa Tanzania,TZ,Dodoma,TZ01,Bahi,TZ0106,Mundemu,TZ0106061,8149 ,3917 ,4232 ,8149 ,3917 ,0 ,0 ,0 ,4232 
United Republic of Tanzania,Jamhuri ya Muungano wa Tanzania,TZ,Dodoma,TZ01,Bahi,TZ0106,Bahi,TZ0106071,18293 ,8876 ,9417 ,18293 ,8876 ,0 ,0 ,0 ,9417 
United Republic of Tanzania,Jamhuri ya Muungano wa Tanzania,TZ,Dodoma,TZ01,Bahi,TZ0106,Mpamantwa,TZ0106081,12984 ,6249 ,6735 ,12984 ,6249 ,0 ,0 ,0 ,6735 
United Republic of Tanzania,Jamhuri ya Muungano wa Tanzania,TZ,Dodoma,TZ01,Bahi,TZ0106,Ibihwa,TZ0106091,11060 ,5223 ,5837 ,11060 ,5223 ,0 ,0 ,0 ,5837 
United Republic of Tanzania,Jamhuri ya Muungano wa Tanzania,TZ,Dodoma,TZ01,Bahi,TZ0106,Ilindi,TZ0106101,9440 ,4515 ,4925 ,9440 ,4515 ,0 ,0 ,0 ,4925 
United Republic of Tanzania,Jamhuri ya Muungano wa Tanzania,TZ,Dodoma,TZ01,Bahi,TZ0106,Kigwe,TZ0106111,15559 ,7315 ,8244 ,15559 ,7315 ,0 ,0 ,0 ,8244 
United Republic of Tanzania,Jamhuri ya Muungano wa Tanzania,TZ,Dodoma,TZ01,Bahi,TZ0106,Chikola,TZ0106121,13668 ,6479 ,7189 ,13668 ,6479 ,0 ,0 ,0 ,7189 
United Republic of Tanzania,Jamhuri ya Muungano wa Tanzania,TZ,Dodoma,TZ01,Bahi,TZ0106,Chipanga,TZ0106131,9654 ,4594 ,5060 ,9654 ,4594 ,0 ,0 ,0 ,5060 
United Republic of Tanzania,Jamhuri ya Muungano wa Tanzania,TZ,Dodoma,TZ01,Bahi,TZ0106,Chali,TZ0106141,11300 ,5282 ,6018 ,11300 ,5282 ,0 ,0 ,0 ,6018 
United Republic of Tanzania,Jamhuri ya Muungano wa Tanzania,TZ,Dodoma,TZ01,Bahi,TZ0106,Nondwa,TZ0106151,15369 ,7344 ,8025 ,15369 ,7344 ,0 ,0 ,0 ,8025 
United Republic of Tanzania,Jamhuri ya Muungano wa Tanzania,TZ,Dodoma,TZ01,Bahi,TZ0106,Mpalanga,TZ0106161,10228 ,4831 ,5397 ,10228 ,4831 ,0 ,0 ,0 ,5397 
United Republic of Tanzania,Jamhuri ya Muungano wa Tanzania,TZ,Dodoma,TZ01,Bahi,TZ0106,Ibugule,TZ0106171,8046 ,3770 ,4276 ,8046 ,3770 ,0 ,0 ,0 ,4276 
United Republic of Tanzania,Jamhuri ya Muungano wa Tanzania,TZ,Dodoma,TZ01,Bahi,TZ0106,Chibelela,TZ0106181,10033 ,4739 ,5294 ,10033 ,4739 ,0 ,0 ,0 ,5294 
United Republic of Tanzania,Jamhuri ya Muungano wa Tanzania,TZ,Dodoma,TZ01,Bahi,TZ0106,Mwitikira,TZ0106191,7235 ,3424 ,3811 ,7235 ,3424 ,0 ,0 ,0 ,3811 
United Republic of Tanzania,Jamhuri ya Muungano wa Tanzania,TZ,Dodoma,TZ01,Bahi,TZ0106,Mtitaa,TZ0106201,8604 ,4094 ,4510 ,8604 ,4094 ,0 ,0 ,0 ,4510 
United Republic of Tanzania,Jamhuri ya Muungano wa Tanzania,TZ,Dodoma,TZ01,Chemba,TZ0107,Makorongo,TZ0107011,15162 ,7343 ,7819 ,15162 ,7343 ,0 ,0 ,0 ,7819 
United Republic of Tanzania,Jamhuri ya Muungano wa Tanzania,TZ,Dodoma,TZ01,Chemba,TZ0107,Ovada,TZ0107021,11648 ,5897 ,5751 ,11648 ,5897 ,0 ,0 ,0 ,5751 
United Republic of Tanzania,Jamhuri ya Muungano wa Tanzania,TZ,Dodoma,TZ01,Chemba,TZ0107,Msaada,TZ0107031,6349 ,3163 ,3186 ,6349 ,3163 ,0 ,0 ,0 ,3186 
United Republic of Tanzania,Jamhuri ya Muungano wa Tanzania,TZ,Dodoma,TZ01,Chemba,TZ0107,Kimaha,TZ0107041,10602 ,5302 ,5300 ,10602 ,5302 ,0 ,0 ,0 ,5300 
United Republic of Tanzania,Jamhuri ya Muungano wa Tanzania,TZ,Dodoma,TZ01,Chemba,TZ0107,Churuku,TZ0107051,9260 ,4556 ,4704 ,9260 ,4556 ,0 ,0 ,0 ,4704 
United Republic of Tanzania,Jamhuri ya Muungano wa Tanzania,TZ,Dodoma,TZ01,Chemba,TZ0107,Songoro,TZ0107061,10751 ,5472 ,5279 ,10751 ,5472 ,0 ,0 ,0 ,5279 
United Republic of Tanzania,Jamhuri ya Muungano wa Tanzania,TZ,Dodoma,TZ01,Chemba,TZ0107,Mondo,TZ0107071,9494 ,4675 ,4819 ,9494 ,4675 ,0 ,0 ,0 ,4819 
United Republic of Tanzania,Jamhuri ya Muungano wa Tanzania,TZ,Dodoma,TZ01,Chemba,TZ0107,Dalai,TZ0107081,15078 ,7365 ,7713 ,15078 ,7365 ,0 ,0 ,0 ,7713 
United Republic of Tanzania,Jamhuri ya Muungano wa Tanzania,TZ,Dodoma,TZ01,Chemba,TZ0107,Jangalo,TZ0107091,17764 ,8939 ,8825 ,17764 ,8939 ,0 ,0 ,0 ,8825 
United Republic of Tanzania,Jamhuri ya Muungano wa Tanzania,TZ,Dodoma,TZ01,Chemba,TZ0107,Mrijo,TZ0107103,13104 ,6405 ,6699 ,8565 ,4163 ,4539 ,2242 ,2297 ,4402 
United Republic of Tanzania,Jamhuri ya Muungano wa Tanzania,TZ,Dodoma,TZ01,Chemba,TZ0107,Chandama,TZ0107111,18705 ,9253 ,9452 ,18705 ,9253 ,0 ,0 ,0 ,9452 
United Republic of Tanzania,Jamhuri ya Muungano wa Tanzania,TZ,Dodoma,TZ01,Chemba,TZ0107,Goima,TZ0107121,12261 ,6061 ,6200 ,12261 ,6061 ,0 ,0 ,0 ,6200 
United Republic of Tanzania,Jamhuri ya Muungano wa Tanzania,TZ,Dodoma,TZ01,Chemba,TZ0107,Chemba,TZ0107131,16047 ,8119 ,7928 ,16047 ,8119 ,0 ,0 ,0 ,7928 
United Republic of Tanzania,Jamhuri ya Muungano wa Tanzania,TZ,Dodoma,TZ01,Chemba,TZ0107,Paranga,TZ0107141,12297 ,6141 ,6156 ,12297 ,6141 ,0 ,0 ,0 ,6156 
United Republic of Tanzania,Jamhuri ya Muungano wa Tanzania,TZ,Dodoma,TZ01,Chemba,TZ0107,Gwandi,TZ0107151,7971 ,3967 ,4004 ,7971 ,3967 ,0 ,0 ,0 ,4004 
United Republic of Tanzania,Jamhuri ya Muungano wa Tanzania,TZ,Dodoma,TZ01,Chemba,TZ0107,Farkwa,TZ0107161,9991 ,5091 ,4900 ,9991 ,5091 ,0 ,0 ,0 ,4900 
United Republic of Tanzania,Jamhuri ya Muungano wa Tanzania,TZ,Dodoma,TZ01,Chemba,TZ0107,Mpendo,TZ0107171,6997 ,3349 ,3648 ,6997 ,3349 ,0 ,0 ,0 ,3648 
United Republic of Tanzania,Jamhuri ya Muungano wa Tanzania,TZ,Dodoma,TZ01,Chemba,TZ0107,Sanzawa,TZ0107181,10613 ,5434 ,5179 ,10613 ,5434 ,0 ,0 ,0 ,5179 
United Republic of Tanzania,Jamhuri ya Muungano wa Tanzania,TZ,Dodoma,TZ01,Chemba,TZ0107,Kwamtoro,TZ0107191,9785 ,4995 ,4790 ,9785 ,4995 ,0 ,0 ,0 ,4790 
United Republic of Tanzania,Jamhuri ya Muungano wa Tanzania,TZ,Dodoma,TZ01,Chemba,TZ0107,Lalta,TZ0107201,11832 ,6058 ,5774 ,11832 ,6058 ,0 ,0 ,0 ,5774 
United Republic of Tanzania,Jamhuri ya Muungano wa Tanzania,TZ,Arusha,TZ02,Monduli,TZ0201,Engaruka,TZ0201011,11121 ,5314 ,5807 ,11121 ,5314 ,0 ,0 ,0 ,5807 
United Republic of Tanzania,Jamhuri ya Muungano wa Tanzania,TZ,Arusha,TZ02,Monduli,TZ0201,Selela,TZ0201021,8703 ,4244 ,4459 ,8703 ,4244 ,0 ,0 ,0 ,4459 
United Republic of Tanzania,Jamhuri ya Muungano wa Tanzania,TZ,Arusha,TZ02,Monduli,TZ0201,Monduli juu,TZ0201031,15914 ,7321 ,8593 ,15914 ,7321 ,0 ,0 ,0 ,8593 
United Republic of Tanzania,Jamhuri ya Muungano wa Tanzania,TZ,Arusha,TZ02,Monduli,TZ0201,Engutoto,TZ0201043,6970 ,3304 ,3666 ,4628 ,2204 ,2342 ,1100 ,1242 ,2424 
United Republic of Tanzania,Jamhuri ya Muungano wa Tanzania,TZ,Arusha,TZ02,Monduli,TZ0201,Monduli Mjini,TZ0201052,7796 ,3793 ,4003 ,0 ,0 ,7796 ,3793 ,4003 ,0 
United Republic of Tanzania,Jamhuri ya Muungano wa Tanzania,TZ,Arusha,TZ02,Monduli,TZ0201,Moita,TZ0201061,11340 ,5136 ,6204 ,11340 ,5136 ,0 ,0 ,0 ,6204 
United Republic of Tanzania,Jamhuri ya Muungano wa Tanzania,TZ,Arusha,TZ02,Monduli,TZ0201,Sepeko,TZ0201071,16720 ,7902 ,8818 ,16720 ,7902 ,0 ,0 ,0 ,8818 
United Republic of Tanzania,Jamhuri ya Muungano wa Tanzania,TZ,Arusha,TZ02,Monduli,TZ0201,Lolkisale,TZ0201081,10056 ,4892 ,5164 ,10056 ,4892 ,0 ,0 ,0 ,5164 
United Republic of Tanzania,Jamhuri ya Muungano wa Tanzania,TZ,Arusha,TZ02,Monduli,TZ0201,Makuyuni,TZ0201091,11228 ,5434 ,5794 ,11228 ,5434 ,0 ,0 ,0 ,5794 
United Republic of Tanzania,Jamhuri ya Muungano wa Tanzania,TZ,Arusha,TZ02,Monduli,TZ0201,Esilalei,TZ0201101,14595 ,6950 ,7645 ,14595 ,6950 ,0 ,0 ,0 ,7645 
United Republic of Tanzania,Jamhuri ya Muungano wa Tanzania,TZ,Arusha,TZ02,Monduli,TZ0201,Mto wa Mbu,TZ0201113,11405 ,5470 ,5935 ,1145 ,536 ,10260 ,4934 ,5326 ,609 
United Republic of Tanzania,Jamhuri ya Muungano wa Tanzania,TZ,Arusha,TZ02,Monduli,TZ0201,Lepurko,TZ0201121,8151 ,3665 ,4486 ,8151 ,3665 ,0 ,0 ,0 ,4486 
United Republic of Tanzania,Jamhuri ya Muungano wa Tanzania,TZ,Arusha,TZ02,Monduli,TZ0201,Meserani,TZ0201131,11301 ,5400 ,5901 ,11301 ,5400 ,0 ,0 ,0 ,5901 
United Republic of Tanzania,Jamhuri ya Muungano wa Tanzania,TZ,Arusha,TZ02,Monduli,TZ0201,Mswakini,TZ0201141,5776 ,2861 ,2915 ,5776 ,2861 ,0 ,0 ,0 ,2915 
United Republic of Tanzania,Jamhuri ya Muungano wa Tanzania,TZ,Arusha,TZ02,Monduli,TZ0201,Majengo,TZ0201151,7853 ,3929 ,3924 ,7853 ,3929 ,0 ,0 ,0 ,3924 
United Republic of Tanzania,Jamhuri ya Muungano wa Tanzania,TZ,Arusha,TZ02,Meru,TZ0202,Ngarenanyuki,TZ0202011,20379 ,10169 ,10210 ,20379 ,10169 ,0 ,0 ,0 ,10210 
United Republic of Tanzania,Jamhuri ya Muungano wa Tanzania,TZ,Arusha,TZ02,Meru,TZ0202,Leguruki,TZ0202021,17636 ,8584 ,9052 ,17636 ,8584 ,0 ,0 ,0 ,9052 
United Republic of Tanzania,Jamhuri ya Muungano wa Tanzania,TZ,Arusha,TZ02,Meru,TZ0202,King'ori,TZ0202033,23280 ,11465 ,11815 ,18507 ,9099 ,4773 ,2366 ,2407 ,9408 
United Republic of Tanzania,Jamhuri ya Muungano wa Tanzania,TZ,Arusha,TZ02,Meru,TZ0202,Maji ya chai,TZ0202043,29313 ,14143 ,15170 ,25582 ,12483 ,3731 ,1660 ,2071 ,13099 
United Republic of Tanzania,Jamhuri ya Muungano wa Tanzania,TZ,Arusha,TZ02,Meru,TZ0202,Kikatiti,TZ0202053,16755 ,8220 ,8535 ,14448 ,7121 ,2307 ,1099 ,1208 ,7327 
United Republic of Tanzania,Jamhuri ya Muungano wa Tanzania,TZ,Arusha,TZ02,Meru,TZ0202,Maroroni,TZ0202061,14103 ,7021 ,7082 ,14103 ,7021 ,0 ,0 ,0 ,7082 
United Republic of Tanzania,Jamhuri ya Muungano wa Tanzania,TZ,Arusha,TZ02,Meru,TZ0202,Makiba,TZ0202073,11874 ,5819 ,6055 ,11874 ,5819 ,0 ,0 ,0 ,6055 
United Republic of Tanzania,Jamhuri ya Muungano wa Tanzania,TZ,Arusha,TZ02,Meru,TZ0202,Mbuguni,TZ0202083,16130 ,8193 ,7937 ,14255 ,7262 ,1875 ,931 ,944 ,6993 
United Republic of Tanzania,Jamhuri ya Muungano wa Tanzania,TZ,Arusha,TZ02,Meru,TZ0202,Kikwe,TZ0202091,10795 ,5431 ,5364 ,10795 ,5431 ,0 ,0 ,0 ,5364 
United Republic of Tanzania,Jamhuri ya Muungano wa Tanzania,TZ,Arusha,TZ02,Meru,TZ0202,Usariver,TZ0202103,23437 ,11174 ,12263 ,4727 ,2375 ,18710 ,8799 ,9911 ,2352 
United Republic of Tanzania,Jamhuri ya Muungano wa Tanzania,TZ,Arusha,TZ02,Meru,TZ0202,Nkoaranga,TZ0202113,13929 ,6789 ,7140 ,12550 ,6139 ,1379 ,650 ,729 ,6411 
United Republic of Tanzania,Jamhuri ya Muungano wa Tanzania,TZ,Arusha,TZ02,Meru,TZ0202,Poli,TZ0202123,9507 ,4542 ,4965 ,7182 ,3423 ,2325 ,1119 ,1206 ,3759 
United Republic of Tanzania,Jamhuri ya Muungano wa Tanzania,TZ,Arusha,TZ02,Meru,TZ0202,Seela Sing'isi,TZ0202131,10109 ,4911 ,5198 ,10109 ,4911 ,0 ,0 ,0 ,5198 
United Republic of Tanzania,Jamhuri ya Muungano wa Tanzania,TZ,Arusha,TZ02,Meru,TZ0202,Akheri,TZ0202143,13699 ,6610 ,7089 ,9586 ,4693 ,4113 ,1917 ,2196 ,4893 
United Republic of Tanzania,Jamhuri ya Muungano wa Tanzania,TZ,Arusha,TZ02,Meru,TZ0202,Nkoanrua,TZ0202151,18520 ,8961 ,9559 ,18520 ,8961 ,0 ,0 ,0 ,9559 
United Republic of Tanzania,Jamhuri ya Muungano wa Tanzania,TZ,Arusha,TZ02,Meru,TZ0202,Songoro,TZ0202161,11319 ,5698 ,5621 ,11319 ,5698 ,0 ,0 ,0 ,5621 
United Republic of Tanzania,Jamhuri ya Muungano wa Tanzania,TZ,Arusha,TZ02,Meru,TZ0202,Nkoarisambu,TZ0202171,7359 ,3534 ,3825 ,7359 ,3534 ,0 ,0 ,0 ,3825 
United Republic of Tanzania,Jamhuri ya Muungano wa Tanzania,TZ,Arusha,TZ02,Arusha Urban,TZ0203,Kati,TZ0203012,3114 ,1564 ,1550 ,0 ,0 ,3114 ,1564 ,1550 ,0 
United Republic of Tanzania,Jamhuri ya Muungano wa Tanzania,TZ,Arusha,TZ02,Arusha Urban,TZ0203,Kaloleni,TZ0203022,9591 ,4490 ,5101 ,0 ,0 ,9591 ,4490 ,5101 ,0 
United Republic of Tanzania,Jamhuri ya Muungano wa Tanzania,TZ,Arusha,TZ02,Arusha Urban,TZ0203,Sekei,TZ0203032,9213 ,4272 ,4941 ,0 ,0 ,9213 ,4272 ,4941 ,0 
United Republic of Tanzania,Jamhuri ya Muungano wa Tanzania,TZ,Arusha,TZ02,Arusha Urban,TZ0203,Kimandolu,TZ0203042,27649 ,12911 ,14738 ,0 ,0 ,27649 ,12911 ,14738 ,0 
United Republic of Tanzania,Jamhuri ya Muungano wa Tanzania,TZ,Arusha,TZ02,Arusha Urban,TZ0203,Baraa,TZ0203052,12498 ,5896 ,6602 ,0 ,0 ,12498 ,5896 ,6602 ,0 
United Republic of Tanzania,Jamhuri ya Muungano wa Tanzania,TZ,Arusha,TZ02,Arusha Urban,TZ0203,Oloirieni,TZ0203062,9485 ,4685 ,4800 ,7025 ,3476 ,2460 ,1209 ,1251 ,3549 
United Republic of Tanzania,Jamhuri ya Muungano wa Tanzania,TZ,Arusha,TZ02,Arusha Urban,TZ0203,Themi,TZ0203072,9458 ,4579 ,4879 ,0 ,0 ,9458 ,4579 ,4879 ,0 
United Republic of Tanzania,Jamhuri ya Muungano wa Tanzania,TZ,Arusha,TZ02,Arusha Urban,TZ0203,Lemara,TZ0203082,19564 ,9573 ,9991 ,0 ,0 ,19564 ,9573 ,9991 ,0 
United Republic of Tanzania,Jamhuri ya Muungano wa Tanzania,TZ,Arusha,TZ02,Arusha Urban,TZ0203,Terrat,TZ0203092,21790 ,10346 ,11444 ,0 ,0 ,21790 ,10346 ,11444 ,0 
United Republic of Tanzania,Jamhuri ya Muungano wa Tanzania,TZ,Arusha,TZ02,Arusha Urban,TZ0203,Sokoni I,TZ0203102,32073 ,15261 ,16812 ,30867 ,14680 ,1206 ,581 ,625 ,16187 
United Republic of Tanzania,Jamhuri ya Muungano wa Tanzania,TZ,Arusha,TZ02,Arusha Urban,TZ0203,Daraja Mbili,TZ0203112,19491 ,9375 ,10116 ,0 ,0 ,19491 ,9375 ,10116 ,0 
United Republic of Tanzania,Jamhuri ya Muungano wa Tanzania,TZ,Arusha,TZ02,Arusha Urban,TZ0203,Unga Ltd,TZ0203122,17342 ,8497 ,8845 ,0 ,0 ,17342 ,8497 ,8845 ,0 
United Republic of Tanzania,Jamhuri ya Muungano wa Tanzania,TZ,Arusha,TZ02,Arusha Urban,TZ0203,Sombetini,TZ0203132,48268 ,22769 ,25499 ,0 ,0 ,48268 ,22769 ,25499 ,0 
United Republic of Tanzania,Jamhuri ya Muungano wa Tanzania,TZ,Arusha,TZ02,Arusha Urban,TZ0203,Ngarenaro,TZ0203142,12382 ,5955 ,6427 ,0 ,0 ,12382 ,5955 ,6427 ,0 
United Republic of Tanzania,Jamhuri ya Muungano wa Tanzania,TZ,Arusha,TZ02,Arusha Urban,TZ0203,Levolosi,TZ0203152,8838 ,4279 ,4559 ,0 ,0 ,8838 ,4279 ,4559 ,0 
United Republic of Tanzania,Jamhuri ya Muungano wa Tanzania,TZ,Arusha,TZ02,Arusha Urban,TZ0203,Engutoto,TZ0203162,7426 ,3619 ,3807 ,0 ,0 ,7426 ,3619 ,3807 ,0 
United Republic of Tanzania,Jamhuri ya Muungano wa Tanzania,TZ,Arusha,TZ02,Arusha Urban,TZ0203,Elerai,TZ0203172,40749 ,19244 ,21505 ,0 ,0 ,40749 ,19244 ,21505 ,0 
United Republic of Tanzania,Jamhuri ya Muungano wa Tanzania,TZ,Arusha,TZ02,Arusha Urban,TZ0203,Olasiti,TZ0203182,36361 ,17883 ,18478 ,0 ,0 ,36361 ,17883 ,18478 ,0 
United Republic of Tanzania,Jamhuri ya Muungano wa Tanzania,TZ,Arusha,TZ02,Arusha Urban,TZ0203,Moshono,TZ0203192,20698 ,9995 ,10703 ,0 ,0 ,20698 ,9995 ,10703 ,0 
United Republic of Tanzania,Jamhuri ya Muungano wa Tanzania,TZ,Arusha,TZ02,Karatu,TZ0204,Karatu,TZ0204013,26617 ,12990 ,13627 ,11774 ,5914 ,14843 ,7076 ,7767 ,5860 
United Republic of Tanzania,Jamhuri ya Muungano wa Tanzania,TZ,Arusha,TZ02,Karatu,TZ0204,Endamarariek,TZ0204021,24996 ,12686 ,12310 ,24996 ,12686 ,0 ,0 ,0 ,12310 
United Republic of Tanzania,Jamhuri ya Muungano wa Tanzania,TZ,Arusha,TZ02,Karatu,TZ0204,Buger,TZ0204031,9919 ,5051 ,4868 ,9919 ,5051 ,0 ,0 ,0 ,4868 
United Republic of Tanzania,Jamhuri ya Muungano wa Tanzania,TZ,Arusha,TZ02,Karatu,TZ0204,Endabash,TZ0204041,14358 ,7564 ,6794 ,14358 ,7564 ,0 ,0 ,0 ,6794 
United Republic of Tanzania,Jamhuri ya Muungano wa Tanzania,TZ,Arusha,TZ02,Karatu,TZ0204,Kansay,TZ0204051,14198 ,7254 ,6944 ,14198 ,7254 ,0 ,0 ,0 ,6944 
United Republic of Tanzania,Jamhuri ya Muungano wa Tanzania,TZ,Arusha,TZ02,Karatu,TZ0204,Baray,TZ0204061,23554 ,12398 ,11156 ,23554 ,12398 ,0 ,0 ,0 ,11156 
United Republic of Tanzania,Jamhuri ya Muungano wa Tanzania,TZ,Arusha,TZ02,Karatu,TZ0204,Mang'ola,TZ0204071,6087 ,3235 ,2852 ,6087 ,3235 ,0 ,0 ,0 ,2852 
United Republic of Tanzania,Jamhuri ya Muungano wa Tanzania,TZ,Arusha,TZ02,Karatu,TZ0204,Daa,TZ0204081,9868 ,5243 ,4625 ,9868 ,5243 ,0 ,0 ,0 ,4625 
United Republic of Tanzania,Jamhuri ya Muungano wa Tanzania,TZ,Arusha,TZ02,Karatu,TZ0204,Oldean,TZ0204091,6870 ,3525 ,3345 ,6870 ,3525 ,0 ,0 ,0 ,3345 
United Republic of Tanzania,Jamhuri ya Muungano wa Tanzania,TZ,Arusha,TZ02,Karatu,TZ0204,Qurus,TZ0204101,15919 ,8027 ,7892 ,15919 ,8027 ,0 ,0 ,0 ,7892 
United Republic of Tanzania,Jamhuri ya Muungano wa Tanzania,TZ,Arusha,TZ02,Karatu,TZ0204,Ganako,TZ0204111,15481 ,7822 ,7659 ,15481 ,7822 ,0 ,0 ,0 ,7659 
United Republic of Tanzania,Jamhuri ya Muungano wa Tanzania,TZ,Arusha,TZ02,Karatu,TZ0204,Rhotia,TZ0204121,24268 ,12490 ,11778 ,24268 ,12490 ,0 ,0 ,0 ,11778 
United Republic of Tanzania,Jamhuri ya Muungano wa Tanzania,TZ,Arusha,TZ02,Karatu,TZ0204,Mbulumbulu,TZ0204131,21764 ,11219 ,10545 ,21764 ,11219 ,0 ,0 ,0 ,10545 
United Republic of Tanzania,Jamhuri ya Muungano wa Tanzania,TZ,Arusha,TZ02,Karatu,TZ0204,Endamaghang,TZ0204141,16267 ,8265 ,8002 ,16267 ,8265 ,0 ,0 ,0 ,8002 
United Republic of Tanzania,Jamhuri ya Muungano wa Tanzania,TZ,Arusha,TZ02,Ngorongoro,TZ0205,Orgosorok,TZ0205013,12268 ,6112 ,6156 ,7225 ,3535 ,5043 ,2577 ,2466 ,3690 
United Republic of Tanzania,Jamhuri ya Muungano wa Tanzania,TZ,Arusha,TZ02,Ngorongoro,TZ0205,Digodigo,TZ0205021,8195 ,3942 ,4253 ,8195 ,3942 ,0 ,0 ,0 ,4253 
United Republic of Tanzania,Jamhuri ya Muungano wa Tanzania,TZ,Arusha,TZ02,Ngorongoro,TZ0205,Oldonyo Sambu,TZ0205031,5233 ,2525 ,2708 ,5233 ,2525 ,0 ,0 ,0 ,2708 
United Republic of Tanzania,Jamhuri ya Muungano wa Tanzania,TZ,Arusha,TZ02,Ngorongoro,TZ0205,Pinyinyi,TZ0205041,8482 ,4083 ,4399 ,8482 ,4083 ,0 ,0 ,0 ,4399 
United Republic of Tanzania,Jamhuri ya Muungano wa Tanzania,TZ,Arusha,TZ02,Ngorongoro,TZ0205,Sale,TZ0205051,4384 ,2069 ,2315 ,4384 ,2069 ,0 ,0 ,0 ,2315 
United Republic of Tanzania,Jamhuri ya Muungano wa Tanzania,TZ,Arusha,TZ02,Ngorongoro,TZ0205,Malambo,TZ0205061,14226 ,6608 ,7618 ,14226 ,6608 ,0 ,0 ,0 ,7618 
United Republic of Tanzania,Jamhuri ya Muungano wa Tanzania,TZ,Arusha,TZ02,Ngorongoro,TZ0205,Naiyobi,TZ0205071,9133 ,4277 ,4856 ,9133 ,4277 ,0 ,0 ,0 ,4856 
United Republic of Tanzania,Jamhuri ya Muungano wa Tanzania,TZ,Arusha,TZ02,Ngorongoro,TZ0205,Nainokanoka,TZ0205081,12971 ,6032 ,6939 ,12971 ,6032 ,0 ,0 ,0 ,6939 
United Republic of Tanzania,Jamhuri ya Muungano wa Tanzania,TZ,Arusha,TZ02,Ngorongoro,TZ0205,Olbalbal,TZ0205091,8969 ,4119 ,4850 ,8969 ,4119 ,0 ,0 ,0 ,4850 
United Republic of Tanzania,Jamhuri ya Muungano wa Tanzania,TZ,Arusha,TZ02,Ngorongoro,TZ0205,Ngorongoro,TZ0205103,12586 ,5871 ,6715 ,11442 ,5222 ,1144 ,649 ,495 ,6220 
United Republic of Tanzania,Jamhuri ya Muungano wa Tanzania,TZ,Arusha,TZ02,Ngorongoro,TZ0205,Endulen,TZ0205111,13537 ,6000 ,7537 ,13537 ,6000 ,0 ,0 ,0 ,7537 
United Republic of Tanzania,Jamhuri ya Muungano wa Tanzania,TZ,Arusha,TZ02,Ngorongoro,TZ0205,Kakesio,TZ0205121,5537 ,2578 ,2959 ,5537 ,2578 ,0 ,0 ,0 ,2959 
United Republic of Tanzania,Jamhuri ya Muungano wa Tanzania,TZ,Arusha,TZ02,Ngorongoro,TZ0205,Arash,TZ0205131,7841 ,3711 ,4130 ,7841 ,3711 ,0 ,0 ,0 ,4130 
United Republic of Tanzania,Jamhuri ya Muungano wa Tanzania,TZ,Arusha,TZ02,Ngorongoro,TZ0205,Soitsambu,TZ0205141,10956 ,5407 ,5549 ,10956 ,5407 ,0 ,0 ,0 ,5549 
United Republic of Tanzania,Jamhuri ya Muungano wa Tanzania,TZ,Arusha,TZ02,Ngorongoro,TZ0205,Engusero Sambu,TZ0205151,1521 ,752 ,769 ,1521 ,752 ,0 ,0 ,0 ,769 
United Republic of Tanzania,Jamhuri ya Muungano wa Tanzania,TZ,Arusha,TZ02,Ngorongoro,TZ0205,Oloirien,TZ0205161,18679 ,8743 ,9936 ,0 ,0 ,18679 ,8743 ,9936 ,0 
United Republic of Tanzania,Jamhuri ya Muungano wa Tanzania,TZ,Arusha,TZ02,Ngorongoro,TZ0205,Samunge,TZ0205171,6579 ,3156 ,3423 ,6579 ,3156 ,0 ,0 ,0 ,3423 
United Republic of Tanzania,Jamhuri ya Muungano wa Tanzania,TZ,Arusha,TZ02,Ngorongoro,TZ0205,Alailelai,TZ0205181,7351 ,3405 ,3946 ,7351 ,3405 ,0 ,0 ,0 ,3946 
United Republic of Tanzania,Jamhuri ya Muungano wa Tanzania,TZ,Arusha,TZ02,Ngorongoro,TZ0205,Maalon,TZ0205191,4353 ,2004 ,2349 ,4353 ,2004 ,0 ,0 ,0 ,2349 
United Republic of Tanzania,Jamhuri ya Muungano wa Tanzania,TZ,Arusha,TZ02,Ngorongoro,TZ0205,Ololosokwan,TZ0205201,6557 ,3263 ,3294 ,6557 ,3263 ,0 ,0 ,0 ,3294 
United Republic of Tanzania,Jamhuri ya Muungano wa Tanzania,TZ,Arusha,TZ02,Ngorongoro,TZ0205,Oloipiri,TZ0205211,4114 ,2011 ,2103 ,4114 ,2011 ,0 ,0 ,0 ,2103 
United Republic of Tanzania,Jamhuri ya Muungano wa Tanzania,TZ,Arusha,TZ02,Arusha,TZ0206,Oldonyosambu,TZ0206011,16484 ,7943 ,8541 ,16484 ,7943 ,0 ,0 ,0 ,8541 
United Republic of Tanzania,Jamhuri ya Muungano wa Tanzania,TZ,Arusha,TZ02,Arusha,TZ0206,Olkokola,TZ0206021,24728 ,11511 ,13217 ,24728 ,11511 ,0 ,0 ,0 ,13217 
United Republic of Tanzania,Jamhuri ya Muungano wa Tanzania,TZ,Arusha,TZ02,Arusha,TZ0206,Ilkiding'a,TZ0206031,10850 ,5218 ,5632 ,10850 ,5218 ,0 ,0 ,0 ,5632 
United Republic of Tanzania,Jamhuri ya Muungano wa Tanzania,TZ,Arusha,TZ02,Arusha,TZ0206,Bangata,TZ0206041,9136 ,4495 ,4641 ,9136 ,4495 ,0 ,0 ,0 ,4641 
United Republic of Tanzania,Jamhuri ya Muungano wa Tanzania,TZ,Arusha,TZ02,Arusha,TZ0206,Sokon II,TZ0206053,73331 ,35534 ,37797 ,0 ,0 ,73331 ,35534 ,37797 ,0 
United Republic of Tanzania,Jamhuri ya Muungano wa Tanzania,TZ,Arusha,TZ02,Arusha,TZ0206,Oltoroto,TZ0206061,15451 ,7536 ,7915 ,15451 ,7536 ,0 ,0 ,0 ,7915 
United Republic of Tanzania,Jamhuri ya Muungano wa Tanzania,TZ,Arusha,TZ02,Arusha,TZ0206,Moivo,TZ0206073,27151 ,13311 ,13840 ,5931 ,2885 ,21220 ,10426 ,10794 ,3046 
United Republic of Tanzania,Jamhuri ya Muungano wa Tanzania,TZ,Arusha,TZ02,Arusha,TZ0206,Kiranyi,TZ0206083,25469 ,12084 ,13385 ,8107 ,3874 ,17362 ,8210 ,9152 ,4233 
United Republic of Tanzania,Jamhuri ya Muungano wa Tanzania,TZ,Arusha,TZ02,Arusha,TZ0206,Kimnyaki,TZ0206091,3487 ,1652 ,1835 ,3487 ,1652 ,0 ,0 ,0 ,1835 
United Republic of Tanzania,Jamhuri ya Muungano wa Tanzania,TZ,Arusha,TZ02,Arusha,TZ0206,Oltrumet,TZ0206101,10226 ,4806 ,5420 ,10226 ,4806 ,0 ,0 ,0 ,5420 
United Republic of Tanzania,Jamhuri ya Muungano wa Tanzania,TZ,Arusha,TZ02,Arusha,TZ0206,Mwandeti,TZ0206111,17390 ,7927 ,9463 ,17390 ,7927 ,0 ,0 ,0 ,9463 
United Republic of Tanzania,Jamhuri ya Muungano wa Tanzania,TZ,Arusha,TZ02,Arusha,TZ0206,Mussa,TZ0206121,11836 ,5598 ,6238 ,11836 ,5598 ,0 ,0 ,0 ,6238 
United Republic of Tanzania,Jamhuri ya Muungano wa Tanzania,TZ,Arusha,TZ02,Arusha,TZ0206,Kisongo,TZ0206131,8769 ,4166 ,4603 ,8769 ,4166 ,0 ,0 ,0 ,4603 
United Republic of Tanzania,Jamhuri ya Muungano wa Tanzania,TZ,Arusha,TZ02,Arusha,TZ0206,Mateves,TZ0206141,15632 ,7373 ,8259 ,7476 ,3503 ,8156 ,3870 ,4286 ,3973 
United Republic of Tanzania,Jamhuri ya Muungano wa Tanzania,TZ,Arusha,TZ02,Arusha,TZ0206,Oljoro,TZ0206151,7896 ,3905 ,3991 ,7896 ,3905 ,0 ,0 ,0 ,3991 
United Republic of Tanzania,Jamhuri ya Muungano wa Tanzania,TZ,Arusha,TZ02,Arusha,TZ0206,Bwawani,TZ0206161,11117 ,5483 ,5634 ,11117 ,5483 ,0 ,0 ,0 ,5634 
United Republic of Tanzania,Jamhuri ya Muungano wa Tanzania,TZ,Arusha,TZ02,Arusha,TZ0206,Nduruma,TZ0206171,12042 ,5960 ,6082 ,12042 ,5960 ,0 ,0 ,0 ,6082 
United Republic of Tanzania,Jamhuri ya Muungano wa Tanzania,TZ,Arusha,TZ02,Arusha,TZ0206,Mlangarini,TZ0206181,12983 ,6343 ,6640 ,12983 ,6343 ,0 ,0 ,0 ,6640 
United Republic of Tanzania,Jamhuri ya Muungano wa Tanzania,TZ,Arusha,TZ02,Arusha,TZ0206,Sambasha,TZ0206191,9484 ,4157 ,5327 ,9484 ,4157 ,0 ,0 ,0 ,5327 
United Republic of Tanzania,Jamhuri ya Muungano wa Tanzania,TZ,Arusha,TZ02,Arusha,TZ0206,Olorieni,TZ0206201,22434 ,10705 ,11729 ,22434 ,10705 ,0 ,0 ,0 ,11729 
United Republic of Tanzania,Jamhuri ya Muungano wa Tanzania,TZ,Arusha,TZ02,Arusha,TZ0206,Olmotonyi,TZ0206213,18560 ,8867 ,9693 ,14738 ,6970 ,3822 ,1897 ,1925 ,7768 
United Republic of Tanzania,Jamhuri ya Muungano wa Tanzania,TZ,Arusha,TZ02,Longido,TZ0207,Kitumbeine,TZ0207011,7233 ,3613 ,3620 ,7233 ,3613 ,0 ,0 ,0 ,3620 
United Republic of Tanzania,Jamhuri ya Muungano wa Tanzania,TZ,Arusha,TZ02,Longido,TZ0207,Engikaret,TZ0207021,6527 ,3192 ,3335 ,6527 ,3192 ,0 ,0 ,0 ,3335 
United Republic of Tanzania,Jamhuri ya Muungano wa Tanzania,TZ,Arusha,TZ02,Longido,TZ0207,Eleng'ata Dapash,TZ0207031,10221 ,4856 ,5365 ,10221 ,4856 ,0 ,0 ,0 ,5365 
United Republic of Tanzania,Jamhuri ya Muungano wa Tanzania,TZ,Arusha,TZ02,Longido,TZ0207,Ilorienito,TZ0207041,5571 ,2565 ,3006 ,5571 ,2565 ,0 ,0 ,0 ,3006 
United Republic of Tanzania,Jamhuri ya Muungano wa Tanzania,TZ,Arusha,TZ02,Longido,TZ0207,Gelai Meirugoi,TZ0207051,9173 ,4454 ,4719 ,9173 ,4454 ,0 ,0 ,0 ,4719 
United Republic of Tanzania,Jamhuri ya Muungano wa Tanzania,TZ,Arusha,TZ02,Longido,TZ0207,Gelai lumbwa,TZ0207061,6198 ,3108 ,3090 ,6198 ,3108 ,0 ,0 ,0 ,3090 
United Republic of Tanzania,Jamhuri ya Muungano wa Tanzania,TZ,Arusha,TZ02,Longido,TZ0207,Matale,TZ0207071,4411 ,2194 ,2217 ,4411 ,2194 ,0 ,0 ,0 ,2217 
United Republic of Tanzania,Jamhuri ya Muungano wa Tanzania,TZ,Arusha,TZ02,Longido,TZ0207,Engarenaibor,TZ0207081,11607 ,5789 ,5818 ,11607 ,5789 ,0 ,0 ,0 ,5818 
United Republic of Tanzania,Jamhuri ya Muungano wa Tanzania,TZ,Arusha,TZ02,Longido,TZ0207,Mundarara,TZ0207091,7301 ,3711 ,3590 ,7301 ,3711 ,0 ,0 ,0 ,3590 
United Republic of Tanzania,Jamhuri ya Muungano wa Tanzania,TZ,Arusha,TZ02,Longido,TZ0207,Kimokouwa,TZ0207101,7806 ,3763 ,4043 ,7806 ,3763 ,0 ,0 ,0 ,4043 
United Republic of Tanzania,Jamhuri ya Muungano wa Tanzania,TZ,Arusha,TZ02,Longido,TZ0207,Namanga,TZ0207113,9189 ,4464 ,4725 ,3661 ,1797 ,5528 ,2667 ,2861 ,1864 
United Republic of Tanzania,Jamhuri ya Muungano wa Tanzania,TZ,Arusha,TZ02,Longido,TZ0207,Orbomba,TZ0207121,7900 ,3901 ,3999 ,7900 ,3901 ,0 ,0 ,0 ,3999 
United Republic of Tanzania,Jamhuri ya Muungano wa Tanzania,TZ,Arusha,TZ02,Longido,TZ0207,Longido,TZ0207132,2285 ,1155 ,1130 ,0 ,0 ,2285 ,1155 ,1130 ,0 
United Republic of Tanzania,Jamhuri ya Muungano wa Tanzania,TZ,Arusha,TZ02,Longido,TZ0207,Tingatinga,TZ0207141,8821 ,4286 ,4535 ,8821 ,4286 ,0 ,0 ,0 ,4535 
United Republic of Tanzania,Jamhuri ya Muungano wa Tanzania,TZ,Arusha,TZ02,Longido,TZ0207,Olmolog,TZ0207151,8764 ,4210 ,4554 ,8764 ,4210 ,0 ,0 ,0 ,4554 
United Republic of Tanzania,Jamhuri ya Muungano wa Tanzania,TZ,Arusha,TZ02,Longido,TZ0207,Kamwanga,TZ0207161,10146 ,4938 ,5208 ,10146 ,4938 ,0 ,0 ,0 ,5208 
United Republic of Tanzania,Jamhuri ya Muungano wa Tanzania,TZ,Kilimanjaro,TZ03,Rombo,TZ0301,Mamsera,TZ0301011,9935 ,4859 ,5076 ,9935 ,4859 ,0 ,0 ,0 ,5076 
United Republic of Tanzania,Jamhuri ya Muungano wa Tanzania,TZ,Kilimanjaro,TZ03,Rombo,TZ0301,Mahida,TZ0301023,7980 ,3918 ,4062 ,7980 ,3918 ,0 ,0 ,0 ,4062 
United Republic of Tanzania,Jamhuri ya Muungano wa Tanzania,TZ,Kilimanjaro,TZ03,Rombo,TZ0301,Mengwe,TZ0301031,5277 ,2437 ,2840 ,5277 ,2437 ,0 ,0 ,0 ,2840 
United Republic of Tanzania,Jamhuri ya Muungano wa Tanzania,TZ,Kilimanjaro,TZ03,Rombo,TZ0301,Keni Mengeni,TZ0301041,8719 ,4253 ,4466 ,8719 ,4253 ,0 ,0 ,0 ,4466 
United Republic of Tanzania,Jamhuri ya Muungano wa Tanzania,TZ,Kilimanjaro,TZ03,Rombo,TZ0301,Aleni,TZ0301051,9801 ,4787 ,5014 ,9801 ,4787 ,0 ,0 ,0 ,5014 
United Republic of Tanzania,Jamhuri ya Muungano wa Tanzania,TZ,Kilimanjaro,TZ03,Rombo,TZ0301,Shimbi,TZ0301061,14591 ,7086 ,7505 ,14591 ,7086 ,0 ,0 ,0 ,7505 
United Republic of Tanzania,Jamhuri ya Muungano wa Tanzania,TZ,Kilimanjaro,TZ03,Rombo,TZ0301,Makiidi,TZ0301071,8720 ,4063 ,4657 ,8720 ,4063 ,0 ,0 ,0 ,4657 
United Republic of Tanzania,Jamhuri ya Muungano wa Tanzania,TZ,Kilimanjaro,TZ03,Rombo,TZ0301,Kelamfua Mokala,TZ0301083,13302 ,6097 ,7205 ,10872 ,4931 ,2430 ,1166 ,1264 ,5941 
United Republic of Tanzania,Jamhuri ya Muungano wa Tanzania,TZ,Kilimanjaro,TZ03,Rombo,TZ0301,Ushiri Ikuini,TZ0301091,8879 ,4103 ,4776 ,8879 ,4103 ,0 ,0 ,0 ,4776 
United Republic of Tanzania,Jamhuri ya Muungano wa Tanzania,TZ,Kilimanjaro,TZ03,Rombo,TZ0301,Mrao Keryo,TZ0301101,8199 ,3766 ,4433 ,8199 ,3766 ,0 ,0 ,0 ,4433 
United Republic of Tanzania,Jamhuri ya Muungano wa Tanzania,TZ,Kilimanjaro,TZ03,Rombo,TZ0301,Kirwa Keni,TZ0301111,8362 ,3659 ,4703 ,8362 ,3659 ,0 ,0 ,0 ,4703 
United Republic of Tanzania,Jamhuri ya Muungano wa Tanzania,TZ,Kilimanjaro,TZ03,Rombo,TZ0301,Katangara Mrere,TZ0301121,11642 ,5451 ,6191 ,11642 ,5451 ,0 ,0 ,0 ,6191 
United Republic of Tanzania,Jamhuri ya Muungano wa Tanzania,TZ,Kilimanjaro,TZ03,Rombo,TZ0301,Kisale Msaranga,TZ0301131,10048 ,4640 ,5408 ,10048 ,4640 ,0 ,0 ,0 ,5408 
United Republic of Tanzania,Jamhuri ya Muungano wa Tanzania,TZ,Kilimanjaro,TZ03,Rombo,TZ0301,Olele,TZ0301141,6723 ,3134 ,3589 ,6723 ,3134 ,0 ,0 ,0 ,3589 
United Republic of Tanzania,Jamhuri ya Muungano wa Tanzania,TZ,Kilimanjaro,TZ03,Rombo,TZ0301,Kirongo Samanga,TZ0301151,14895 ,7106 ,7789 ,14895 ,7106 ,0 ,0 ,0 ,7789 
United Republic of Tanzania,Jamhuri ya Muungano wa Tanzania,TZ,Kilimanjaro,TZ03,Rombo,TZ0301,Kitirima Kingachi,TZ0301161,18420 ,8677 ,9743 ,18420 ,8677 ,0 ,0 ,0 ,9743 
United Republic of Tanzania,Jamhuri ya Muungano wa Tanzania,TZ,Kilimanjaro,TZ03,Rombo,TZ0301,Ubetu Kahe,TZ0301171,19295 ,9248 ,10047 ,19295 ,9248 ,0 ,0 ,0 ,10047 
United Republic of Tanzania,Jamhuri ya Muungano wa Tanzania,TZ,Kilimanjaro,TZ03,Rombo,TZ0301,Nanjara Reha,TZ0301181,26715 ,12989 ,13726 ,26715 ,12989 ,0 ,0 ,0 ,13726 
United Republic of Tanzania,Jamhuri ya Muungano wa Tanzania,TZ,Kilimanjaro,TZ03,Rombo,TZ0301,Tarakea Motamburu,TZ0301193,20746 ,10253 ,10493 ,9081 ,4514 ,11665 ,5739 ,5926 ,4567 
United Republic of Tanzania,Jamhuri ya Muungano wa Tanzania,TZ,Kilimanjaro,TZ03,Rombo,TZ0301,Motamburu Kitendeni,TZ0301201,5603 ,2875 ,2728 ,5603 ,2875 ,0 ,0 ,0 ,2728 
United Republic of Tanzania,Jamhuri ya Muungano wa Tanzania,TZ,Kilimanjaro,TZ03,Rombo,TZ0301,Marangu Kitowo,TZ0301211,7734 ,3609 ,4125 ,7734 ,3609 ,0 ,0 ,0 ,4125 
United Republic of Tanzania,Jamhuri ya Muungano wa Tanzania,TZ,Kilimanjaro,TZ03,Rombo,TZ0301,Ngoyoni,TZ0301221,4038 ,1939 ,2099 ,4038 ,1939 ,0 ,0 ,0 ,2099 
United Republic of Tanzania,Jamhuri ya Muungano wa Tanzania,TZ,Kilimanjaro,TZ03,Rombo,TZ0301,Manda,TZ0301231,4040 ,1906 ,2134 ,4040 ,1906 ,0 ,0 ,0 ,2134 
United Republic of Tanzania,Jamhuri ya Muungano wa Tanzania,TZ,Kilimanjaro,TZ03,Rombo,TZ0301,Holili,TZ0301243,7299 ,3673 ,3626 ,3540 ,1827 ,3759 ,1846 ,1913 ,1713 
United Republic of Tanzania,Jamhuri ya Muungano wa Tanzania,TZ,Kilimanjaro,TZ03,Mwanga,TZ0302,Kileo,TZ0302013,13645 ,6702 ,6943 ,9353 ,4633 ,4292 ,2069 ,2223 ,4720 
United Republic of Tanzania,Jamhuri ya Muungano wa Tanzania,TZ,Kilimanjaro,TZ03,Mwanga,TZ0302,Mwanga,TZ0302022,15783 ,7414 ,8369 ,0 ,0 ,15783 ,7414 ,8369 ,0 
United Republic of Tanzania,Jamhuri ya Muungano wa Tanzania,TZ,Kilimanjaro,TZ03,Mwanga,TZ0302,Msangeni,TZ0302031,6925 ,3256 ,3669 ,6925 ,3256 ,0 ,0 ,0 ,3669 
United Republic of Tanzania,Jamhuri ya Muungano wa Tanzania,TZ,Kilimanjaro,TZ03,Mwanga,TZ0302,Kifula,TZ0302041,8020 ,3826 ,4194 ,8020 ,3826 ,0 ,0 ,0 ,4194 
United Republic of Tanzania,Jamhuri ya Muungano wa Tanzania,TZ,Kilimanjaro,TZ03,Mwanga,TZ0302,Kighare,TZ0302051,6254 ,2915 ,3339 ,6254 ,2915 ,0 ,0 ,0 ,3339 
United Republic of Tanzania,Jamhuri ya Muungano wa Tanzania,TZ,Kilimanjaro,TZ03,Mwanga,TZ0302,Kirongwe,TZ0302061,4771 ,2228 ,2543 ,4771 ,2228 ,0 ,0 ,0 ,2543 
United Republic of Tanzania,Jamhuri ya Muungano wa Tanzania,TZ,Kilimanjaro,TZ03,Mwanga,TZ0302,Kwakoa,TZ0302071,3717 ,1869 ,1848 ,3717 ,1869 ,0 ,0 ,0 ,1848 
United Republic of Tanzania,Jamhuri ya Muungano wa Tanzania,TZ,Kilimanjaro,TZ03,Mwanga,TZ0302,Lembeni,TZ0302083,11780 ,5666 ,6114 ,5100 ,2503 ,6680 ,3163 ,3517 ,2597 
United Republic of Tanzania,Jamhuri ya Muungano wa Tanzania,TZ,Kilimanjaro,TZ03,Mwanga,TZ0302,Jipe,TZ0302091,2564 ,1294 ,1270 ,2564 ,1294 ,0 ,0 ,0 ,1270 
United Republic of Tanzania,Jamhuri ya Muungano wa Tanzania,TZ,Kilimanjaro,TZ03,Mwanga,TZ0302,Mwaniko,TZ0302101,7741 ,3693 ,4048 ,7741 ,3693 ,0 ,0 ,0 ,4048 
United Republic of Tanzania,Jamhuri ya Muungano wa Tanzania,TZ,Kilimanjaro,TZ03,Mwanga,TZ0302,Chomvu,TZ0302111,7444 ,3401 ,4043 ,7444 ,3401 ,0 ,0 ,0 ,4043 
United Republic of Tanzania,Jamhuri ya Muungano wa Tanzania,TZ,Kilimanjaro,TZ03,Mwanga,TZ0302,Ngujini,TZ0302121,3314 ,1483 ,1831 ,3314 ,1483 ,0 ,0 ,0 ,1831 
United Republic of Tanzania,Jamhuri ya Muungano wa Tanzania,TZ,Kilimanjaro,TZ03,Mwanga,TZ0302,Kirya,TZ0302133,4917 ,2531 ,2386 ,2165 ,1159 ,2752 ,1372 ,1380 ,1006 
United Republic of Tanzania,Jamhuri ya Muungano wa Tanzania,TZ,Kilimanjaro,TZ03,Mwanga,TZ0302,Kilomeni,TZ0302141,4467 ,2139 ,2328 ,4467 ,2139 ,0 ,0 ,0 ,2328 
United Republic of Tanzania,Jamhuri ya Muungano wa Tanzania,TZ,Kilimanjaro,TZ03,Mwanga,TZ0302,Shighatini,TZ0302151,7765 ,3740 ,4025 ,7765 ,3740 ,0 ,0 ,0 ,4025 
United Republic of Tanzania,Jamhuri ya Muungano wa Tanzania,TZ,Kilimanjaro,TZ03,Mwanga,TZ0302,Lang'ata,TZ0302163,8965 ,4435 ,4530 ,1761 ,898 ,7204 ,3537 ,3667 ,863 
United Republic of Tanzania,Jamhuri ya Muungano wa Tanzania,TZ,Kilimanjaro,TZ03,Mwanga,TZ0302,Mgagao,TZ0302171,6011 ,2879 ,3132 ,6011 ,2879 ,0 ,0 ,0 ,3132 
United Republic of Tanzania,Jamhuri ya Muungano wa Tanzania,TZ,Kilimanjaro,TZ03,Mwanga,TZ0302,Toloha,TZ0302181,3055 ,1484 ,1571 ,3055 ,1484 ,0 ,0 ,0 ,1571 
United Republic of Tanzania,Jamhuri ya Muungano wa Tanzania,TZ,Kilimanjaro,TZ03,Mwanga,TZ0302,Kigoningoni,TZ0302191,2610 ,1364 ,1246 ,2610 ,1364 ,0 ,0 ,0 ,1246 
United Republic of Tanzania,Jamhuri ya Muungano wa Tanzania,TZ,Kilimanjaro,TZ03,Mwanga,TZ0302,Kivisini,TZ0302201,1694 ,880 ,814 ,1694 ,880 ,0 ,0 ,0 ,814 
United Republic of Tanzania,Jamhuri ya Muungano wa Tanzania,TZ,Kilimanjaro,TZ03,Same,TZ0303,Same,TZ0303012,9049 ,4194 ,4855 ,0 ,0 ,9049 ,4194 ,4855 ,0 
United Republic of Tanzania,Jamhuri ya Muungano wa Tanzania,TZ,Kilimanjaro,TZ03,Same,TZ0303,Ruvu,TZ0303021,14261 ,7439 ,6822 ,14261 ,7439 ,0 ,0 ,0 ,6822 
United Republic of Tanzania,Jamhuri ya Muungano wa Tanzania,TZ,Kilimanjaro,TZ03,Same,TZ0303,Njoro,TZ0303031,5368 ,2599 ,2769 ,5368 ,2599 ,0 ,0 ,0 ,2769 
United Republic of Tanzania,Jamhuri ya Muungano wa Tanzania,TZ,Kilimanjaro,TZ03,Same,TZ0303,Kisiwani,TZ0303043,9309 ,4314 ,4995 ,4356 ,1969 ,4953 ,2345 ,2608 ,2387 
United Republic of Tanzania,Jamhuri ya Muungano wa Tanzania,TZ,Kilimanjaro,TZ03,Same,TZ0303,Msindo,TZ0303051,6495 ,3179 ,3316 ,6495 ,3179 ,0 ,0 ,0 ,3316 
United Republic of Tanzania,Jamhuri ya Muungano wa Tanzania,TZ,Kilimanjaro,TZ03,Same,TZ0303,Mshewa,TZ0303061,6154 ,3077 ,3077 ,6154 ,3077 ,0 ,0 ,0 ,3077 
United Republic of Tanzania,Jamhuri ya Muungano wa Tanzania,TZ,Kilimanjaro,TZ03,Same,TZ0303,Mhezi,TZ0303071,4790 ,2348 ,2442 ,4790 ,2348 ,0 ,0 ,0 ,2442 
United Republic of Tanzania,Jamhuri ya Muungano wa Tanzania,TZ,Kilimanjaro,TZ03,Same,TZ0303,Mwembe,TZ0303083,11913 ,5935 ,5978 ,8292 ,4159 ,3621 ,1776 ,1845 ,4133 
United Republic of Tanzania,Jamhuri ya Muungano wa Tanzania,TZ,Kilimanjaro,TZ03,Same,TZ0303,Vudee,TZ0303091,7120 ,3529 ,3591 ,7120 ,3529 ,0 ,0 ,0 ,3591 
United Republic of Tanzania,Jamhuri ya Muungano wa Tanzania,TZ,Kilimanjaro,TZ03,Same,TZ0303,Vuje,TZ0303101,10726 ,5288 ,5438 ,10726 ,5288 ,0 ,0 ,0 ,5438 
United Republic of Tanzania,Jamhuri ya Muungano wa Tanzania,TZ,Kilimanjaro,TZ03,Same,TZ0303,Bombo,TZ0303111,5530 ,2711 ,2819 ,5530 ,2711 ,0 ,0 ,0 ,2819 
United Republic of Tanzania,Jamhuri ya Muungano wa Tanzania,TZ,Kilimanjaro,TZ03,Same,TZ0303,Mtii,TZ0303121,5488 ,2706 ,2782 ,5488 ,2706 ,0 ,0 ,0 ,2782 
United Republic of Tanzania,Jamhuri ya Muungano wa Tanzania,TZ,Kilimanjaro,TZ03,Same,TZ0303,Maore,TZ0303133,15722 ,7682 ,8040 ,9081 ,4457 ,6641 ,3225 ,3416 ,4624 
United Republic of Tanzania,Jamhuri ya Muungano wa Tanzania,TZ,Kilimanjaro,TZ03,Same,TZ0303,Ndungu,TZ0303143,13636 ,6557 ,7079 ,2319 ,1129 ,11317 ,5428 ,5889 ,1190 
United Republic of Tanzania,Jamhuri ya Muungano wa Tanzania,TZ,Kilimanjaro,TZ03,Same,TZ0303,Kihurio,TZ0303153,10341 ,5032 ,5309 ,966 ,489 ,9375 ,4543 ,4832 ,477 
United Republic of Tanzania,Jamhuri ya Muungano wa Tanzania,TZ,Kilimanjaro,TZ03,Same,TZ0303,Bendera,TZ0303163,4913 ,2358 ,2555 ,840 ,404 ,4073 ,1954 ,2119 ,436 
United Republic of Tanzania,Jamhuri ya Muungano wa Tanzania,TZ,Kilimanjaro,TZ03,Same,TZ0303,Myamba,TZ0303171,13168 ,6521 ,6647 ,13168 ,6521 ,0 ,0 ,0 ,6647 
United Republic of Tanzania,Jamhuri ya Muungano wa Tanzania,TZ,Kilimanjaro,TZ03,Same,TZ0303,Mpinji,TZ0303181,8453 ,4177 ,4276 ,8453 ,4177 ,0 ,0 ,0 ,4276 
United Republic of Tanzania,Jamhuri ya Muungano wa Tanzania,TZ,Kilimanjaro,TZ03,Same,TZ0303,Bwambo,TZ0303191,9479 ,4705 ,4774 ,9479 ,4705 ,0 ,0 ,0 ,4774 
United Republic of Tanzania,Jamhuri ya Muungano wa Tanzania,TZ,Kilimanjaro,TZ03,Same,TZ0303,Vunta,TZ0303201,8659 ,4126 ,4533 ,8659 ,4126 ,0 ,0 ,0 ,4533 
United Republic of Tanzania,Jamhuri ya Muungano wa Tanzania,TZ,Kilimanjaro,TZ03,Same,TZ0303,Chome,TZ0303211,5893 ,2924 ,2969 ,5893 ,2924 ,0 ,0 ,0 ,2969 
United Republic of Tanzania,Jamhuri ya Muungano wa Tanzania,TZ,Kilimanjaro,TZ03,Same,TZ0303,Suji,TZ0303221,8776 ,4377 ,4399 ,8776 ,4377 ,0 ,0 ,0 ,4399 
United Republic of Tanzania,Jamhuri ya Muungano wa Tanzania,TZ,Kilimanjaro,TZ03,Same,TZ0303,Makanya,TZ0303233,10629 ,5321 ,5308 ,4740 ,2446 ,5889 ,2875 ,3014 ,2294 
United Republic of Tanzania,Jamhuri ya Muungano wa Tanzania,TZ,Kilimanjaro,TZ03,Same,TZ0303,Hedaru,TZ0303243,18476 ,8749 ,9727 ,2304 ,1105 ,16172 ,7644 ,8528 ,1199 
United Republic of Tanzania,Jamhuri ya Muungano wa Tanzania,TZ,Kilimanjaro,TZ03,Same,TZ0303,Kirangare,TZ0303251,5528 ,2667 ,2861 ,5528 ,2667 ,0 ,0 ,0 ,2861 
United Republic of Tanzania,Jamhuri ya Muungano wa Tanzania,TZ,Kilimanjaro,TZ03,Same,TZ0303,Kisima,TZ0303262,9885 ,4119 ,5766 ,0 ,0 ,9885 ,4119 ,5766 ,0 
United Republic of Tanzania,Jamhuri ya Muungano wa Tanzania,TZ,Kilimanjaro,TZ03,Same,TZ0303,Stesheni,TZ0303272,6860 ,3289 ,3571 ,0 ,0 ,6860 ,3289 ,3571 ,0 
United Republic of Tanzania,Jamhuri ya Muungano wa Tanzania,TZ,Kilimanjaro,TZ03,Same,TZ0303,Vumari,TZ0303281,5908 ,2971 ,2937 ,5908 ,2971 ,0 ,0 ,0 ,2937 
United Republic of Tanzania,Jamhuri ya Muungano wa Tanzania,TZ,Kilimanjaro,TZ03,Same,TZ0303,Mabilioni,TZ0303291,6570 ,3256 ,3314 ,6570 ,3256 ,0 ,0 ,0 ,3314 
United Republic of Tanzania,Jamhuri ya Muungano wa Tanzania,TZ,Kilimanjaro,TZ03,Same,TZ0303,Kalemawe,TZ0303301,4248 ,2134 ,2114 ,4248 ,2134 ,0 ,0 ,0 ,2114 
United Republic of Tanzania,Jamhuri ya Muungano wa Tanzania,TZ,Kilimanjaro,TZ03,Same,TZ0303,Lugulu,TZ0303311,6460 ,3231 ,3229 ,6460 ,3231 ,0 ,0 ,0 ,3229 
United Republic of Tanzania,Jamhuri ya Muungano wa Tanzania,TZ,Kilimanjaro,TZ03,Moshi,TZ0304,Mwika Kusini,TZ0304011,19645 ,9591 ,10054 ,19645 ,9591 ,0 ,0 ,0 ,10054 
United Republic of Tanzania,Jamhuri ya Muungano wa Tanzania,TZ,Kilimanjaro,TZ03,Moshi,TZ0304,MwikaKaskazini,TZ0304021,21177 ,10387 ,10790 ,21177 ,10387 ,0 ,0 ,0 ,10790 
United Republic of Tanzania,Jamhuri ya Muungano wa Tanzania,TZ,Kilimanjaro,TZ03,Moshi,TZ0304,Mamba Kaskazini,TZ0304031,9065 ,4366 ,4699 ,9065 ,4366 ,0 ,0 ,0 ,4699 
United Republic of Tanzania,Jamhuri ya Muungano wa Tanzania,TZ,Kilimanjaro,TZ03,Moshi,TZ0304,Mamba Kusini,TZ0304041,10060 ,4888 ,5172 ,10060 ,4888 ,0 ,0 ,0 ,5172 
United Republic of Tanzania,Jamhuri ya Muungano wa Tanzania,TZ,Kilimanjaro,TZ03,Moshi,TZ0304,Marangu Mashariki,TZ0304051,23734 ,11455 ,12279 ,23734 ,11455 ,0 ,0 ,0 ,12279 
United Republic of Tanzania,Jamhuri ya Muungano wa Tanzania,TZ,Kilimanjaro,TZ03,Moshi,TZ0304,Marangu Magharibi,TZ0304061,18976 ,9132 ,9844 ,18976 ,9132 ,0 ,0 ,0 ,9844 
United Republic of Tanzania,Jamhuri ya Muungano wa Tanzania,TZ,Kilimanjaro,TZ03,Moshi,TZ0304,Makuyuni,TZ0304073,22442 ,10781 ,11661 ,6134 ,3056 ,16308 ,7725 ,8583 ,3078 
United Republic of Tanzania,Jamhuri ya Muungano wa Tanzania,TZ,Kilimanjaro,TZ03,Moshi,TZ0304,Kilema Kaskazini,TZ0304081,9669 ,4592 ,5077 ,9669 ,4592 ,0 ,0 ,0 ,5077 
United Republic of Tanzania,Jamhuri ya Muungano wa Tanzania,TZ,Kilimanjaro,TZ03,Moshi,TZ0304,Kilema Kusini,TZ0304091,22711 ,11114 ,11597 ,22711 ,11114 ,0 ,0 ,0 ,11597 
United Republic of Tanzania,Jamhuri ya Muungano wa Tanzania,TZ,Kilimanjaro,TZ03,Moshi,TZ0304,KiruaVunjo Mashariki,TZ0304101,8657 ,4306 ,4351 ,8657 ,4306 ,0 ,0 ,0 ,4351 
United Republic of Tanzania,Jamhuri ya Muungano wa Tanzania,TZ,Kilimanjaro,TZ03,Moshi,TZ0304,KiruaVunjo Magharibi,TZ0304111,12840 ,6266 ,6574 ,12840 ,6266 ,0 ,0 ,0 ,6574 
United Republic of Tanzania,Jamhuri ya Muungano wa Tanzania,TZ,Kilimanjaro,TZ03,Moshi,TZ0304,Kahe,TZ0304121,19142 ,9581 ,9561 ,19142 ,9581 ,0 ,0 ,0 ,9561 
United Republic of Tanzania,Jamhuri ya Muungano wa Tanzania,TZ,Kilimanjaro,TZ03,Moshi,TZ0304,Kahe Mashariki,TZ0304131,11384 ,5789 ,5595 ,11384 ,5789 ,0 ,0 ,0 ,5595 
United Republic of Tanzania,Jamhuri ya Muungano wa Tanzania,TZ,Kilimanjaro,TZ03,Moshi,TZ0304,Old Moshi Mashariki,TZ0304141,9528 ,4575 ,4953 ,9528 ,4575 ,0 ,0 ,0 ,4953 
United Republic of Tanzania,Jamhuri ya Muungano wa Tanzania,TZ,Kilimanjaro,TZ03,Moshi,TZ0304,Old Moshi Magharibi,TZ0304151,8100 ,4036 ,4064 ,8100 ,4036 ,0 ,0 ,0 ,4064 
United Republic of Tanzania,Jamhuri ya Muungano wa Tanzania,TZ,Kilimanjaro,TZ03,Moshi,TZ0304,Mbokomu,TZ0304161,14606 ,7036 ,7570 ,14606 ,7036 ,0 ,0 ,0 ,7570 
United Republic of Tanzania,Jamhuri ya Muungano wa Tanzania,TZ,Kilimanjaro,TZ03,Moshi,TZ0304,Uru Mashariki,TZ0304171,14781 ,7248 ,7533 ,14781 ,7248 ,0 ,0 ,0 ,7533 
United Republic of Tanzania,Jamhuri ya Muungano wa Tanzania,TZ,Kilimanjaro,TZ03,Moshi,TZ0304,Uru Shimbwe,TZ0304181,6107 ,2844 ,3263 ,6107 ,2844 ,0 ,0 ,0 ,3263 
United Republic of Tanzania,Jamhuri ya Muungano wa Tanzania,TZ,Kilimanjaro,TZ03,Moshi,TZ0304,Uru Kusini,TZ0304191,22904 ,11065 ,11839 ,22904 ,11065 ,0 ,0 ,0 ,11839 
United Republic of Tanzania,Jamhuri ya Muungano wa Tanzania,TZ,Kilimanjaro,TZ03,Moshi,TZ0304,Uru Kaskazini,TZ0304201,11081 ,5331 ,5750 ,11081 ,5331 ,0 ,0 ,0 ,5750 
United Republic of Tanzania,Jamhuri ya Muungano wa Tanzania,TZ,Kilimanjaro,TZ03,Moshi,TZ0304,Mabogini,TZ0304211,28992 ,14320 ,14672 ,28992 ,14320 ,0 ,0 ,0 ,14672 
United Republic of Tanzania,Jamhuri ya Muungano wa Tanzania,TZ,Kilimanjaro,TZ03,Moshi,TZ0304,Arusha Chini,TZ0304221,13960 ,7227 ,6733 ,13960 ,7227 ,0 ,0 ,0 ,6733 
United Republic of Tanzania,Jamhuri ya Muungano wa Tanzania,TZ,Kilimanjaro,TZ03,Moshi,TZ0304,Kibosho Mashariki,TZ0304231,14148 ,6374 ,7774 ,14148 ,6374 ,0 ,0 ,0 ,7774 
United Republic of Tanzania,Jamhuri ya Muungano wa Tanzania,TZ,Kilimanjaro,TZ03,Moshi,TZ0304,Kibosho Kati,TZ0304241,10258 ,4613 ,5645 ,10258 ,4613 ,0 ,0 ,0 ,5645 
United Republic of Tanzania,Jamhuri ya Muungano wa Tanzania,TZ,Kilimanjaro,TZ03,Moshi,TZ0304,Kibosho Magharibi,TZ0304251,20291 ,9737 ,10554 ,20291 ,9737 ,0 ,0 ,0 ,10554 
United Republic of Tanzania,Jamhuri ya Muungano wa Tanzania,TZ,Kilimanjaro,TZ03,Moshi,TZ0304,Kindi,TZ0304261,21391 ,10222 ,11169 ,21391 ,10222 ,0 ,0 ,0 ,11169 
United Republic of Tanzania,Jamhuri ya Muungano wa Tanzania,TZ,Kilimanjaro,TZ03,Moshi,TZ0304,KiruaVunjo Kusini,TZ0304271,19378 ,9455 ,9923 ,19378 ,9455 ,0 ,0 ,0 ,9923 
United Republic of Tanzania,Jamhuri ya Muungano wa Tanzania,TZ,Kilimanjaro,TZ03,Moshi,TZ0304,Kirima,TZ0304281,10709 ,4890 ,5819 ,10709 ,4890 ,0 ,0 ,0 ,5819 
United Republic of Tanzania,Jamhuri ya Muungano wa Tanzania,TZ,Kilimanjaro,TZ03,Moshi,TZ0304,Okaoni,TZ0304291,10446 ,4709 ,5737 ,10446 ,4709 ,0 ,0 ,0 ,5737 
United Republic of Tanzania,Jamhuri ya Muungano wa Tanzania,TZ,Kilimanjaro,TZ03,Moshi,TZ0304,Kimochi,TZ0304301,13562 ,6476 ,7086 ,13562 ,6476 ,0 ,0 ,0 ,7086 
United Republic of Tanzania,Jamhuri ya Muungano wa Tanzania,TZ,Kilimanjaro,TZ03,Moshi,TZ0304,Kilema Kati,TZ0304311,6993 ,3361 ,3632 ,6993 ,3361 ,0 ,0 ,0 ,3632 
United Republic of Tanzania,Jamhuri ya Muungano wa Tanzania,TZ,Kilimanjaro,TZ03,Hai,TZ0305,Machame Mashariki,TZ0305011,13084 ,6353 ,6731 ,13084 ,6353 ,0 ,0 ,0 ,6731 
United Republic of Tanzania,Jamhuri ya Muungano wa Tanzania,TZ,Kilimanjaro,TZ03,Hai,TZ0305,Machame Kusini,TZ0305021,13572 ,6828 ,6744 ,13572 ,6828 ,0 ,0 ,0 ,6744 
United Republic of Tanzania,Jamhuri ya Muungano wa Tanzania,TZ,Kilimanjaro,TZ03,Hai,TZ0305,Machame Kaskazini,TZ0305031,23334 ,11317 ,12017 ,23334 ,11317 ,0 ,0 ,0 ,12017 
United Republic of Tanzania,Jamhuri ya Muungano wa Tanzania,TZ,Kilimanjaro,TZ03,Hai,TZ0305,Machame Magharibi,TZ0305041,6503 ,3156 ,3347 ,6503 ,3156 ,0 ,0 ,0 ,3347 
United Republic of Tanzania,Jamhuri ya Muungano wa Tanzania,TZ,Kilimanjaro,TZ03,Hai,TZ0305,Machame Uroki,TZ0305051,10762 ,5293 ,5469 ,10762 ,5293 ,0 ,0 ,0 ,5469 
United Republic of Tanzania,Jamhuri ya Muungano wa Tanzania,TZ,Kilimanjaro,TZ03,Hai,TZ0305,Masama Mashariki,TZ0305061,25723 ,12481 ,13242 ,25723 ,12481 ,0 ,0 ,0 ,13242 
United Republic of Tanzania,Jamhuri ya Muungano wa Tanzania,TZ,Kilimanjaro,TZ03,Hai,TZ0305,Masama Magharibi,TZ0305071,10851 ,5357 ,5494 ,10851 ,5357 ,0 ,0 ,0 ,5494 
United Republic of Tanzania,Jamhuri ya Muungano wa Tanzania,TZ,Kilimanjaro,TZ03,Hai,TZ0305,Masama Kusini,TZ0305083,12060 ,5824 ,6236 ,7331 ,3559 ,4729 ,2265 ,2464 ,3772 
United Republic of Tanzania,Jamhuri ya Muungano wa Tanzania,TZ,Kilimanjaro,TZ03,Hai,TZ0305,Masama Rundugai,TZ0305093,14033 ,7036 ,6997 ,14033 ,7036 ,0 ,0 ,0 ,6997 
United Republic of Tanzania,Jamhuri ya Muungano wa Tanzania,TZ,Kilimanjaro,TZ03,Hai,TZ0305,Hai Mjini,TZ0305102,34098 ,16157 ,17941 ,0 ,0 ,34098 ,16157 ,17941 ,0 
United Republic of Tanzania,Jamhuri ya Muungano wa Tanzania,TZ,Kilimanjaro,TZ03,Hai,TZ0305,Masama Kati,TZ0305111,11562 ,5601 ,5961 ,11562 ,5601 ,0 ,0 ,0 ,5961 
United Republic of Tanzania,Jamhuri ya Muungano wa Tanzania,TZ,Kilimanjaro,TZ03,Hai,TZ0305,Machame Weruweru,TZ0305121,12402 ,6141 ,6261 ,12402 ,6141 ,0 ,0 ,0 ,6261 
United Republic of Tanzania,Jamhuri ya Muungano wa Tanzania,TZ,Kilimanjaro,TZ03,Hai,TZ0305,KIA,TZ0305133,10472 ,5225 ,5247 ,8835 ,4432 ,1637 ,793 ,844 ,4403 
United Republic of Tanzania,Jamhuri ya Muungano wa Tanzania,TZ,Kilimanjaro,TZ03,Hai,TZ0305,Machame Narumu,TZ0305141,12077 ,5688 ,6389 ,12077 ,5688 ,0 ,0 ,0 ,6389 
United Republic of Tanzania,Jamhuri ya Muungano wa Tanzania,TZ,Kilimanjaro,TZ03,Moshi Urban,TZ0306,Kilimanjaro,TZ0306012,5233 ,2539 ,2694 ,0 ,0 ,5233 ,2539 ,2694 ,0 
United Republic of Tanzania,Jamhuri ya Muungano wa Tanzania,TZ,Kilimanjaro,TZ03,Moshi Urban,TZ0306,Njoro,TZ0306022,14296 ,6992 ,7304 ,0 ,0 ,14296 ,6992 ,7304 ,0 
United Republic of Tanzania,Jamhuri ya Muungano wa Tanzania,TZ,Kilimanjaro,TZ03,Moshi Urban,TZ0306,Mji Mpya,TZ0306032,15293 ,7349 ,7944 ,0 ,0 ,15293 ,7349 ,7944 ,0 
United Republic of Tanzania,Jamhuri ya Muungano wa Tanzania,TZ,Kilimanjaro,TZ03,Moshi Urban,TZ0306,Majengo,TZ0306042,9006 ,4375 ,4631 ,0 ,0 ,9006 ,4375 ,4631 ,0 
United Republic of Tanzania,Jamhuri ya Muungano wa Tanzania,TZ,Kilimanjaro,TZ03,Moshi Urban,TZ0306,Mawenzi,TZ0306052,1770 ,773 ,997 ,0 ,0 ,1770 ,773 ,997 ,0 
United Republic of Tanzania,Jamhuri ya Muungano wa Tanzania,TZ,Kilimanjaro,TZ03,Moshi Urban,TZ0306,Rau,TZ0306062,9137 ,4294 ,4843 ,0 ,0 ,9137 ,4294 ,4843 ,0 
United Republic of Tanzania,Jamhuri ya Muungano wa Tanzania,TZ,Kilimanjaro,TZ03,Moshi Urban,TZ0306,Korongoni,TZ0306072,5815 ,2757 ,3058 ,0 ,0 ,5815 ,2757 ,3058 ,0 
United Republic of Tanzania,Jamhuri ya Muungano wa Tanzania,TZ,Kilimanjaro,TZ03,Moshi Urban,TZ0306,Kiusa,TZ0306082,5950 ,2911 ,3039 ,0 ,0 ,5950 ,2911 ,3039 ,0 
United Republic of Tanzania,Jamhuri ya Muungano wa Tanzania,TZ,Kilimanjaro,TZ03,Moshi Urban,TZ0306,Bondeni,TZ0306092,4050 ,2045 ,2005 ,0 ,0 ,4050 ,2045 ,2005 ,0 
United Republic of Tanzania,Jamhuri ya Muungano wa Tanzania,TZ,Kilimanjaro,TZ03,Moshi Urban,TZ0306,Pasua,TZ0306102,13460 ,6572 ,6888 ,0 ,0 ,13460 ,6572 ,6888 ,0 
United Republic of Tanzania,Jamhuri ya Muungano wa Tanzania,TZ,Kilimanjaro,TZ03,Moshi Urban,TZ0306,Kaloleni,TZ0306112,6554 ,3208 ,3346 ,0 ,0 ,6554 ,3208 ,3346 ,0 
United Republic of Tanzania,Jamhuri ya Muungano wa Tanzania,TZ,Kilimanjaro,TZ03,Moshi Urban,TZ0306,Kiboriloni,TZ0306122,9206 ,4290 ,4916 ,0 ,0 ,9206 ,4290 ,4916 ,0 
United Republic of Tanzania,Jamhuri ya Muungano wa Tanzania,TZ,Kilimanjaro,TZ03,Moshi Urban,TZ0306,Msaranga,TZ0306132,7699 ,3760 ,3939 ,0 ,0 ,7699 ,3760 ,3939 ,0 
United Republic of Tanzania,Jamhuri ya Muungano wa Tanzania,TZ,Kilimanjaro,TZ03,Moshi Urban,TZ0306,Karanga,TZ0306142,7124 ,4115 ,3009 ,0 ,0 ,7124 ,4115 ,3009 ,0 
United Republic of Tanzania,Jamhuri ya Muungano wa Tanzania,TZ,Kilimanjaro,TZ03,Moshi Urban,TZ0306,Longuo B,TZ0306152,6632 ,3044 ,3588 ,0 ,0 ,6632 ,3044 ,3588 ,0 
United Republic of Tanzania,Jamhuri ya Muungano wa Tanzania,TZ,Kilimanjaro,TZ03,Moshi Urban,TZ0306,Miembeni,TZ0306162,15220 ,7438 ,7782 ,0 ,0 ,15220 ,7438 ,7782 ,0 
United Republic of Tanzania,Jamhuri ya Muungano wa Tanzania,TZ,Kilimanjaro,TZ03,Moshi Urban,TZ0306,Mfumuni,TZ0306172,4750 ,2205 ,2545 ,0 ,0 ,4750 ,2205 ,2545 ,0 
United Republic of Tanzania,Jamhuri ya Muungano wa Tanzania,TZ,Kilimanjaro,TZ03,Moshi Urban,TZ0306,Soweto,TZ0306182,14946 ,7219 ,7727 ,0 ,0 ,14946 ,7219 ,7727 ,0 
United Republic of Tanzania,Jamhuri ya Muungano wa Tanzania,TZ,Kilimanjaro,TZ03,Moshi Urban,TZ0306,Boma Mbuzi,TZ0306192,15776 ,7518 ,8258 ,0 ,0 ,15776 ,7518 ,8258 ,0 
United Republic of Tanzania,Jamhuri ya Muungano wa Tanzania,TZ,Kilimanjaro,TZ03,Moshi Urban,TZ0306,Ng'ambo,TZ0306202,7890 ,3635 ,4255 ,0 ,0 ,7890 ,3635 ,4255 ,0 
United Republic of Tanzania,Jamhuri ya Muungano wa Tanzania,TZ,Kilimanjaro,TZ03,Moshi Urban,TZ0306,Shirimatunda,TZ0306212,4485 ,2135 ,2350 ,0 ,0 ,4485 ,2135 ,2350 ,0 
United Republic of Tanzania,Jamhuri ya Muungano wa Tanzania,TZ,Kilimanjaro,TZ03,Siha,TZ0307,Ndumeti,TZ0307011,11344 ,5729 ,5615 ,11344 ,5729 ,0 ,0 ,0 ,5615 
United Republic of Tanzania,Jamhuri ya Muungano wa Tanzania,TZ,Kilimanjaro,TZ03,Siha,TZ0307,Ngarenairobi,TZ0307023,9431 ,4679 ,4752 ,6803 ,3370 ,2628 ,1309 ,1319 ,3433 
United Republic of Tanzania,Jamhuri ya Muungano wa Tanzania,TZ,Kilimanjaro,TZ03,Siha,TZ0307,Gararagua,TZ0307031,9884 ,4693 ,5191 ,9884 ,4693 ,0 ,0 ,0 ,5191 
United Republic of Tanzania,Jamhuri ya Muungano wa Tanzania,TZ,Kilimanjaro,TZ03,Siha,TZ0307,Sanya Juu,TZ0307042,11283 ,5422 ,5861 ,0 ,0 ,11283 ,5422 ,5861 ,0 
United Republic of Tanzania,Jamhuri ya Muungano wa Tanzania,TZ,Kilimanjaro,TZ03,Siha,TZ0307,Biriri,TZ0307051,7768 ,3690 ,4078 ,7768 ,3690 ,0 ,0 ,0 ,4078 
United Republic of Tanzania,Jamhuri ya Muungano wa Tanzania,TZ,Kilimanjaro,TZ03,Siha,TZ0307,Makiwaru,TZ0307061,10699 ,5213 ,5486 ,10699 ,5213 ,0 ,0 ,0 ,5486 
United Republic of Tanzania,Jamhuri ya Muungano wa Tanzania,TZ,Kilimanjaro,TZ03,Siha,TZ0307,Nasai,TZ0307071,8032 ,3881 ,4151 ,8032 ,3881 ,0 ,0 ,0 ,4151 
United Republic of Tanzania,Jamhuri ya Muungano wa Tanzania,TZ,Kilimanjaro,TZ03,Siha,TZ0307,Livishi,TZ0307081,6140 ,3059 ,3081 ,6140 ,3059 ,0 ,0 ,0 ,3081 
United Republic of Tanzania,Jamhuri ya Muungano wa Tanzania,TZ,Kilimanjaro,TZ03,Siha,TZ0307,Ivaeny,TZ0307091,10748 ,5205 ,5543 ,10748 ,5205 ,0 ,0 ,0 ,5543 
United Republic of Tanzania,Jamhuri ya Muungano wa Tanzania,TZ,Kilimanjaro,TZ03,Siha,TZ0307,Kashisha,TZ0307101,6694 ,3248 ,3446 ,6694 ,3248 ,0 ,0 ,0 ,3446 
United Republic of Tanzania,Jamhuri ya Muungano wa Tanzania,TZ,Kilimanjaro,TZ03,Siha,TZ0307,Karansi,TZ0307111,11394 ,5447 ,5947 ,11394 ,5447 ,0 ,0 ,0 ,5947 
United Republic of Tanzania,Jamhuri ya Muungano wa Tanzania,TZ,Kilimanjaro,TZ03,Siha,TZ0307,Olkolili,TZ0307121,12896 ,6234 ,6662 ,12896 ,6234 ,0 ,0 ,0 ,6662 
United Republic of Tanzania,Jamhuri ya Muungano wa Tanzania,TZ,Tanga,TZ04,Lushoto,TZ0401,Lushoto,TZ0401012,28190 ,13258 ,14932 ,0 ,0 ,28190 ,13258 ,14932 ,0 
United Republic of Tanzania,Jamhuri ya Muungano wa Tanzania,TZ,Tanga,TZ04,Lushoto,TZ0401,Gare,TZ0401021,12477 ,5830 ,6647 ,12477 ,5830 ,0 ,0 ,0 ,6647 
United Republic of Tanzania,Jamhuri ya Muungano wa Tanzania,TZ,Tanga,TZ04,Lushoto,TZ0401,Kwai,TZ0401031,12829 ,6108 ,6721 ,12829 ,6108 ,0 ,0 ,0 ,6721 
United Republic of Tanzania,Jamhuri ya Muungano wa Tanzania,TZ,Tanga,TZ04,Lushoto,TZ0401,Ubiri,TZ0401041,6325 ,2943 ,3382 ,6325 ,2943 ,0 ,0 ,0 ,3382 
United Republic of Tanzania,Jamhuri ya Muungano wa Tanzania,TZ,Tanga,TZ04,Lushoto,TZ0401,Soni,TZ0401053,12839 ,5968 ,6871 ,9451 ,4458 ,3388 ,1510 ,1878 ,4993 
United Republic of Tanzania,Jamhuri ya Muungano wa Tanzania,TZ,Tanga,TZ04,Lushoto,TZ0401,Vuga,TZ0401061,11128 ,5320 ,5808 ,11128 ,5320 ,0 ,0 ,0 ,5808 
United Republic of Tanzania,Jamhuri ya Muungano wa Tanzania,TZ,Tanga,TZ04,Lushoto,TZ0401,Mponde,TZ0401071,11232 ,5562 ,5670 ,11232 ,5562 ,0 ,0 ,0 ,5670 
United Republic of Tanzania,Jamhuri ya Muungano wa Tanzania,TZ,Tanga,TZ04,Lushoto,TZ0401,Mamba,TZ0401081,11359 ,5315 ,6044 ,11359 ,5315 ,0 ,0 ,0 ,6044 
United Republic of Tanzania,Jamhuri ya Muungano wa Tanzania,TZ,Tanga,TZ04,Lushoto,TZ0401,Mbuzii,TZ0401091,6882 ,3261 ,3621 ,6882 ,3261 ,0 ,0 ,0 ,3621 
United Republic of Tanzania,Jamhuri ya Muungano wa Tanzania,TZ,Tanga,TZ04,Lushoto,TZ0401,Tamota,TZ0401101,8300 ,3949 ,4351 ,8300 ,3949 ,0 ,0 ,0 ,4351 
United Republic of Tanzania,Jamhuri ya Muungano wa Tanzania,TZ,Tanga,TZ04,Lushoto,TZ0401,Bumbuli,TZ0401111,10159 ,4849 ,5310 ,10159 ,4849 ,0 ,0 ,0 ,5310 
United Republic of Tanzania,Jamhuri ya Muungano wa Tanzania,TZ,Tanga,TZ04,Lushoto,TZ0401,Funta,TZ0401121,10592 ,4959 ,5633 ,10592 ,4959 ,0 ,0 ,0 ,5633 
United Republic of Tanzania,Jamhuri ya Muungano wa Tanzania,TZ,Tanga,TZ04,Lushoto,TZ0401,Mayo,TZ0401131,12218 ,5862 ,6356 ,12218 ,5862 ,0 ,0 ,0 ,6356 
United Republic of Tanzania,Jamhuri ya Muungano wa Tanzania,TZ,Tanga,TZ04,Lushoto,TZ0401,Baga,TZ0401141,8521 ,4053 ,4468 ,8521 ,4053 ,0 ,0 ,0 ,4468 
United Republic of Tanzania,Jamhuri ya Muungano wa Tanzania,TZ,Tanga,TZ04,Lushoto,TZ0401,Milingano,TZ0401151,12467 ,6035 ,6432 ,12467 ,6035 ,0 ,0 ,0 ,6432 
United Republic of Tanzania,Jamhuri ya Muungano wa Tanzania,TZ,Tanga,TZ04,Lushoto,TZ0401,Mgwashi,TZ0401161,12772 ,6104 ,6668 ,12772 ,6104 ,0 ,0 ,0 ,6668 
United Republic of Tanzania,Jamhuri ya Muungano wa Tanzania,TZ,Tanga,TZ04,Lushoto,TZ0401,Mtae,TZ0401171,12851 ,5614 ,7237 ,12851 ,5614 ,0 ,0 ,0 ,7237 
United Republic of Tanzania,Jamhuri ya Muungano wa Tanzania,TZ,Tanga,TZ04,Lushoto,TZ0401,Sunga,TZ0401181,20452 ,9057 ,11395 ,20452 ,9057 ,0 ,0 ,0 ,11395 
United Republic of Tanzania,Jamhuri ya Muungano wa Tanzania,TZ,Tanga,TZ04,Lushoto,TZ0401,Rangwi,TZ0401191,14936 ,6873 ,8063 ,14936 ,6873 ,0 ,0 ,0 ,8063 
United Republic of Tanzania,Jamhuri ya Muungano wa Tanzania,TZ,Tanga,TZ04,Lushoto,TZ0401,Mnazi,TZ0401201,11221 ,5322 ,5899 ,11221 ,5322 ,0 ,0 ,0 ,5899 
United Republic of Tanzania,Jamhuri ya Muungano wa Tanzania,TZ,Tanga,TZ04,Lushoto,TZ0401,Lunguza,TZ0401211,8278 ,3952 ,4326 ,8278 ,3952 ,0 ,0 ,0 ,4326 
United Republic of Tanzania,Jamhuri ya Muungano wa Tanzania,TZ,Tanga,TZ04,Lushoto,TZ0401,Mbaramo,TZ0401221,12465 ,5962 ,6503 ,12465 ,5962 ,0 ,0 ,0 ,6503 
United Republic of Tanzania,Jamhuri ya Muungano wa Tanzania,TZ,Tanga,TZ04,Lushoto,TZ0401,Mng'aro,TZ0401231,7148 ,3475 ,3673 ,7148 ,3475 ,0 ,0 ,0 ,3673 
United Republic of Tanzania,Jamhuri ya Muungano wa Tanzania,TZ,Tanga,TZ04,Lushoto,TZ0401,Mlalo,TZ0401243,8143 ,3727 ,4416 ,6253 ,2894 ,1890 ,833 ,1057 ,3359 
United Republic of Tanzania,Jamhuri ya Muungano wa Tanzania,TZ,Tanga,TZ04,Lushoto,TZ0401,Mwangoi,TZ0401251,9649 ,4432 ,5217 ,9649 ,4432 ,0 ,0 ,0 ,5217 
United Republic of Tanzania,Jamhuri ya Muungano wa Tanzania,TZ,Tanga,TZ04,Lushoto,TZ0401,Shume,TZ0401261,12251 ,5757 ,6494 ,12251 ,5757 ,0 ,0 ,0 ,6494 
United Republic of Tanzania,Jamhuri ya Muungano wa Tanzania,TZ,Tanga,TZ04,Lushoto,TZ0401,Malindi,TZ0401271,17979 ,8321 ,9658 ,17979 ,8321 ,0 ,0 ,0 ,9658 
United Republic of Tanzania,Jamhuri ya Muungano wa Tanzania,TZ,Tanga,TZ04,Lushoto,TZ0401,Hemtoye,TZ0401281,9125 ,4125 ,5000 ,9125 ,4125 ,0 ,0 ,0 ,5000 
United Republic of Tanzania,Jamhuri ya Muungano wa Tanzania,TZ,Tanga,TZ04,Lushoto,TZ0401,Malibwi,TZ0401291,17680 ,8101 ,9579 ,17680 ,8101 ,0 ,0 ,0 ,9579 
United Republic of Tanzania,Jamhuri ya Muungano wa Tanzania,TZ,Tanga,TZ04,Lushoto,TZ0401,Mlola,TZ0401301,9724 ,4394 ,5330 ,9724 ,4394 ,0 ,0 ,0 ,5330 
United Republic of Tanzania,Jamhuri ya Muungano wa Tanzania,TZ,Tanga,TZ04,Lushoto,TZ0401,Makanya,TZ0401311,13888 ,6478 ,7410 ,13888 ,6478 ,0 ,0 ,0 ,7410 
United Republic of Tanzania,Jamhuri ya Muungano wa Tanzania,TZ,Tanga,TZ04,Lushoto,TZ0401,Ngwelo,TZ0401321,4647 ,2093 ,2554 ,4647 ,2093 ,0 ,0 ,0 ,2554 
United Republic of Tanzania,Jamhuri ya Muungano wa Tanzania,TZ,Tanga,TZ04,Lushoto,TZ0401,Kilole,TZ0401331,6460 ,2943 ,3517 ,6460 ,2943 ,0 ,0 ,0 ,3517 
United Republic of Tanzania,Jamhuri ya Muungano wa Tanzania,TZ,Tanga,TZ04,Lushoto,TZ0401,Kwekanga,TZ0401341,11858 ,5457 ,6401 ,11858 ,5457 ,0 ,0 ,0 ,6401 
United Republic of Tanzania,Jamhuri ya Muungano wa Tanzania,TZ,Tanga,TZ04,Lushoto,TZ0401,Lukozi,TZ0401351,11998 ,5660 ,6338 ,11998 ,5660 ,0 ,0 ,0 ,6338 
United Republic of Tanzania,Jamhuri ya Muungano wa Tanzania,TZ,Tanga,TZ04,Lushoto,TZ0401,Manolo,TZ0401361,23134 ,10826 ,12308 ,23134 ,10826 ,0 ,0 ,0 ,12308 
United Republic of Tanzania,Jamhuri ya Muungano wa Tanzania,TZ,Tanga,TZ04,Lushoto,TZ0401,"Dule ""M""",TZ0401371,8834 ,4064 ,4770 ,8834 ,4064 ,0 ,0 ,0 ,4770 
United Republic of Tanzania,Jamhuri ya Muungano wa Tanzania,TZ,Tanga,TZ04,Lushoto,TZ0401,Kwemshasha,TZ0401383,8093 ,3537 ,4556 ,6404 ,2835 ,1689 ,702 ,987 ,3569 
United Republic of Tanzania,Jamhuri ya Muungano wa Tanzania,TZ,Tanga,TZ04,Lushoto,TZ0401,Nkongoi,TZ0401391,9208 ,4443 ,4765 ,9208 ,4443 ,0 ,0 ,0 ,4765 
United Republic of Tanzania,Jamhuri ya Muungano wa Tanzania,TZ,Tanga,TZ04,Lushoto,TZ0401,"Dule ""B""",TZ0401401,7971 ,3794 ,4177 ,7971 ,3794 ,0 ,0 ,0 ,4177 
United Republic of Tanzania,Jamhuri ya Muungano wa Tanzania,TZ,Tanga,TZ04,Lushoto,TZ0401,Maheza ngulu,TZ0401411,9006 ,4305 ,4701 ,9006 ,4305 ,0 ,0 ,0 ,4701 
United Republic of Tanzania,Jamhuri ya Muungano wa Tanzania,TZ,Tanga,TZ04,Lushoto,TZ0401,Usambara,TZ0401421,5351 ,2610 ,2741 ,5351 ,2610 ,0 ,0 ,0 ,2741 
United Republic of Tanzania,Jamhuri ya Muungano wa Tanzania,TZ,Tanga,TZ04,Lushoto,TZ0401,Ngulwi,TZ0401431,6152 ,2851 ,3301 ,6152 ,2851 ,0 ,0 ,0 ,3301 
United Republic of Tanzania,Jamhuri ya Muungano wa Tanzania,TZ,Tanga,TZ04,Lushoto,TZ0401,Kwemashai,TZ0401441,5649 ,2687 ,2962 ,5649 ,2687 ,0 ,0 ,0 ,2962 
United Republic of Tanzania,Jamhuri ya Muungano wa Tanzania,TZ,Tanga,TZ04,Korogwe,TZ0402,Mashewa,TZ0402011,11938 ,6045 ,5893 ,11938 ,6045 ,0 ,0 ,0 ,5893 
United Republic of Tanzania,Jamhuri ya Muungano wa Tanzania,TZ,Tanga,TZ04,Korogwe,TZ0402,Kizara,TZ0402021,14622 ,7251 ,7371 ,14622 ,7251 ,0 ,0 ,0 ,7371 
United Republic of Tanzania,Jamhuri ya Muungano wa Tanzania,TZ,Tanga,TZ04,Korogwe,TZ0402,Magoma,TZ0402031,11395 ,5575 ,5820 ,11395 ,5575 ,0 ,0 ,0 ,5820 
United Republic of Tanzania,Jamhuri ya Muungano wa Tanzania,TZ,Tanga,TZ04,Korogwe,TZ0402,Kerenge,TZ0402041,14737 ,7353 ,7384 ,14737 ,7353 ,0 ,0 ,0 ,7384 
United Republic of Tanzania,Jamhuri ya Muungano wa Tanzania,TZ,Tanga,TZ04,Korogwe,TZ0402,Kwagunda,TZ0402051,8924 ,4426 ,4498 ,8924 ,4426 ,0 ,0 ,0 ,4498 
United Republic of Tanzania,Jamhuri ya Muungano wa Tanzania,TZ,Tanga,TZ04,Korogwe,TZ0402,Mnyuzi,TZ0402063,19174 ,9461 ,9713 ,11820 ,5868 ,7354 ,3593 ,3761 ,5952 
United Republic of Tanzania,Jamhuri ya Muungano wa Tanzania,TZ,Tanga,TZ04,Korogwe,TZ0402,Vugiri,TZ0402071,9772 ,4864 ,4908 ,9772 ,4864 ,0 ,0 ,0 ,4908 
United Republic of Tanzania,Jamhuri ya Muungano wa Tanzania,TZ,Tanga,TZ04,Korogwe,TZ0402,Dindira,TZ0402081,12086 ,5800 ,6286 ,12086 ,5800 ,0 ,0 ,0 ,6286 
United Republic of Tanzania,Jamhuri ya Muungano wa Tanzania,TZ,Tanga,TZ04,Korogwe,TZ0402,Bungu,TZ0402091,14232 ,6876 ,7356 ,14232 ,6876 ,0 ,0 ,0 ,7356 
United Republic of Tanzania,Jamhuri ya Muungano wa Tanzania,TZ,Tanga,TZ04,Korogwe,TZ0402,Lutindi,TZ0402101,7840 ,3924 ,3916 ,7840 ,3924 ,0 ,0 ,0 ,3916 
United Republic of Tanzania,Jamhuri ya Muungano wa Tanzania,TZ,Tanga,TZ04,Korogwe,TZ0402,Makuyuni,TZ0402111,13180 ,6312 ,6868 ,13180 ,6312 ,0 ,0 ,0 ,6868 
United Republic of Tanzania,Jamhuri ya Muungano wa Tanzania,TZ,Tanga,TZ04,Korogwe,TZ0402,Chekelei,TZ0402121,8228 ,3963 ,4265 ,8228 ,3963 ,0 ,0 ,0 ,4265 
United Republic of Tanzania,Jamhuri ya Muungano wa Tanzania,TZ,Tanga,TZ04,Korogwe,TZ0402,Mombo,TZ0402133,17093 ,8054 ,9039 ,10341 ,4875 ,6752 ,3179 ,3573 ,5466 
United Republic of Tanzania,Jamhuri ya Muungano wa Tanzania,TZ,Tanga,TZ04,Korogwe,TZ0402,Mkalamo,TZ0402141,8836 ,4283 ,4553 ,8836 ,4283 ,0 ,0 ,0 ,4553 
United Republic of Tanzania,Jamhuri ya Muungano wa Tanzania,TZ,Tanga,TZ04,Korogwe,TZ0402,Mazinde,TZ0402153,22832 ,10981 ,11851 ,17754 ,8585 ,5078 ,2396 ,2682 ,9169 
United Republic of Tanzania,Jamhuri ya Muungano wa Tanzania,TZ,Tanga,TZ04,Korogwe,TZ0402,Mkomazi,TZ0402161,8069 ,4073 ,3996 ,8069 ,4073 ,0 ,0 ,0 ,3996 
United Republic of Tanzania,Jamhuri ya Muungano wa Tanzania,TZ,Tanga,TZ04,Korogwe,TZ0402,Kwashemshi,TZ0402171,10166 ,5005 ,5161 ,10166 ,5005 ,0 ,0 ,0 ,5161 
United Republic of Tanzania,Jamhuri ya Muungano wa Tanzania,TZ,Tanga,TZ04,Korogwe,TZ0402,Mpale,TZ0402181,9006 ,4530 ,4476 ,9006 ,4530 ,0 ,0 ,0 ,4476 
United Republic of Tanzania,Jamhuri ya Muungano wa Tanzania,TZ,Tanga,TZ04,Korogwe,TZ0402,Mswaha,TZ0402191,13594 ,6718 ,6876 ,13594 ,6718 ,0 ,0 ,0 ,6876 
United Republic of Tanzania,Jamhuri ya Muungano wa Tanzania,TZ,Tanga,TZ04,Korogwe,TZ0402,Magamba Kwalukonge,TZ0402201,6314 ,3050 ,3264 ,6314 ,3050 ,0 ,0 ,0 ,3264 
United Republic of Tanzania,Jamhuri ya Muungano wa Tanzania,TZ,Tanga,TZ04,Muheza,TZ0403,Misozwe,TZ0403011,6606 ,3397 ,3209 ,6606 ,3397 ,0 ,0 ,0 ,3209 
United Republic of Tanzania,Jamhuri ya Muungano wa Tanzania,TZ,Tanga,TZ04,Muheza,TZ0403,Pande Darajani,TZ0403021,3681 ,1899 ,1782 ,3681 ,1899 ,0 ,0 ,0 ,1782 
United Republic of Tanzania,Jamhuri ya Muungano wa Tanzania,TZ,Tanga,TZ04,Muheza,TZ0403,Ngomeni,TZ0403031,9190 ,4546 ,4644 ,9190 ,4546 ,0 ,0 ,0 ,4644 
United Republic of Tanzania,Jamhuri ya Muungano wa Tanzania,TZ,Tanga,TZ04,Muheza,TZ0403,Kigombe,TZ0403041,5678 ,2851 ,2827 ,5678 ,2851 ,0 ,0 ,0 ,2827 
United Republic of Tanzania,Jamhuri ya Muungano wa Tanzania,TZ,Tanga,TZ04,Muheza,TZ0403,Lusanga,TZ0403053,7739 ,3614 ,4125 ,3086 ,1519 ,4653 ,2095 ,2558 ,1567 
United Republic of Tanzania,Jamhuri ya Muungano wa Tanzania,TZ,Tanga,TZ04,Muheza,TZ0403,Kicheba,TZ0403061,6328 ,3147 ,3181 ,6328 ,3147 ,0 ,0 ,0 ,3181 
United Republic of Tanzania,Jamhuri ya Muungano wa Tanzania,TZ,Tanga,TZ04,Muheza,TZ0403,Magoroto,TZ0403071,5769 ,2943 ,2826 ,5769 ,2943 ,0 ,0 ,0 ,2826 
United Republic of Tanzania,Jamhuri ya Muungano wa Tanzania,TZ,Tanga,TZ04,Muheza,TZ0403,Magila,TZ0403081,6758 ,3285 ,3473 ,6758 ,3285 ,0 ,0 ,0 ,3473 
United Republic of Tanzania,Jamhuri ya Muungano wa Tanzania,TZ,Tanga,TZ04,Muheza,TZ0403,Mbaramo,TZ0403092,2795 ,1285 ,1510 ,2795 ,1285 ,0 ,0 ,0 ,1510 
United Republic of Tanzania,Jamhuri ya Muungano wa Tanzania,TZ,Tanga,TZ04,Muheza,TZ0403,Majengo,TZ0403102,6992 ,3210 ,3782 ,0 ,0 ,6992 ,3210 ,3782 ,0 
United Republic of Tanzania,Jamhuri ya Muungano wa Tanzania,TZ,Tanga,TZ04,Muheza,TZ0403,Masuguru,TZ0403113,3824 ,1772 ,2052 ,2630 ,1218 ,1194 ,554 ,640 ,1412 
United Republic of Tanzania,Jamhuri ya Muungano wa Tanzania,TZ,Tanga,TZ04,Muheza,TZ0403,Tingeni,TZ0403121,2709 ,1338 ,1371 ,2709 ,1338 ,0 ,0 ,0 ,1371 
United Republic of Tanzania,Jamhuri ya Muungano wa Tanzania,TZ,Tanga,TZ04,Muheza,TZ0403,Kilulu,TZ0403131,8212 ,4001 ,4211 ,8212 ,4001 ,0 ,0 ,0 ,4211 
United Republic of Tanzania,Jamhuri ya Muungano wa Tanzania,TZ,Tanga,TZ04,Muheza,TZ0403,Mkuzi,TZ0403141,7948 ,3866 ,4082 ,7948 ,3866 ,0 ,0 ,0 ,4082 
United Republic of Tanzania,Jamhuri ya Muungano wa Tanzania,TZ,Tanga,TZ04,Muheza,TZ0403,Mtindiro,TZ0403151,10831 ,5485 ,5346 ,10831 ,5485 ,0 ,0 ,0 ,5346 
United Republic of Tanzania,Jamhuri ya Muungano wa Tanzania,TZ,Tanga,TZ04,Muheza,TZ0403,Kwafungo,TZ0403161,11943 ,5959 ,5984 ,11943 ,5959 ,0 ,0 ,0 ,5984 
United Republic of Tanzania,Jamhuri ya Muungano wa Tanzania,TZ,Tanga,TZ04,Muheza,TZ0403,Songa,TZ0403171,5769 ,2940 ,2829 ,5769 ,2940 ,0 ,0 ,0 ,2829 
United Republic of Tanzania,Jamhuri ya Muungano wa Tanzania,TZ,Tanga,TZ04,Muheza,TZ0403,Bwembwera,TZ0403181,5557 ,2763 ,2794 ,5557 ,2763 ,0 ,0 ,0 ,2794 
United Republic of Tanzania,Jamhuri ya Muungano wa Tanzania,TZ,Tanga,TZ04,Muheza,TZ0403,Potwe,TZ0403191,5812 ,2921 ,2891 ,5812 ,2921 ,0 ,0 ,0 ,2891 
United Republic of Tanzania,Jamhuri ya Muungano wa Tanzania,TZ,Tanga,TZ04,Muheza,TZ0403,Nkumba,TZ0403201,6473 ,3158 ,3315 ,6473 ,3158 ,0 ,0 ,0 ,3315 
United Republic of Tanzania,Jamhuri ya Muungano wa Tanzania,TZ,Tanga,TZ04,Muheza,TZ0403,Kisiwani,TZ0403211,7123 ,3541 ,3582 ,7123 ,3541 ,0 ,0 ,0 ,3582 
United Republic of Tanzania,Jamhuri ya Muungano wa Tanzania,TZ,Tanga,TZ04,Muheza,TZ0403,Misalai,TZ0403221,6942 ,3401 ,3541 ,6942 ,3401 ,0 ,0 ,0 ,3541 
United Republic of Tanzania,Jamhuri ya Muungano wa Tanzania,TZ,Tanga,TZ04,Muheza,TZ0403,Zirai,TZ0403231,9289 ,4758 ,4531 ,9289 ,4758 ,0 ,0 ,0 ,4531 
United Republic of Tanzania,Jamhuri ya Muungano wa Tanzania,TZ,Tanga,TZ04,Muheza,TZ0403,Mbomole,TZ0403241,5663 ,2813 ,2850 ,5663 ,2813 ,0 ,0 ,0 ,2850 
United Republic of Tanzania,Jamhuri ya Muungano wa Tanzania,TZ,Tanga,TZ04,Muheza,TZ0403,Amani,TZ0403251,5553 ,2818 ,2735 ,5553 ,2818 ,0 ,0 ,0 ,2735 
United Republic of Tanzania,Jamhuri ya Muungano wa Tanzania,TZ,Tanga,TZ04,Muheza,TZ0403,Tongwe,TZ0403261,7478 ,3722 ,3756 ,7478 ,3722 ,0 ,0 ,0 ,3756 
United Republic of Tanzania,Jamhuri ya Muungano wa Tanzania,TZ,Tanga,TZ04,Muheza,TZ0403,Mhamba,TZ0403271,3391 ,1726 ,1665 ,3391 ,1726 ,0 ,0 ,0 ,1665 
United Republic of Tanzania,Jamhuri ya Muungano wa Tanzania,TZ,Tanga,TZ04,Muheza,TZ0403,Kwakifua,TZ0403281,3084 ,1511 ,1573 ,3084 ,1511 ,0 ,0 ,0 ,1573 
United Republic of Tanzania,Jamhuri ya Muungano wa Tanzania,TZ,Tanga,TZ04,Muheza,TZ0403,Kwemkabala,TZ0403291,6672 ,3127 ,3545 ,6672 ,3127 ,0 ,0 ,0 ,3545 
United Republic of Tanzania,Jamhuri ya Muungano wa Tanzania,TZ,Tanga,TZ04,Muheza,TZ0403,Genge,TZ0403301,6521 ,3019 ,3502 ,6521 ,3019 ,0 ,0 ,0 ,3502 
United Republic of Tanzania,Jamhuri ya Muungano wa Tanzania,TZ,Tanga,TZ04,Muheza,TZ0403,Tanganyika,TZ0403311,3580 ,1671 ,1909 ,3580 ,1671 ,0 ,0 ,0 ,1909 
United Republic of Tanzania,Jamhuri ya Muungano wa Tanzania,TZ,Tanga,TZ04,Muheza,TZ0403,Mpapayu,TZ0403321,3225 ,1618 ,1607 ,3225 ,1618 ,0 ,0 ,0 ,1607 
United Republic of Tanzania,Jamhuri ya Muungano wa Tanzania,TZ,Tanga,TZ04,Muheza,TZ0403,Mlingano,TZ0403331,5326 ,2738 ,2588 ,5326 ,2738 ,0 ,0 ,0 ,2588 
United Republic of Tanzania,Jamhuri ya Muungano wa Tanzania,TZ,Tanga,TZ04,Tanga Urban,TZ0404,Central,TZ0404012,5739 ,2830 ,2909 ,0 ,0 ,5739 ,2830 ,2909 ,0 
United Republic of Tanzania,Jamhuri ya Muungano wa Tanzania,TZ,Tanga,TZ04,Tanga Urban,TZ0404,Majengo,TZ0404022,7482 ,3610 ,3872 ,0 ,0 ,7482 ,3610 ,3872 ,0 
United Republic of Tanzania,Jamhuri ya Muungano wa Tanzania,TZ,Tanga,TZ04,Tanga Urban,TZ0404,Nguvumali,TZ0404032,15133 ,7123 ,8010 ,0 ,0 ,15133 ,7123 ,8010 ,0 
United Republic of Tanzania,Jamhuri ya Muungano wa Tanzania,TZ,Tanga,TZ04,Tanga Urban,TZ0404,Chumbageni,TZ0404042,14225 ,6652 ,7573 ,0 ,0 ,14225 ,6652 ,7573 ,0 
United Republic of Tanzania,Jamhuri ya Muungano wa Tanzania,TZ,Tanga,TZ04,Tanga Urban,TZ0404,Ngamiani Kaskazini,TZ0404052,3910 ,1906 ,2004 ,0 ,0 ,3910 ,1906 ,2004 ,0 
United Republic of Tanzania,Jamhuri ya Muungano wa Tanzania,TZ,Tanga,TZ04,Tanga Urban,TZ0404,Ngamiani Kati,TZ0404062,4755 ,2211 ,2544 ,0 ,0 ,4755 ,2211 ,2544 ,0 
United Republic of Tanzania,Jamhuri ya Muungano wa Tanzania,TZ,Tanga,TZ04,Tanga Urban,TZ0404,Ngamiani Kusini,TZ0404072,7638 ,3558 ,4080 ,0 ,0 ,7638 ,3558 ,4080 ,0 
United Republic of Tanzania,Jamhuri ya Muungano wa Tanzania,TZ,Tanga,TZ04,Tanga Urban,TZ0404,Usagara,TZ0404082,10330 ,4831 ,5499 ,0 ,0 ,10330 ,4831 ,5499 ,0 
United Republic of Tanzania,Jamhuri ya Muungano wa Tanzania,TZ,Tanga,TZ04,Tanga Urban,TZ0404,Makorora,TZ0404092,16664 ,7731 ,8933 ,0 ,0 ,16664 ,7731 ,8933 ,0 
United Republic of Tanzania,Jamhuri ya Muungano wa Tanzania,TZ,Tanga,TZ04,Tanga Urban,TZ0404,Mzingani,TZ0404102,29041 ,13772 ,15269 ,0 ,0 ,29041 ,13772 ,15269 ,0 
United Republic of Tanzania,Jamhuri ya Muungano wa Tanzania,TZ,Tanga,TZ04,Tanga Urban,TZ0404,Msambweni,TZ0404112,9610 ,4388 ,5222 ,0 ,0 ,9610 ,4388 ,5222 ,0 
United Republic of Tanzania,Jamhuri ya Muungano wa Tanzania,TZ,Tanga,TZ04,Tanga Urban,TZ0404,Mwanzange,TZ0404122,7521 ,3563 ,3958 ,0 ,0 ,7521 ,3563 ,3958 ,0 
United Republic of Tanzania,Jamhuri ya Muungano wa Tanzania,TZ,Tanga,TZ04,Tanga Urban,TZ0404,Tangasisi,TZ0404133,19149 ,9201 ,9948 ,2244 ,1075 ,16905 ,8126 ,8779 ,1169 
United Republic of Tanzania,Jamhuri ya Muungano wa Tanzania,TZ,Tanga,TZ04,Tanga Urban,TZ0404,Mabawa,TZ0404142,35125 ,16194 ,18931 ,0 ,0 ,35125 ,16194 ,18931 ,0 
United Republic of Tanzania,Jamhuri ya Muungano wa Tanzania,TZ,Tanga,TZ04,Tanga Urban,TZ0404,Tongoni,TZ0404151,4594 ,2203 ,2391 ,4594 ,2203 ,0 ,0 ,0 ,2391 
United Republic of Tanzania,Jamhuri ya Muungano wa Tanzania,TZ,Tanga,TZ04,Tanga Urban,TZ0404,Marungu,TZ0404161,3025 ,1521 ,1504 ,3025 ,1521 ,0 ,0 ,0 ,1504 
United Republic of Tanzania,Jamhuri ya Muungano wa Tanzania,TZ,Tanga,TZ04,Tanga Urban,TZ0404,Pongwe,TZ0404173,13513 ,6613 ,6900 ,3728 ,1833 ,9785 ,4780 ,5005 ,1895 
United Republic of Tanzania,Jamhuri ya Muungano wa Tanzania,TZ,Tanga,TZ04,Tanga Urban,TZ0404,Maweni,TZ0404181,14091 ,7546 ,6545 ,14091 ,7546 ,0 ,0 ,0 ,6545 
United Republic of Tanzania,Jamhuri ya Muungano wa Tanzania,TZ,Tanga,TZ04,Tanga Urban,TZ0404,Duga,TZ0404192,18704 ,8895 ,9809 ,0 ,0 ,18704 ,8895 ,9809 ,0 
United Republic of Tanzania,Jamhuri ya Muungano wa Tanzania,TZ,Tanga,TZ04,Tanga Urban,TZ0404,Mzizima,TZ0404203,11570 ,5830 ,5740 ,3010 ,1581 ,8560 ,4249 ,4311 ,1429 
United Republic of Tanzania,Jamhuri ya Muungano wa Tanzania,TZ,Tanga,TZ04,Tanga Urban,TZ0404,Mabokweni,TZ0404211,5433 ,2667 ,2766 ,5433 ,2667 ,0 ,0 ,0 ,2766 
United Republic of Tanzania,Jamhuri ya Muungano wa Tanzania,TZ,Tanga,TZ04,Tanga Urban,TZ0404,Kirare,TZ0404221,4756 ,2458 ,2298 ,4756 ,2458 ,0 ,0 ,0 ,2298 
United Republic of Tanzania,Jamhuri ya Muungano wa Tanzania,TZ,Tanga,TZ04,Tanga Urban,TZ0404,Kiomoni,TZ0404231,6587 ,3302 ,3285 ,6587 ,3302 ,0 ,0 ,0 ,3285 
United Republic of Tanzania,Jamhuri ya Muungano wa Tanzania,TZ,Tanga,TZ04,Tanga Urban,TZ0404,Chongoleani,TZ0404241,4737 ,2315 ,2422 ,4737 ,2315 ,0 ,0 ,0 ,2422 
United Republic of Tanzania,Jamhuri ya Muungano wa Tanzania,TZ,Tanga,TZ04,Pangani,TZ0405,Pangani Mashariki,TZ0405013,2975 ,1392 ,1583 ,447 ,224 ,2528 ,1168 ,1360 ,223 
United Republic of Tanzania,Jamhuri ya Muungano wa Tanzania,TZ,Tanga,TZ04,Pangani,TZ0405,Pangani Magharibi,TZ0405022,6262 ,2919 ,3343 ,0 ,0 ,6262 ,2919 ,3343 ,0 
United Republic of Tanzania,Jamhuri ya Muungano wa Tanzania,TZ,Tanga,TZ04,Pangani,TZ0405,Bweni,TZ0405031,1263 ,620 ,643 ,1263 ,620 ,0 ,0 ,0 ,643 
United Republic of Tanzania,Jamhuri ya Muungano wa Tanzania,TZ,Tanga,TZ04,Pangani,TZ0405,Madanga,TZ0405041,3298 ,1596 ,1702 ,3298 ,1596 ,0 ,0 ,0 ,1702 
United Republic of Tanzania,Jamhuri ya Muungano wa Tanzania,TZ,Tanga,TZ04,Pangani,TZ0405,Kimang'a,TZ0405051,3876 ,1921 ,1955 ,3876 ,1921 ,0 ,0 ,0 ,1955 
United Republic of Tanzania,Jamhuri ya Muungano wa Tanzania,TZ,Tanga,TZ04,Pangani,TZ0405,Bushiri,TZ0405061,7294 ,3836 ,3458 ,7294 ,3836 ,0 ,0 ,0 ,3458 
United Republic of Tanzania,Jamhuri ya Muungano wa Tanzania,TZ,Tanga,TZ04,Pangani,TZ0405,Mwera,TZ0405071,4601 ,2234 ,2367 ,4601 ,2234 ,0 ,0 ,0 ,2367 
United Republic of Tanzania,Jamhuri ya Muungano wa Tanzania,TZ,Tanga,TZ04,Pangani,TZ0405,Tungamaa,TZ0405081,2583 ,1350 ,1233 ,2583 ,1350 ,0 ,0 ,0 ,1233 
United Republic of Tanzania,Jamhuri ya Muungano wa Tanzania,TZ,Tanga,TZ04,Pangani,TZ0405,Kipumbwi,TZ0405091,5333 ,2680 ,2653 ,5333 ,2680 ,0 ,0 ,0 ,2653 
United Republic of Tanzania,Jamhuri ya Muungano wa Tanzania,TZ,Tanga,TZ04,Pangani,TZ0405,Mikunguni,TZ0405101,4646 ,2327 ,2319 ,4646 ,2327 ,0 ,0 ,0 ,2319 
United Republic of Tanzania,Jamhuri ya Muungano wa Tanzania,TZ,Tanga,TZ04,Pangani,TZ0405,Ubangaa,TZ0405111,2112 ,1067 ,1045 ,2112 ,1067 ,0 ,0 ,0 ,1045 
United Republic of Tanzania,Jamhuri ya Muungano wa Tanzania,TZ,Tanga,TZ04,Pangani,TZ0405,Mkwaja,TZ0405121,4217 ,2171 ,2046 ,4217 ,2171 ,0 ,0 ,0 ,2046 
United Republic of Tanzania,Jamhuri ya Muungano wa Tanzania,TZ,Tanga,TZ04,Pangani,TZ0405,Mkalamo,TZ0405131,5565 ,2757 ,2808 ,5565 ,2757 ,0 ,0 ,0 ,2808 
United Republic of Tanzania,Jamhuri ya Muungano wa Tanzania,TZ,Tanga,TZ04,Handeni,TZ0406,Segera,TZ0406011,23445 ,11505 ,11940 ,23445 ,11505 ,0 ,0 ,0 ,11940 
United Republic of Tanzania,Jamhuri ya Muungano wa Tanzania,TZ,Tanga,TZ04,Handeni,TZ0406,Ndolwa,TZ0406021,23317 ,11553 ,11764 ,23317 ,11553 ,0 ,0 ,0 ,11764 
United Republic of Tanzania,Jamhuri ya Muungano wa Tanzania,TZ,Tanga,TZ04,Handeni,TZ0406,Mazingara,TZ0406031,15854 ,7783 ,8071 ,15854 ,7783 ,0 ,0 ,0 ,8071 
United Republic of Tanzania,Jamhuri ya Muungano wa Tanzania,TZ,Tanga,TZ04,Handeni,TZ0406,Kwamsisi,TZ0406041,11351 ,5654 ,5697 ,11351 ,5654 ,0 ,0 ,0 ,5697 
United Republic of Tanzania,Jamhuri ya Muungano wa Tanzania,TZ,Tanga,TZ04,Handeni,TZ0406,Kwasunga,TZ0406051,8257 ,4107 ,4150 ,8257 ,4107 ,0 ,0 ,0 ,4150 
United Republic of Tanzania,Jamhuri ya Muungano wa Tanzania,TZ,Tanga,TZ04,Handeni,TZ0406,Kwaluguru,TZ0406061,11347 ,5593 ,5754 ,11347 ,5593 ,0 ,0 ,0 ,5754 
United Republic of Tanzania,Jamhuri ya Muungano wa Tanzania,TZ,Tanga,TZ04,Handeni,TZ0406,Kang'ata,TZ0406071,9099 ,4843 ,4256 ,9099 ,4843 ,0 ,0 ,0 ,4256 
United Republic of Tanzania,Jamhuri ya Muungano wa Tanzania,TZ,Tanga,TZ04,Handeni,TZ0406,Kwamkonje,TZ0406081,10671 ,5313 ,5358 ,10671 ,5313 ,0 ,0 ,0 ,5358 
United Republic of Tanzania,Jamhuri ya Muungano wa Tanzania,TZ,Tanga,TZ04,Handeni,TZ0406,Kwachaga,TZ0406091,10438 ,5126 ,5312 ,10438 ,5126 ,0 ,0 ,0 ,5312 
United Republic of Tanzania,Jamhuri ya Muungano wa Tanzania,TZ,Tanga,TZ04,Handeni,TZ0406,Sindeni,TZ0406101,16790 ,8135 ,8655 ,16790 ,8135 ,0 ,0 ,0 ,8655 
United Republic of Tanzania,Jamhuri ya Muungano wa Tanzania,TZ,Tanga,TZ04,Handeni,TZ0406,Misima,TZ0406111,13366 ,6393 ,6973 ,13366 ,6393 ,0 ,0 ,0 ,6973 
United Republic of Tanzania,Jamhuri ya Muungano wa Tanzania,TZ,Tanga,TZ04,Handeni,TZ0406,Kiva,TZ0406121,9972 ,4895 ,5077 ,9972 ,4895 ,0 ,0 ,0 ,5077 
United Republic of Tanzania,Jamhuri ya Muungano wa Tanzania,TZ,Tanga,TZ04,Handeni,TZ0406,Kabuku,TZ0406131,12222 ,5939 ,6283 ,12222 ,5939 ,0 ,0 ,0 ,6283 
United Republic of Tanzania,Jamhuri ya Muungano wa Tanzania,TZ,Tanga,TZ04,Handeni,TZ0406,Kwamatuku,TZ0406141,11219 ,5794 ,5425 ,11219 ,5794 ,0 ,0 ,0 ,5425 
United Republic of Tanzania,Jamhuri ya Muungano wa Tanzania,TZ,Tanga,TZ04,Handeni,TZ0406,Kwedizinga,TZ0406151,6319 ,3180 ,3139 ,6319 ,3180 ,0 ,0 ,0 ,3139 
United Republic of Tanzania,Jamhuri ya Muungano wa Tanzania,TZ,Tanga,TZ04,Handeni,TZ0406,Mgambo,TZ0406161,11317 ,6121 ,5196 ,11317 ,6121 ,0 ,0 ,0 ,5196 
United Republic of Tanzania,Jamhuri ya Muungano wa Tanzania,TZ,Tanga,TZ04,Handeni,TZ0406,Komkonga,TZ0406171,16262 ,7850 ,8412 ,16262 ,7850 ,0 ,0 ,0 ,8412 
United Republic of Tanzania,Jamhuri ya Muungano wa Tanzania,TZ,Tanga,TZ04,Handeni,TZ0406,Mkata,TZ0406181,31879 ,15522 ,16357 ,31879 ,15522 ,0 ,0 ,0 ,16357 
United Republic of Tanzania,Jamhuri ya Muungano wa Tanzania,TZ,Tanga,TZ04,Handeni,TZ0406,Kabuku ndani,TZ0406191,15551 ,7787 ,7764 ,15551 ,7787 ,0 ,0 ,0 ,7764 
United Republic of Tanzania,Jamhuri ya Muungano wa Tanzania,TZ,Tanga,TZ04,Handeni,TZ0406,Kwamgwe,TZ0406201,7970 ,4125 ,3845 ,7970 ,4125 ,0 ,0 ,0 ,3845 
United Republic of Tanzania,Jamhuri ya Muungano wa Tanzania,TZ,Tanga,TZ04,Kilindi,TZ0407,Lwande,TZ0407011,8793 ,4423 ,4370 ,8793 ,4423 ,0 ,0 ,0 ,4370 
United Republic of Tanzania,Jamhuri ya Muungano wa Tanzania,TZ,Tanga,TZ04,Kilindi,TZ0407,Kikunde,TZ0407021,10468 ,5237 ,5231 ,10468 ,5237 ,0 ,0 ,0 ,5231 
United Republic of Tanzania,Jamhuri ya Muungano wa Tanzania,TZ,Tanga,TZ04,Kilindi,TZ0407,Songe,TZ0407031,14801 ,7119 ,7682 ,14801 ,7119 ,0 ,0 ,0 ,7682 
United Republic of Tanzania,Jamhuri ya Muungano wa Tanzania,TZ,Tanga,TZ04,Kilindi,TZ0407,Pagwi,TZ0407041,11518 ,5720 ,5798 ,11518 ,5720 ,0 ,0 ,0 ,5798 
United Republic of Tanzania,Jamhuri ya Muungano wa Tanzania,TZ,Tanga,TZ04,Kilindi,TZ0407,Masagalu,TZ0407051,13464 ,6686 ,6778 ,13464 ,6686 ,0 ,0 ,0 ,6778 
United Republic of Tanzania,Jamhuri ya Muungano wa Tanzania,TZ,Tanga,TZ04,Kilindi,TZ0407,Kimbe,TZ0407061,14249 ,7296 ,6953 ,14249 ,7296 ,0 ,0 ,0 ,6953 
United Republic of Tanzania,Jamhuri ya Muungano wa Tanzania,TZ,Tanga,TZ04,Kilindi,TZ0407,Kilindi,TZ0407071,11093 ,5810 ,5283 ,11093 ,5810 ,0 ,0 ,0 ,5283 
United Republic of Tanzania,Jamhuri ya Muungano wa Tanzania,TZ,Tanga,TZ04,Kilindi,TZ0407,Negero,TZ0407081,10000 ,4989 ,5011 ,10000 ,4989 ,0 ,0 ,0 ,5011 
United Republic of Tanzania,Jamhuri ya Muungano wa Tanzania,TZ,Tanga,TZ04,Kilindi,TZ0407,Mkindi,TZ0407091,10774 ,5299 ,5475 ,10774 ,5299 ,0 ,0 ,0 ,5475 
United Republic of Tanzania,Jamhuri ya Muungano wa Tanzania,TZ,Tanga,TZ04,Kilindi,TZ0407,Mvungwe,TZ0407101,20100 ,9834 ,10266 ,20100 ,9834 ,0 ,0 ,0 ,10266 
United Republic of Tanzania,Jamhuri ya Muungano wa Tanzania,TZ,Tanga,TZ04,Kilindi,TZ0407,Kwediboma,TZ0407111,17748 ,8780 ,8968 ,17748 ,8780 ,0 ,0 ,0 ,8968 
United Republic of Tanzania,Jamhuri ya Muungano wa Tanzania,TZ,Tanga,TZ04,Kilindi,TZ0407,Saunyi,TZ0407121,3231 ,1564 ,1667 ,3231 ,1564 ,0 ,0 ,0 ,1667 
United Republic of Tanzania,Jamhuri ya Muungano wa Tanzania,TZ,Tanga,TZ04,Kilindi,TZ0407,Jaila,TZ0407131,12319 ,6017 ,6302 ,12319 ,6017 ,0 ,0 ,0 ,6302 
United Republic of Tanzania,Jamhuri ya Muungano wa Tanzania,TZ,Tanga,TZ04,Kilindi,TZ0407,Msanja,TZ0407141,17233 ,8938 ,8295 ,17233 ,8938 ,0 ,0 ,0 ,8295 
United Republic of Tanzania,Jamhuri ya Muungano wa Tanzania,TZ,Tanga,TZ04,Kilindi,TZ0407,Kisangasa,TZ0407151,9591 ,4780 ,4811 ,9591 ,4780 ,0 ,0 ,0 ,4811 
United Republic of Tanzania,Jamhuri ya Muungano wa Tanzania,TZ,Tanga,TZ04,Kilindi,TZ0407,Mabalanga,TZ0407161,6916 ,3437 ,3479 ,6916 ,3437 ,0 ,0 ,0 ,3479 
United Republic of Tanzania,Jamhuri ya Muungano wa Tanzania,TZ,Tanga,TZ04,Kilindi,TZ0407,Kibirashi,TZ0407171,20796 ,10229 ,10567 ,20796 ,10229 ,0 ,0 ,0 ,10567 
United Republic of Tanzania,Jamhuri ya Muungano wa Tanzania,TZ,Tanga,TZ04,Kilindi,TZ0407,Kilwa,TZ0407181,6835 ,3509 ,3326 ,6835 ,3509 ,0 ,0 ,0 ,3326 
United Republic of Tanzania,Jamhuri ya Muungano wa Tanzania,TZ,Tanga,TZ04,Kilindi,TZ0407,Tunguli,TZ0407191,7774 ,3818 ,3956 ,7774 ,3818 ,0 ,0 ,0 ,3956 
United Republic of Tanzania,Jamhuri ya Muungano wa Tanzania,TZ,Tanga,TZ04,Kilindi,TZ0407,Kwekivu,TZ0407201,9130 ,4682 ,4448 ,9130 ,4682 ,0 ,0 ,0 ,4448 
United Republic of Tanzania,Jamhuri ya Muungano wa Tanzania,TZ,Tanga,TZ04,Mkinga,TZ0408,Mwakijembe,TZ0408011,6515 ,3251 ,3264 ,6515 ,3251 ,0 ,0 ,0 ,3264 
United Republic of Tanzania,Jamhuri ya Muungano wa Tanzania,TZ,Tanga,TZ04,Mkinga,TZ0408,Mkinga,TZ0408021,4839 ,2325 ,2514 ,4839 ,2325 ,0 ,0 ,0 ,2514 
United Republic of Tanzania,Jamhuri ya Muungano wa Tanzania,TZ,Tanga,TZ04,Mkinga,TZ0408,Duga,TZ0408031,9444 ,4587 ,4857 ,9444 ,4587 ,0 ,0 ,0 ,4857 
United Republic of Tanzania,Jamhuri ya Muungano wa Tanzania,TZ,Tanga,TZ04,Mkinga,TZ0408,Moa,TZ0408041,4339 ,2009 ,2330 ,4339 ,2009 ,0 ,0 ,0 ,2330 
United Republic of Tanzania,Jamhuri ya Muungano wa Tanzania,TZ,Tanga,TZ04,Mkinga,TZ0408,Manza,TZ0408051,3613 ,1723 ,1890 ,3613 ,1723 ,0 ,0 ,0 ,1890 
United Republic of Tanzania,Jamhuri ya Muungano wa Tanzania,TZ,Tanga,TZ04,Mkinga,TZ0408,Kwale,TZ0408061,2430 ,1137 ,1293 ,2430 ,1137 ,0 ,0 ,0 ,1293 
United Republic of Tanzania,Jamhuri ya Muungano wa Tanzania,TZ,Tanga,TZ04,Mkinga,TZ0408,Mtimbwani,TZ0408071,3103 ,1439 ,1664 ,3103 ,1439 ,0 ,0 ,0 ,1664 
United Republic of Tanzania,Jamhuri ya Muungano wa Tanzania,TZ,Tanga,TZ04,Mkinga,TZ0408,Gombero,TZ0408081,6302 ,3065 ,3237 ,6302 ,3065 ,0 ,0 ,0 ,3237 
United Republic of Tanzania,Jamhuri ya Muungano wa Tanzania,TZ,Tanga,TZ04,Mkinga,TZ0408,Mhinduro,TZ0408091,6989 ,3487 ,3502 ,6989 ,3487 ,0 ,0 ,0 ,3502 
United Republic of Tanzania,Jamhuri ya Muungano wa Tanzania,TZ,Tanga,TZ04,Mkinga,TZ0408,Maramba,TZ0408103,10961 ,5274 ,5687 ,2488 ,1256 ,8473 ,4018 ,4455 ,1232 
United Republic of Tanzania,Jamhuri ya Muungano wa Tanzania,TZ,Tanga,TZ04,Mkinga,TZ0408,Kigongoi,TZ0408111,7318 ,3711 ,3607 ,7318 ,3711 ,0 ,0 ,0 ,3607 
United Republic of Tanzania,Jamhuri ya Muungano wa Tanzania,TZ,Tanga,TZ04,Mkinga,TZ0408,Daluni,TZ0408121,6905 ,3438 ,3467 ,6905 ,3438 ,0 ,0 ,0 ,3467 
United Republic of Tanzania,Jamhuri ya Muungano wa Tanzania,TZ,Tanga,TZ04,Mkinga,TZ0408,Bosha,TZ0408131,7585 ,3767 ,3818 ,7585 ,3767 ,0 ,0 ,0 ,3818 
United Republic of Tanzania,Jamhuri ya Muungano wa Tanzania,TZ,Tanga,TZ04,Mkinga,TZ0408,Mapatano,TZ0408141,6677 ,3374 ,3303 ,6677 ,3374 ,0 ,0 ,0 ,3303 
United Republic of Tanzania,Jamhuri ya Muungano wa Tanzania,TZ,Tanga,TZ04,Mkinga,TZ0408,Bwiti,TZ0408151,9711 ,4730 ,4981 ,9711 ,4730 ,0 ,0 ,0 ,4981 
United Republic of Tanzania,Jamhuri ya Muungano wa Tanzania,TZ,Tanga,TZ04,Mkinga,TZ0408,Mnyenzani,TZ0408161,3604 ,1833 ,1771 ,3604 ,1833 ,0 ,0 ,0 ,1771 
United Republic of Tanzania,Jamhuri ya Muungano wa Tanzania,TZ,Tanga,TZ04,Mkinga,TZ0408,Doda,TZ0408171,2670 ,1357 ,1313 ,2670 ,1357 ,0 ,0 ,0 ,1313 
United Republic of Tanzania,Jamhuri ya Muungano wa Tanzania,TZ,Tanga,TZ04,Mkinga,TZ0408,Boma,TZ0408181,2587 ,1192 ,1395 ,2587 ,1192 ,0 ,0 ,0 ,1395 
United Republic of Tanzania,Jamhuri ya Muungano wa Tanzania,TZ,Tanga,TZ04,Mkinga,TZ0408,Parungu Kasera,TZ0408191,4560 ,2250 ,2310 ,4560 ,2250 ,0 ,0 ,0 ,2310 
United Republic of Tanzania,Jamhuri ya Muungano wa Tanzania,TZ,Tanga,TZ04,Mkinga,TZ0408,Mayomboni,TZ0408201,4001 ,1952 ,2049 ,4001 ,1952 ,0 ,0 ,0 ,2049 
United Republic of Tanzania,Jamhuri ya Muungano wa Tanzania,TZ,Tanga,TZ04,Mkinga,TZ0408,Sigaya,TZ0408211,3912 ,1859 ,2053 ,3912 ,1859 ,0 ,0 ,0 ,2053 
United Republic of Tanzania,Jamhuri ya Muungano wa Tanzania,TZ,Tanga,TZ04,Korogwe Township Authority,TZ0409,Ngombezi,TZ0409013,5346 ,2633 ,2713 ,1053 ,481 ,4293 ,2152 ,2141 ,572 
United Republic of Tanzania,Jamhuri ya Muungano wa Tanzania,TZ,Tanga,TZ04,Korogwe Township Authority,TZ0409,Mtonga,TZ0409022,10369 ,4957 ,5412 ,0 ,0 ,10369 ,4957 ,5412 ,0 
United Republic of Tanzania,Jamhuri ya Muungano wa Tanzania,TZ,Tanga,TZ04,Korogwe Township Authority,TZ0409,Magunga,TZ0409032,9519 ,4631 ,4888 ,0 ,0 ,9519 ,4631 ,4888 ,0 
United Republic of Tanzania,Jamhuri ya Muungano wa Tanzania,TZ,Tanga,TZ04,Korogwe Township Authority,TZ0409,Kwamndolwa,TZ0409041,5160 ,2447 ,2713 ,5160 ,2447 ,0 ,0 ,0 ,2713 
United Republic of Tanzania,Jamhuri ya Muungano wa Tanzania,TZ,Tanga,TZ04,Korogwe Township Authority,TZ0409,Old Korogwe,TZ0409052,6394 ,3085 ,3309 ,0 ,0 ,6394 ,3085 ,3309 ,0 
United Republic of Tanzania,Jamhuri ya Muungano wa Tanzania,TZ,Tanga,TZ04,Korogwe Township Authority,TZ0409,Manundu,TZ0409062,17499 ,8440 ,9059 ,0 ,0 ,17499 ,8440 ,9059 ,0 
United Republic of Tanzania,Jamhuri ya Muungano wa Tanzania,TZ,Tanga,TZ04,Korogwe Township Authority,TZ0409,Kilole,TZ0409072,8208 ,4046 ,4162 ,0 ,0 ,8208 ,4046 ,4162 ,0 
United Republic of Tanzania,Jamhuri ya Muungano wa Tanzania,TZ,Tanga,TZ04,Korogwe Township Authority,TZ0409,Kwamsisi,TZ0409081,5813 ,2882 ,2931 ,5813 ,2882 ,0 ,0 ,0 ,2931 
United Republic of Tanzania,Jamhuri ya Muungano wa Tanzania,TZ,Tanga,TZ04,Handeni Mji,TZ0410,Malezi,TZ0410012,8077 ,4031 ,4046 ,0 ,0 ,8077 ,4031 ,4046 ,0 
United Republic of Tanzania,Jamhuri ya Muungano wa Tanzania,TZ,Tanga,TZ04,Handeni Mji,TZ0410,Kwenjugo,TZ0410022,7115 ,3382 ,3733 ,0 ,0 ,7115 ,3382 ,3733 ,0 
United Republic of Tanzania,Jamhuri ya Muungano wa Tanzania,TZ,Tanga,TZ04,Handeni Mji,TZ0410,Mabanda,TZ0410032,5860 ,2804 ,3056 ,0 ,0 ,5860 ,2804 ,3056 ,0 
United Republic of Tanzania,Jamhuri ya Muungano wa Tanzania,TZ,Tanga,TZ04,Handeni Mji,TZ0410,Konje,TZ0410042,3057 ,1645 ,1412 ,0 ,0 ,3057 ,1645 ,1412 ,0 
United Republic of Tanzania,Jamhuri ya Muungano wa Tanzania,TZ,Tanga,TZ04,Handeni Mji,TZ0410,Mlimani,TZ0410052,5252 ,2558 ,2694 ,0 ,0 ,5252 ,2558 ,2694 ,0 
United Republic of Tanzania,Jamhuri ya Muungano wa Tanzania,TZ,Tanga,TZ04,Handeni Mji,TZ0410,Msasa,TZ0410062,4328 ,2121 ,2207 ,0 ,0 ,4328 ,2121 ,2207 ,0 
United Republic of Tanzania,Jamhuri ya Muungano wa Tanzania,TZ,Tanga,TZ04,Handeni Mji,TZ0410,Kideleko,TZ0410072,5414 ,2605 ,2809 ,0 ,0 ,5414 ,2605 ,2809 ,0 
United Republic of Tanzania,Jamhuri ya Muungano wa Tanzania,TZ,Tanga,TZ04,Handeni Mji,TZ0410,Kwamagome,TZ0410082,9188 ,4503 ,4685 ,0 ,0 ,9188 ,4503 ,4685 ,0 
United Republic of Tanzania,Jamhuri ya Muungano wa Tanzania,TZ,Tanga,TZ04,Handeni Mji,TZ0410,Vibaoni,TZ0410092,6078 ,3074 ,3004 ,0 ,0 ,6078 ,3074 ,3004 ,0 
United Republic of Tanzania,Jamhuri ya Muungano wa Tanzania,TZ,Tanga,TZ04,Handeni Mji,TZ0410,Chanika,TZ0410102,10994 ,5297 ,5697 ,0 ,0 ,10994 ,5297 ,5697 ,0 
United Republic of Tanzania,Jamhuri ya Muungano wa Tanzania,TZ,Tanga,TZ04,Handeni Mji,TZ0410,Mdoe,TZ0410112,9541 ,4588 ,4953 ,0 ,0 ,9541 ,4588 ,4953 ,0 
United Republic of Tanzania,Jamhuri ya Muungano wa Tanzania,TZ,Tanga,TZ04,Handeni Mji,TZ0410,Kwediyamba,TZ0410122,4152 ,2060 ,2092 ,0 ,0 ,4152 ,2060 ,2092 ,0 
United Republic of Tanzania,Jamhuri ya Muungano wa Tanzania,TZ,Morogoro,TZ05,Kilosa,TZ0501,Mabula,TZ0501011,7168 ,3511 ,3657 ,7168 ,3511 ,0 ,0 ,0 ,3657 
United Republic of Tanzania,Jamhuri ya Muungano wa Tanzania,TZ,Morogoro,TZ05,Kilosa,TZ0501,Maguha,TZ0501021,7848 ,4018 ,3830 ,7848 ,4018 ,0 ,0 ,0 ,3830 
United Republic of Tanzania,Jamhuri ya Muungano wa Tanzania,TZ,Morogoro,TZ05,Kilosa,TZ0501,Berega,TZ0501031,11199 ,5486 ,5713 ,11199 ,5486 ,0 ,0 ,0 ,5713 
United Republic of Tanzania,Jamhuri ya Muungano wa Tanzania,TZ,Morogoro,TZ05,Kilosa,TZ0501,Magubike,TZ0501043,10274 ,5125 ,5149 ,6820 ,3446 ,3454 ,1679 ,1775 ,3374 
United Republic of Tanzania,Jamhuri ya Muungano wa Tanzania,TZ,Morogoro,TZ05,Kilosa,TZ0501,Mamboya,TZ0501051,28710 ,14312 ,14398 ,28710 ,14312 ,0 ,0 ,0 ,14398 
United Republic of Tanzania,Jamhuri ya Muungano wa Tanzania,TZ,Morogoro,TZ05,Kilosa,TZ0501,Dumila,TZ0501063,21288 ,10373 ,10915 ,3256 ,1653 ,18032 ,8720 ,9312 ,1603 
United Republic of Tanzania,Jamhuri ya Muungano wa Tanzania,TZ,Morogoro,TZ05,Kilosa,TZ0501,Magole,TZ0501073,20954 ,10657 ,10297 ,13445 ,7019 ,7509 ,3638 ,3871 ,6426 
United Republic of Tanzania,Jamhuri ya Muungano wa Tanzania,TZ,Morogoro,TZ05,Kilosa,TZ0501,Msowero,TZ0501083,29361 ,14899 ,14462 ,21131 ,10853 ,8230 ,4046 ,4184 ,10278 
United Republic of Tanzania,Jamhuri ya Muungano wa Tanzania,TZ,Morogoro,TZ05,Kilosa,TZ0501,Rudewa,TZ0501091,18352 ,9078 ,9274 ,18352 ,9078 ,0 ,0 ,0 ,9274 
United Republic of Tanzania,Jamhuri ya Muungano wa Tanzania,TZ,Morogoro,TZ05,Kilosa,TZ0501,Chanzulu,TZ0501101,12229 ,5973 ,6256 ,12229 ,5973 ,0 ,0 ,0 ,6256 
United Republic of Tanzania,Jamhuri ya Muungano wa Tanzania,TZ,Morogoro,TZ05,Kilosa,TZ0501,Kimamba 'A',TZ0501112,5967 ,2849 ,3118 ,0 ,0 ,5967 ,2849 ,3118 ,0 
United Republic of Tanzania,Jamhuri ya Muungano wa Tanzania,TZ,Morogoro,TZ05,Kilosa,TZ0501,Kimamba ' B ',TZ0501122,6079 ,2986 ,3093 ,0 ,0 ,6079 ,2986 ,3093 ,0 
United Republic of Tanzania,Jamhuri ya Muungano wa Tanzania,TZ,Morogoro,TZ05,Kilosa,TZ0501,Mbumi,TZ0501132,4540 ,2159 ,2381 ,0 ,0 ,4540 ,2159 ,2381 ,0 
United Republic of Tanzania,Jamhuri ya Muungano wa Tanzania,TZ,Morogoro,TZ05,Kilosa,TZ0501,Mkwatani,TZ0501142,12428 ,5866 ,6562 ,0 ,0 ,12428 ,5866 ,6562 ,0 
United Republic of Tanzania,Jamhuri ya Muungano wa Tanzania,TZ,Morogoro,TZ05,Kilosa,TZ0501,Magomeni,TZ0501152,11998 ,5834 ,6164 ,0 ,0 ,11998 ,5834 ,6164 ,0 
United Republic of Tanzania,Jamhuri ya Muungano wa Tanzania,TZ,Morogoro,TZ05,Kilosa,TZ0501,Kasiki,TZ0501162,5459 ,2762 ,2697 ,0 ,0 ,5459 ,2762 ,2697 ,0 
United Republic of Tanzania,Jamhuri ya Muungano wa Tanzania,TZ,Morogoro,TZ05,Kilosa,TZ0501,Mabwerebwere,TZ0501171,7155 ,3494 ,3661 ,7155 ,3494 ,0 ,0 ,0 ,3661 
United Republic of Tanzania,Jamhuri ya Muungano wa Tanzania,TZ,Morogoro,TZ05,Kilosa,TZ0501,Kilangali,TZ0501181,10679 ,5331 ,5348 ,10679 ,5331 ,0 ,0 ,0 ,5348 
United Republic of Tanzania,Jamhuri ya Muungano wa Tanzania,TZ,Morogoro,TZ05,Kilosa,TZ0501,Mikumi,TZ0501193,19977 ,9973 ,10004 ,5185 ,2717 ,14792 ,7256 ,7536 ,2468 
United Republic of Tanzania,Jamhuri ya Muungano wa Tanzania,TZ,Morogoro,TZ05,Kilosa,TZ0501,Ruhembe,TZ0501201,15198 ,7578 ,7620 ,15198 ,7578 ,0 ,0 ,0 ,7620 
United Republic of Tanzania,Jamhuri ya Muungano wa Tanzania,TZ,Morogoro,TZ05,Kilosa,TZ0501,Kidodi,TZ0501213,9106 ,4429 ,4677 ,9106 ,4429 ,0 ,0 ,0 ,4677 
United Republic of Tanzania,Jamhuri ya Muungano wa Tanzania,TZ,Morogoro,TZ05,Kilosa,TZ0501,Vidunda,TZ0501221,11698 ,5973 ,5725 ,11698 ,5973 ,0 ,0 ,0 ,5725 
United Republic of Tanzania,Jamhuri ya Muungano wa Tanzania,TZ,Morogoro,TZ05,Kilosa,TZ0501,Malolo,TZ0501231,10750 ,5504 ,5246 ,10750 ,5504 ,0 ,0 ,0 ,5246 
United Republic of Tanzania,Jamhuri ya Muungano wa Tanzania,TZ,Morogoro,TZ05,Kilosa,TZ0501,Kisanga,TZ0501243,14311 ,7386 ,6925 ,7884 ,3991 ,6427 ,3395 ,3032 ,3893 
United Republic of Tanzania,Jamhuri ya Muungano wa Tanzania,TZ,Morogoro,TZ05,Kilosa,TZ0501,Uleling'ombe,TZ0501251,4095 ,2067 ,2028 ,4095 ,2067 ,0 ,0 ,0 ,2028 
United Republic of Tanzania,Jamhuri ya Muungano wa Tanzania,TZ,Morogoro,TZ05,Kilosa,TZ0501,Ulaya,TZ0501261,17354 ,8833 ,8521 ,17354 ,8833 ,0 ,0 ,0 ,8521 
United Republic of Tanzania,Jamhuri ya Muungano wa Tanzania,TZ,Morogoro,TZ05,Kilosa,TZ0501,Zombo,TZ0501271,9982 ,4976 ,5006 ,9982 ,4976 ,0 ,0 ,0 ,5006 
United Republic of Tanzania,Jamhuri ya Muungano wa Tanzania,TZ,Morogoro,TZ05,Kilosa,TZ0501,Lumuma,TZ0501281,13221 ,6475 ,6746 ,13221 ,6475 ,0 ,0 ,0 ,6746 
United Republic of Tanzania,Jamhuri ya Muungano wa Tanzania,TZ,Morogoro,TZ05,Kilosa,TZ0501,Masanze,TZ0501291,7890 ,4059 ,3831 ,7890 ,4059 ,0 ,0 ,0 ,3831 
United Republic of Tanzania,Jamhuri ya Muungano wa Tanzania,TZ,Morogoro,TZ05,Kilosa,TZ0501,Kidete,TZ0501301,11329 ,5708 ,5621 ,11329 ,5708 ,0 ,0 ,0 ,5621 
United Republic of Tanzania,Jamhuri ya Muungano wa Tanzania,TZ,Morogoro,TZ05,Kilosa,TZ0501,Lumbiji,TZ0501311,6891 ,3504 ,3387 ,6891 ,3504 ,0 ,0 ,0 ,3387 
United Republic of Tanzania,Jamhuri ya Muungano wa Tanzania,TZ,Morogoro,TZ05,Kilosa,TZ0501,Kitete,TZ0501321,10247 ,5092 ,5155 ,10247 ,5092 ,0 ,0 ,0 ,5155 
United Republic of Tanzania,Jamhuri ya Muungano wa Tanzania,TZ,Morogoro,TZ05,Kilosa,TZ0501,Madoto,TZ0501331,3570 ,1757 ,1813 ,3570 ,1757 ,0 ,0 ,0 ,1813 
United Republic of Tanzania,Jamhuri ya Muungano wa Tanzania,TZ,Morogoro,TZ05,Kilosa,TZ0501,Tindiga,TZ0501341,13291 ,6513 ,6778 ,13291 ,6513 ,0 ,0 ,0 ,6778 
United Republic of Tanzania,Jamhuri ya Muungano wa Tanzania,TZ,Morogoro,TZ05,Kilosa,TZ0501,Ruaha,TZ0501353,27577 ,13838 ,13739 ,6263 ,3199 ,21314 ,10639 ,10675 ,3064 
United Republic of Tanzania,Jamhuri ya Muungano wa Tanzania,TZ,Morogoro,TZ05,Morogoro,TZ0502,Kasanga,TZ0502011,6558 ,3107 ,3451 ,6558 ,3107 ,0 ,0 ,0 ,3451 
United Republic of Tanzania,Jamhuri ya Muungano wa Tanzania,TZ,Morogoro,TZ05,Morogoro,TZ0502,Kolero,TZ0502021,9301 ,4521 ,4780 ,9301 ,4521 ,0 ,0 ,0 ,4780 
United Republic of Tanzania,Jamhuri ya Muungano wa Tanzania,TZ,Morogoro,TZ05,Morogoro,TZ0502,Mvuha,TZ0502031,14250 ,6955 ,7295 ,14250 ,6955 ,0 ,0 ,0 ,7295 
United Republic of Tanzania,Jamhuri ya Muungano wa Tanzania,TZ,Morogoro,TZ05,Morogoro,TZ0502,Selembala,TZ0502041,6861 ,3406 ,3455 ,6861 ,3406 ,0 ,0 ,0 ,3455 
United Republic of Tanzania,Jamhuri ya Muungano wa Tanzania,TZ,Morogoro,TZ05,Morogoro,TZ0502,Bwaki la Chini,TZ0502051,13718 ,6684 ,7034 ,13718 ,6684 ,0 ,0 ,0 ,7034 
United Republic of Tanzania,Jamhuri ya Muungano wa Tanzania,TZ,Morogoro,TZ05,Morogoro,TZ0502,Bwakila Juu,TZ0502061,5976 ,2862 ,3114 ,5976 ,2862 ,0 ,0 ,0 ,3114 
United Republic of Tanzania,Jamhuri ya Muungano wa Tanzania,TZ,Morogoro,TZ05,Morogoro,TZ0502,Kisaki,TZ0502071,13510 ,6543 ,6967 ,13510 ,6543 ,0 ,0 ,0 ,6967 
United Republic of Tanzania,Jamhuri ya Muungano wa Tanzania,TZ,Morogoro,TZ05,Morogoro,TZ0502,Mngazi,TZ0502081,9528 ,4553 ,4975 ,9528 ,4553 ,0 ,0 ,0 ,4975 
United Republic of Tanzania,Jamhuri ya Muungano wa Tanzania,TZ,Morogoro,TZ05,Morogoro,TZ0502,Singisa,TZ0502091,11493 ,5599 ,5894 ,11493 ,5599 ,0 ,0 ,0 ,5894 
United Republic of Tanzania,Jamhuri ya Muungano wa Tanzania,TZ,Morogoro,TZ05,Morogoro,TZ0502,Mkambarani,TZ0502101,11552 ,5883 ,5669 ,11552 ,5883 ,0 ,0 ,0 ,5669 
United Republic of Tanzania,Jamhuri ya Muungano wa Tanzania,TZ,Morogoro,TZ05,Morogoro,TZ0502,Mikese,TZ0502111,15569 ,7951 ,7618 ,15569 ,7951 ,0 ,0 ,0 ,7618 
United Republic of Tanzania,Jamhuri ya Muungano wa Tanzania,TZ,Morogoro,TZ05,Morogoro,TZ0502,Kidugalo,TZ0502121,9273 ,5014 ,4259 ,9273 ,5014 ,0 ,0 ,0 ,4259 
United Republic of Tanzania,Jamhuri ya Muungano wa Tanzania,TZ,Morogoro,TZ05,Morogoro,TZ0502,Mkulazi,TZ0502131,5065 ,2559 ,2506 ,5065 ,2559 ,0 ,0 ,0 ,2506 
United Republic of Tanzania,Jamhuri ya Muungano wa Tanzania,TZ,Morogoro,TZ05,Morogoro,TZ0502,Ngerengere,TZ0502143,11780 ,5705 ,6075 ,3683 ,1852 ,8097 ,3853 ,4244 ,1831 
United Republic of Tanzania,Jamhuri ya Muungano wa Tanzania,TZ,Morogoro,TZ05,Morogoro,TZ0502,Tununguo,TZ0502151,7462 ,3847 ,3615 ,7462 ,3847 ,0 ,0 ,0 ,3615 
United Republic of Tanzania,Jamhuri ya Muungano wa Tanzania,TZ,Morogoro,TZ05,Morogoro,TZ0502,Kinole,TZ0502161,11944 ,5802 ,6142 ,11944 ,5802 ,0 ,0 ,0 ,6142 
United Republic of Tanzania,Jamhuri ya Muungano wa Tanzania,TZ,Morogoro,TZ05,Morogoro,TZ0502,Kiroka,TZ0502171,21853 ,10601 ,11252 ,21853 ,10601 ,0 ,0 ,0 ,11252 
United Republic of Tanzania,Jamhuri ya Muungano wa Tanzania,TZ,Morogoro,TZ05,Morogoro,TZ0502,Mkuyuni,TZ0502181,17935 ,8560 ,9375 ,17935 ,8560 ,0 ,0 ,0 ,9375 
United Republic of Tanzania,Jamhuri ya Muungano wa Tanzania,TZ,Morogoro,TZ05,Morogoro,TZ0502,Tegetero,TZ0502191,6644 ,3315 ,3329 ,6644 ,3315 ,0 ,0 ,0 ,3329 
United Republic of Tanzania,Jamhuri ya Muungano wa Tanzania,TZ,Morogoro,TZ05,Morogoro,TZ0502,Kibogwa,TZ0502201,7986 ,3823 ,4163 ,7986 ,3823 ,0 ,0 ,0 ,4163 
United Republic of Tanzania,Jamhuri ya Muungano wa Tanzania,TZ,Morogoro,TZ05,Morogoro,TZ0502,Kibungo Juu,TZ0502211,6304 ,3060 ,3244 ,6304 ,3060 ,0 ,0 ,0 ,3244 
United Republic of Tanzania,Jamhuri ya Muungano wa Tanzania,TZ,Morogoro,TZ05,Morogoro,TZ0502,Kisemu,TZ0502223,9137 ,4365 ,4772 ,4217 ,2092 ,4920 ,2273 ,2647 ,2125 
United Republic of Tanzania,Jamhuri ya Muungano wa Tanzania,TZ,Morogoro,TZ05,Morogoro,TZ0502,Lundi,TZ0502231,9685 ,4860 ,4825 ,9685 ,4860 ,0 ,0 ,0 ,4825 
United Republic of Tanzania,Jamhuri ya Muungano wa Tanzania,TZ,Morogoro,TZ05,Morogoro,TZ0502,Mtombozi,TZ0502241,9215 ,4536 ,4679 ,9215 ,4536 ,0 ,0 ,0 ,4679 
United Republic of Tanzania,Jamhuri ya Muungano wa Tanzania,TZ,Morogoro,TZ05,Morogoro,TZ0502,Tawa,TZ0502251,11019 ,5358 ,5661 ,11019 ,5358 ,0 ,0 ,0 ,5661 
United Republic of Tanzania,Jamhuri ya Muungano wa Tanzania,TZ,Morogoro,TZ05,Morogoro,TZ0502,Matuli,TZ0502261,6103 ,3028 ,3075 ,6103 ,3028 ,0 ,0 ,0 ,3075 
United Republic of Tanzania,Jamhuri ya Muungano wa Tanzania,TZ,Morogoro,TZ05,Morogoro,TZ0502,Gwata,TZ0502271,6575 ,3396 ,3179 ,6575 ,3396 ,0 ,0 ,0 ,3179 
United Republic of Tanzania,Jamhuri ya Muungano wa Tanzania,TZ,Morogoro,TZ05,Morogoro,TZ0502,Konde,TZ0502281,5546 ,2738 ,2808 ,5546 ,2738 ,0 ,0 ,0 ,2808 
United Republic of Tanzania,Jamhuri ya Muungano wa Tanzania,TZ,Morogoro,TZ05,Morogoro,TZ0502,Bungu,TZ0502291,4406 ,2193 ,2213 ,4406 ,2193 ,0 ,0 ,0 ,2213 
United Republic of Tanzania,Jamhuri ya Muungano wa Tanzania,TZ,Morogoro,TZ05,Kilombero,TZ0503,Kidatu,TZ0503013,32589 ,16359 ,16230 ,15382 ,7569 ,17207 ,8790 ,8417 ,7813 
United Republic of Tanzania,Jamhuri ya Muungano wa Tanzania,TZ,Morogoro,TZ05,Kilombero,TZ0503,Sanje,TZ0503021,11041 ,5485 ,5556 ,11041 ,5485 ,0 ,0 ,0 ,5556 
United Republic of Tanzania,Jamhuri ya Muungano wa Tanzania,TZ,Morogoro,TZ05,Kilombero,TZ0503,Mkula,TZ0503031,9090 ,4443 ,4647 ,9090 ,4443 ,0 ,0 ,0 ,4647 
United Republic of Tanzania,Jamhuri ya Muungano wa Tanzania,TZ,Morogoro,TZ05,Kilombero,TZ0503,Mang'ula,TZ0503043,36176 ,17736 ,18440 ,30722 ,15083 ,5454 ,2653 ,2801 ,15639 
United Republic of Tanzania,Jamhuri ya Muungano wa Tanzania,TZ,Morogoro,TZ05,Kilombero,TZ0503,Kisawasawa,TZ0503051,9048 ,4642 ,4406 ,9048 ,4642 ,0 ,0 ,0 ,4406 
United Republic of Tanzania,Jamhuri ya Muungano wa Tanzania,TZ,Morogoro,TZ05,Kilombero,TZ0503,Kiberege,TZ0503061,22312 ,11075 ,11237 ,22312 ,11075 ,0 ,0 ,0 ,11237 
United Republic of Tanzania,Jamhuri ya Muungano wa Tanzania,TZ,Morogoro,TZ05,Kilombero,TZ0503,Kibaoni,TZ0503073,28869 ,13924 ,14945 ,17842 ,8757 ,11027 ,5167 ,5860 ,9085 
United Republic of Tanzania,Jamhuri ya Muungano wa Tanzania,TZ,Morogoro,TZ05,Kilombero,TZ0503,Ifakara,TZ0503083,55956 ,26620 ,29336 ,3924 ,2175 ,52032 ,24445 ,27587 ,1749 
United Republic of Tanzania,Jamhuri ya Muungano wa Tanzania,TZ,Morogoro,TZ05,Kilombero,TZ0503,Lumemo,TZ0503091,21599 ,10591 ,11008 ,21599 ,10591 ,0 ,0 ,0 ,11008 
United Republic of Tanzania,Jamhuri ya Muungano wa Tanzania,TZ,Morogoro,TZ05,Kilombero,TZ0503,Idete,TZ0503101,21648 ,11064 ,10584 ,21648 ,11064 ,0 ,0 ,0 ,10584 
United Republic of Tanzania,Jamhuri ya Muungano wa Tanzania,TZ,Morogoro,TZ05,Kilombero,TZ0503,Mbingu,TZ0503111,22717 ,11502 ,11215 ,22717 ,11502 ,0 ,0 ,0 ,11215 
United Republic of Tanzania,Jamhuri ya Muungano wa Tanzania,TZ,Morogoro,TZ05,Kilombero,TZ0503,Mofu,TZ0503121,11722 ,6025 ,5697 ,11722 ,6025 ,0 ,0 ,0 ,5697 
United Republic of Tanzania,Jamhuri ya Muungano wa Tanzania,TZ,Morogoro,TZ05,Kilombero,TZ0503,Mchombe,TZ0503131,38651 ,19660 ,18991 ,38651 ,19660 ,0 ,0 ,0 ,18991 
United Republic of Tanzania,Jamhuri ya Muungano wa Tanzania,TZ,Morogoro,TZ05,Kilombero,TZ0503,Chita,TZ0503141,22663 ,11597 ,11066 ,22663 ,11597 ,0 ,0 ,0 ,11066 
United Republic of Tanzania,Jamhuri ya Muungano wa Tanzania,TZ,Morogoro,TZ05,Kilombero,TZ0503,Chisano,TZ0503151,5737 ,2948 ,2789 ,5737 ,2948 ,0 ,0 ,0 ,2789 
United Republic of Tanzania,Jamhuri ya Muungano wa Tanzania,TZ,Morogoro,TZ05,Kilombero,TZ0503,Mlimba,TZ0503163,38108 ,18752 ,19356 ,25374 ,12558 ,12734 ,6194 ,6540 ,12816 
United Republic of Tanzania,Jamhuri ya Muungano wa Tanzania,TZ,Morogoro,TZ05,Kilombero,TZ0503,Utengule,TZ0503171,10562 ,5470 ,5092 ,10562 ,5470 ,0 ,0 ,0 ,5092 
United Republic of Tanzania,Jamhuri ya Muungano wa Tanzania,TZ,Morogoro,TZ05,Kilombero,TZ0503,Masagati,TZ0503181,7121 ,3718 ,3403 ,7121 ,3718 ,0 ,0 ,0 ,3403 
United Republic of Tanzania,Jamhuri ya Muungano wa Tanzania,TZ,Morogoro,TZ05,Kilombero,TZ0503,Uchindile,TZ0503191,2271 ,1178 ,1093 ,2271 ,1178 ,0 ,0 ,0 ,1093 
United Republic of Tanzania,Jamhuri ya Muungano wa Tanzania,TZ,Morogoro,TZ05,Ulanga,TZ0504,Minepa,TZ0504011,16267 ,8081 ,8186 ,16267 ,8081 ,0 ,0 ,0 ,8186 
United Republic of Tanzania,Jamhuri ya Muungano wa Tanzania,TZ,Morogoro,TZ05,Ulanga,TZ0504,Lupiro,TZ0504023,16329 ,8037 ,8292 ,9748 ,4834 ,6581 ,3203 ,3378 ,4914 
United Republic of Tanzania,Jamhuri ya Muungano wa Tanzania,TZ,Morogoro,TZ05,Ulanga,TZ0504,Kichangani,TZ0504031,6195 ,3052 ,3143 ,6195 ,3052 ,0 ,0 ,0 ,3143 
United Republic of Tanzania,Jamhuri ya Muungano wa Tanzania,TZ,Morogoro,TZ05,Ulanga,TZ0504,Msogezi,TZ0504041,6288 ,3261 ,3027 ,6288 ,3261 ,0 ,0 ,0 ,3027 
United Republic of Tanzania,Jamhuri ya Muungano wa Tanzania,TZ,Morogoro,TZ05,Ulanga,TZ0504,Vigoi,TZ0504053,14452 ,6958 ,7494 ,11968 ,6005 ,2484 ,953 ,1531 ,5963 
United Republic of Tanzania,Jamhuri ya Muungano wa Tanzania,TZ,Morogoro,TZ05,Ulanga,TZ0504,Mahenge,TZ0504062,9523 ,4670 ,4853 ,0 ,0 ,9523 ,4670 ,4853 ,0 
United Republic of Tanzania,Jamhuri ya Muungano wa Tanzania,TZ,Morogoro,TZ05,Ulanga,TZ0504,Isongo,TZ0504071,7981 ,3771 ,4210 ,7981 ,3771 ,0 ,0 ,0 ,4210 
United Republic of Tanzania,Jamhuri ya Muungano wa Tanzania,TZ,Morogoro,TZ05,Ulanga,TZ0504,Ruaha,TZ0504081,8745 ,4299 ,4446 ,8745 ,4299 ,0 ,0 ,0 ,4446 
United Republic of Tanzania,Jamhuri ya Muungano wa Tanzania,TZ,Morogoro,TZ05,Ulanga,TZ0504,Chirombola,TZ0504091,5870 ,2997 ,2873 ,5870 ,2997 ,0 ,0 ,0 ,2873 
United Republic of Tanzania,Jamhuri ya Muungano wa Tanzania,TZ,Morogoro,TZ05,Ulanga,TZ0504,Sali,TZ0504101,4932 ,2928 ,2004 ,4932 ,2928 ,0 ,0 ,0 ,2004 
United Republic of Tanzania,Jamhuri ya Muungano wa Tanzania,TZ,Morogoro,TZ05,Ulanga,TZ0504,Euga,TZ0504111,4598 ,2307 ,2291 ,4598 ,2307 ,0 ,0 ,0 ,2291 
United Republic of Tanzania,Jamhuri ya Muungano wa Tanzania,TZ,Morogoro,TZ05,Ulanga,TZ0504,Mwaya,TZ0504123,8763 ,4256 ,4507 ,3507 ,1714 ,5256 ,2542 ,2714 ,1793 
United Republic of Tanzania,Jamhuri ya Muungano wa Tanzania,TZ,Morogoro,TZ05,Ulanga,TZ0504,Lukande,TZ0504131,2897 ,1513 ,1384 ,2897 ,1513 ,0 ,0 ,0 ,1384 
United Republic of Tanzania,Jamhuri ya Muungano wa Tanzania,TZ,Morogoro,TZ05,Ulanga,TZ0504,Mbuga,TZ0504141,8212 ,4125 ,4087 ,8212 ,4125 ,0 ,0 ,0 ,4087 
United Republic of Tanzania,Jamhuri ya Muungano wa Tanzania,TZ,Morogoro,TZ05,Ulanga,TZ0504,Ilonga,TZ0504151,12143 ,6001 ,6142 ,12143 ,6001 ,0 ,0 ,0 ,6142 
United Republic of Tanzania,Jamhuri ya Muungano wa Tanzania,TZ,Morogoro,TZ05,Ulanga,TZ0504,Kilosa kwa Mpepo,TZ0504161,3253 ,1645 ,1608 ,3253 ,1645 ,0 ,0 ,0 ,1608 
United Republic of Tanzania,Jamhuri ya Muungano wa Tanzania,TZ,Morogoro,TZ05,Ulanga,TZ0504,Ngoheranga,TZ0504171,7335 ,3648 ,3687 ,7335 ,3648 ,0 ,0 ,0 ,3687 
United Republic of Tanzania,Jamhuri ya Muungano wa Tanzania,TZ,Morogoro,TZ05,Ulanga,TZ0504,Biro,TZ0504181,7124 ,3481 ,3643 ,7124 ,3481 ,0 ,0 ,0 ,3643 
United Republic of Tanzania,Jamhuri ya Muungano wa Tanzania,TZ,Morogoro,TZ05,Ulanga,TZ0504,Malinyi,TZ0504193,31249 ,15210 ,16039 ,25724 ,12596 ,5525 ,2614 ,2911 ,13128 
United Republic of Tanzania,Jamhuri ya Muungano wa Tanzania,TZ,Morogoro,TZ05,Ulanga,TZ0504,Sofi,TZ0504201,14084 ,6902 ,7182 ,14084 ,6902 ,0 ,0 ,0 ,7182 
United Republic of Tanzania,Jamhuri ya Muungano wa Tanzania,TZ,Morogoro,TZ05,Ulanga,TZ0504,Usangule,TZ0504211,14402 ,7096 ,7306 ,14402 ,7096 ,0 ,0 ,0 ,7306 
United Republic of Tanzania,Jamhuri ya Muungano wa Tanzania,TZ,Morogoro,TZ05,Ulanga,TZ0504,Mtimbira,TZ0504223,16000 ,7936 ,8064 ,11461 ,5696 ,4539 ,2240 ,2299 ,5765 
United Republic of Tanzania,Jamhuri ya Muungano wa Tanzania,TZ,Morogoro,TZ05,Ulanga,TZ0504,Itete,TZ0504231,20755 ,10296 ,10459 ,20755 ,10296 ,0 ,0 ,0 ,10459 
United Republic of Tanzania,Jamhuri ya Muungano wa Tanzania,TZ,Morogoro,TZ05,Ulanga,TZ0504,Iragua,TZ0504241,17806 ,9092 ,8714 ,17806 ,9092 ,0 ,0 ,0 ,8714 
United Republic of Tanzania,Jamhuri ya Muungano wa Tanzania,TZ,Morogoro,TZ05,Morogoro Urban,TZ0505,Sabasaba,TZ0505012,2339 ,1164 ,1175 ,0 ,0 ,2339 ,1164 ,1175 ,0 
United Republic of Tanzania,Jamhuri ya Muungano wa Tanzania,TZ,Morogoro,TZ05,Morogoro Urban,TZ0505,Uwanja wa Taifa,TZ0505022,7247 ,3420 ,3827 ,0 ,0 ,7247 ,3420 ,3827 ,0 
United Republic of Tanzania,Jamhuri ya Muungano wa Tanzania,TZ,Morogoro,TZ05,Morogoro Urban,TZ0505,Kiwanja Cha Ndege,TZ0505032,12203 ,5825 ,6378 ,0 ,0 ,12203 ,5825 ,6378 ,0 
United Republic of Tanzania,Jamhuri ya Muungano wa Tanzania,TZ,Morogoro,TZ05,Morogoro Urban,TZ0505,Mji Mpya,TZ0505042,7359 ,3500 ,3859 ,0 ,0 ,7359 ,3500 ,3859 ,0 
United Republic of Tanzania,Jamhuri ya Muungano wa Tanzania,TZ,Morogoro,TZ05,Morogoro Urban,TZ0505,Kingo,TZ0505052,2944 ,1436 ,1508 ,0 ,0 ,2944 ,1436 ,1508 ,0 
United Republic of Tanzania,Jamhuri ya Muungano wa Tanzania,TZ,Morogoro,TZ05,Morogoro Urban,TZ0505,Mji Mkuu,TZ0505062,4612 ,2173 ,2439 ,0 ,0 ,4612 ,2173 ,2439 ,0 
United Republic of Tanzania,Jamhuri ya Muungano wa Tanzania,TZ,Morogoro,TZ05,Morogoro Urban,TZ0505,Sultan Area,TZ0505072,2604 ,1217 ,1387 ,0 ,0 ,2604 ,1217 ,1387 ,0 
United Republic of Tanzania,Jamhuri ya Muungano wa Tanzania,TZ,Morogoro,TZ05,Morogoro Urban,TZ0505,Mafiga,TZ0505082,13586 ,6344 ,7242 ,0 ,0 ,13586 ,6344 ,7242 ,0 
United Republic of Tanzania,Jamhuri ya Muungano wa Tanzania,TZ,Morogoro,TZ05,Morogoro Urban,TZ0505,Mazimbu,TZ0505092,72527 ,34312 ,38215 ,0 ,0 ,72527 ,34312 ,38215 ,0 
United Republic of Tanzania,Jamhuri ya Muungano wa Tanzania,TZ,Morogoro,TZ05,Morogoro Urban,TZ0505,Mwembesongo,TZ0505102,43571 ,21266 ,22305 ,0 ,0 ,43571 ,21266 ,22305 ,0 
United Republic of Tanzania,Jamhuri ya Muungano wa Tanzania,TZ,Morogoro,TZ05,Morogoro Urban,TZ0505,Kichangani,TZ0505112,19166 ,9146 ,10020 ,0 ,0 ,19166 ,9146 ,10020 ,0 
United Republic of Tanzania,Jamhuri ya Muungano wa Tanzania,TZ,Morogoro,TZ05,Morogoro Urban,TZ0505,Kilakala,TZ0505122,18345 ,8759 ,9586 ,0 ,0 ,18345 ,8759 ,9586 ,0 
United Republic of Tanzania,Jamhuri ya Muungano wa Tanzania,TZ,Morogoro,TZ05,Morogoro Urban,TZ0505,Boma,TZ0505132,8706 ,4378 ,4328 ,0 ,0 ,8706 ,4378 ,4328 ,0 
United Republic of Tanzania,Jamhuri ya Muungano wa Tanzania,TZ,Morogoro,TZ05,Morogoro Urban,TZ0505,Mlimani,TZ0505142,4893 ,2315 ,2578 ,0 ,0 ,4893 ,2315 ,2578 ,0 
United Republic of Tanzania,Jamhuri ya Muungano wa Tanzania,TZ,Morogoro,TZ05,Morogoro Urban,TZ0505,Mbuyuni,TZ0505152,11786 ,5611 ,6175 ,0 ,0 ,11786 ,5611 ,6175 ,0 
United Republic of Tanzania,Jamhuri ya Muungano wa Tanzania,TZ,Morogoro,TZ05,Morogoro Urban,TZ0505,Kingolwira,TZ0505162,21953 ,10631 ,11322 ,0 ,0 ,21953 ,10631 ,11322 ,0 
United Republic of Tanzania,Jamhuri ya Muungano wa Tanzania,TZ,Morogoro,TZ05,Morogoro Urban,TZ0505,Bigwa,TZ0505172,10149 ,4873 ,5276 ,10026 ,4843 ,123 ,30 ,93 ,5183 
United Republic of Tanzania,Jamhuri ya Muungano wa Tanzania,TZ,Morogoro,TZ05,Morogoro Urban,TZ0505,Mzinga,TZ0505182,7452 ,3711 ,3741 ,0 ,0 ,7452 ,3711 ,3741 ,0 
United Republic of Tanzania,Jamhuri ya Muungano wa Tanzania,TZ,Morogoro,TZ05,Morogoro Urban,TZ0505,Kihonda,TZ0505192,44424 ,21619 ,22805 ,0 ,0 ,44424 ,21619 ,22805 ,0 
United Republic of Tanzania,Jamhuri ya Muungano wa Tanzania,TZ,Morogoro,TZ05,Mvomero,TZ0506,Mvomero,TZ0506013,37321 ,18689 ,18632 ,28520 ,14311 ,8801 ,4378 ,4423 ,14209 
United Republic of Tanzania,Jamhuri ya Muungano wa Tanzania,TZ,Morogoro,TZ05,Mvomero,TZ0506,Hembeti,TZ0506021,21057 ,10311 ,10746 ,21057 ,10311 ,0 ,0 ,0 ,10746 
United Republic of Tanzania,Jamhuri ya Muungano wa Tanzania,TZ,Morogoro,TZ05,Mvomero,TZ0506,Maskati,TZ0506031,14396 ,7165 ,7231 ,14396 ,7165 ,0 ,0 ,0 ,7231 
United Republic of Tanzania,Jamhuri ya Muungano wa Tanzania,TZ,Morogoro,TZ05,Mvomero,TZ0506,Kibati,TZ0506041,22628 ,11289 ,11339 ,22628 ,11289 ,0 ,0 ,0 ,11339 
United Republic of Tanzania,Jamhuri ya Muungano wa Tanzania,TZ,Morogoro,TZ05,Mvomero,TZ0506,Sungaji,TZ0506051,14508 ,7131 ,7377 ,14508 ,7131 ,0 ,0 ,0 ,7377 
United Republic of Tanzania,Jamhuri ya Muungano wa Tanzania,TZ,Morogoro,TZ05,Mvomero,TZ0506,Mhonda,TZ0506063,20354 ,10073 ,10281 ,10312 ,5151 ,10042 ,4922 ,5120 ,5161 
United Republic of Tanzania,Jamhuri ya Muungano wa Tanzania,TZ,Morogoro,TZ05,Mvomero,TZ0506,Diongoya,TZ0506071,21017 ,10309 ,10708 ,21017 ,10309 ,0 ,0 ,0 ,10708 
United Republic of Tanzania,Jamhuri ya Muungano wa Tanzania,TZ,Morogoro,TZ05,Mvomero,TZ0506,Mtibwa,TZ0506083,31382 ,16025 ,15357 ,17199 ,8719 ,14183 ,7306 ,6877 ,8480 
United Republic of Tanzania,Jamhuri ya Muungano wa Tanzania,TZ,Morogoro,TZ05,Mvomero,TZ0506,Kanga,TZ0506091,21018 ,10782 ,10236 ,21018 ,10782 ,0 ,0 ,0 ,10236 
United Republic of Tanzania,Jamhuri ya Muungano wa Tanzania,TZ,Morogoro,TZ05,Mvomero,TZ0506,Bunduki,TZ0506101,7136 ,3467 ,3669 ,7136 ,3467 ,0 ,0 ,0 ,3669 
United Republic of Tanzania,Jamhuri ya Muungano wa Tanzania,TZ,Morogoro,TZ05,Mvomero,TZ0506,Kikeo,TZ0506111,14518 ,6987 ,7531 ,14518 ,6987 ,0 ,0 ,0 ,7531 
United Republic of Tanzania,Jamhuri ya Muungano wa Tanzania,TZ,Morogoro,TZ05,Mvomero,TZ0506,Langali,TZ0506123,8610 ,4169 ,4441 ,5974 ,2913 ,2636 ,1256 ,1380 ,3061 
United Republic of Tanzania,Jamhuri ya Muungano wa Tanzania,TZ,Morogoro,TZ05,Mvomero,TZ0506,Tchenzema,TZ0506131,11229 ,5356 ,5873 ,11229 ,5356 ,0 ,0 ,0 ,5873 
United Republic of Tanzania,Jamhuri ya Muungano wa Tanzania,TZ,Morogoro,TZ05,Mvomero,TZ0506,Mzumbe,TZ0506141,19056 ,9264 ,9792 ,19056 ,9264 ,0 ,0 ,0 ,9792 
United Republic of Tanzania,Jamhuri ya Muungano wa Tanzania,TZ,Morogoro,TZ05,Mvomero,TZ0506,Mlali,TZ0506151,23320 ,11470 ,11850 ,23320 ,11470 ,0 ,0 ,0 ,11850 
United Republic of Tanzania,Jamhuri ya Muungano wa Tanzania,TZ,Morogoro,TZ05,Mvomero,TZ0506,Doma,TZ0506161,13041 ,6580 ,6461 ,13041 ,6580 ,0 ,0 ,0 ,6461 
United Republic of Tanzania,Jamhuri ya Muungano wa Tanzania,TZ,Morogoro,TZ05,Mvomero,TZ0506,Melela,TZ0506171,11518 ,5776 ,5742 ,11518 ,5776 ,0 ,0 ,0 ,5742 
United Republic of Tanzania,Jamhuri ya Muungano wa Tanzania,TZ,Morogoro,TZ05,Gairo,TZ0507,Chakwale,TZ0507011,22603 ,10897 ,11706 ,22603 ,10897 ,0 ,0 ,0 ,11706 
United Republic of Tanzania,Jamhuri ya Muungano wa Tanzania,TZ,Morogoro,TZ05,Gairo,TZ0507,Iyogwe,TZ0507021,23286 ,11489 ,11797 ,23286 ,11489 ,0 ,0 ,0 ,11797 
United Republic of Tanzania,Jamhuri ya Muungano wa Tanzania,TZ,Morogoro,TZ05,Gairo,TZ0507,Idibo,TZ0507031,17837 ,8788 ,9049 ,17837 ,8788 ,0 ,0 ,0 ,9049 
United Republic of Tanzania,Jamhuri ya Muungano wa Tanzania,TZ,Morogoro,TZ05,Gairo,TZ0507,Kibedya,TZ0507041,19369 ,9282 ,10087 ,19369 ,9282 ,0 ,0 ,0 ,10087 
United Republic of Tanzania,Jamhuri ya Muungano wa Tanzania,TZ,Morogoro,TZ05,Gairo,TZ0507,Msingisi,TZ0507051,15489 ,7365 ,8124 ,15489 ,7365 ,0 ,0 ,0 ,8124 
United Republic of Tanzania,Jamhuri ya Muungano wa Tanzania,TZ,Morogoro,TZ05,Gairo,TZ0507,Gairo,TZ0507063,33209 ,16112 ,17097 ,10261 ,5042 ,22948 ,11070 ,11878 ,5219 
United Republic of Tanzania,Jamhuri ya Muungano wa Tanzania,TZ,Morogoro,TZ05,Gairo,TZ0507,Rubeho,TZ0507071,22263 ,10471 ,11792 ,22263 ,10471 ,0 ,0 ,0 ,11792 
United Republic of Tanzania,Jamhuri ya Muungano wa Tanzania,TZ,Morogoro,TZ05,Gairo,TZ0507,Mandege,TZ0507081,8382 ,4096 ,4286 ,8382 ,4096 ,0 ,0 ,0 ,4286 
United Republic of Tanzania,Jamhuri ya Muungano wa Tanzania,TZ,Morogoro,TZ05,Gairo,TZ0507,Chagongwe,TZ0507091,11302 ,5279 ,6023 ,11302 ,5279 ,0 ,0 ,0 ,6023 
United Republic of Tanzania,Jamhuri ya Muungano wa Tanzania,TZ,Morogoro,TZ05,Gairo,TZ0507,Chanjale,TZ0507101,10108 ,5005 ,5103 ,10108 ,5005 ,0 ,0 ,0 ,5103 
United Republic of Tanzania,Jamhuri ya Muungano wa Tanzania,TZ,Morogoro,TZ05,Gairo,TZ0507,Nongwe,TZ0507111,9163 ,4422 ,4741 ,9163 ,4422 ,0 ,0 ,0 ,4741 
United Republic of Tanzania,Jamhuri ya Muungano wa Tanzania,TZ,Pwani,TZ06,Bagamoyo,TZ0601,Kiwangwa,TZ0601011,14586 ,7403 ,7183 ,14586 ,7403 ,0 ,0 ,0 ,7183 
United Republic of Tanzania,Jamhuri ya Muungano wa Tanzania,TZ,Pwani,TZ06,Bagamoyo,TZ0601,Msata,TZ0601021,13740 ,6844 ,6896 ,13740 ,6844 ,0 ,0 ,0 ,6896 
United Republic of Tanzania,Jamhuri ya Muungano wa Tanzania,TZ,Pwani,TZ06,Bagamoyo,TZ0601,Miono,TZ0601033,17009 ,8301 ,8708 ,8799 ,4406 ,8210 ,3895 ,4315 ,4393 
United Republic of Tanzania,Jamhuri ya Muungano wa Tanzania,TZ,Pwani,TZ06,Bagamoyo,TZ0601,Mkange,TZ0601041,12026 ,5981 ,6045 ,12026 ,5981 ,0 ,0 ,0 ,6045 
United Republic of Tanzania,Jamhuri ya Muungano wa Tanzania,TZ,Pwani,TZ06,Bagamoyo,TZ0601,Magomeni,TZ0601053,29234 ,14665 ,14569 ,9740 ,5083 ,19494 ,9582 ,9912 ,4657 
United Republic of Tanzania,Jamhuri ya Muungano wa Tanzania,TZ,Pwani,TZ06,Bagamoyo,TZ0601,Dunda,TZ0601062,14559 ,7091 ,7468 ,0 ,0 ,14559 ,7091 ,7468 ,0 
United Republic of Tanzania,Jamhuri ya Muungano wa Tanzania,TZ,Pwani,TZ06,Bagamoyo,TZ0601,Kiromo,TZ0601071,7279 ,3677 ,3602 ,7279 ,3677 ,0 ,0 ,0 ,3602 
United Republic of Tanzania,Jamhuri ya Muungano wa Tanzania,TZ,Pwani,TZ06,Bagamoyo,TZ0601,Zinga,TZ0601081,11189 ,5600 ,5589 ,11189 ,5600 ,0 ,0 ,0 ,5589 
United Republic of Tanzania,Jamhuri ya Muungano wa Tanzania,TZ,Pwani,TZ06,Bagamoyo,TZ0601,Yombo,TZ0601091,8262 ,4138 ,4124 ,8262 ,4138 ,0 ,0 ,0 ,4124 
United Republic of Tanzania,Jamhuri ya Muungano wa Tanzania,TZ,Pwani,TZ06,Bagamoyo,TZ0601,Vigwaza,TZ0601101,16650 ,8176 ,8474 ,16650 ,8176 ,0 ,0 ,0 ,8474 
United Republic of Tanzania,Jamhuri ya Muungano wa Tanzania,TZ,Pwani,TZ06,Bagamoyo,TZ0601,Talawanda,TZ0601111,9229 ,4710 ,4519 ,9229 ,4710 ,0 ,0 ,0 ,4519 
United Republic of Tanzania,Jamhuri ya Muungano wa Tanzania,TZ,Pwani,TZ06,Bagamoyo,TZ0601,Bwilingu,TZ0601123,35149 ,16810 ,18339 ,18035 ,8662 ,17114 ,8148 ,8966 ,9373 
United Republic of Tanzania,Jamhuri ya Muungano wa Tanzania,TZ,Pwani,TZ06,Bagamoyo,TZ0601,Lugoba,TZ0601133,11423 ,5624 ,5799 ,6477 ,3306 ,4946 ,2318 ,2628 ,3171 
United Republic of Tanzania,Jamhuri ya Muungano wa Tanzania,TZ,Pwani,TZ06,Bagamoyo,TZ0601,Ubenazomozi,TZ0601141,15343 ,7644 ,7699 ,15343 ,7644 ,0 ,0 ,0 ,7699 
United Republic of Tanzania,Jamhuri ya Muungano wa Tanzania,TZ,Pwani,TZ06,Bagamoyo,TZ0601,Mbwewe,TZ0601153,14509 ,7029 ,7480 ,9384 ,4647 ,5125 ,2382 ,2743 ,4737 
United Republic of Tanzania,Jamhuri ya Muungano wa Tanzania,TZ,Pwani,TZ06,Bagamoyo,TZ0601,Kibindu,TZ0601161,13673 ,7098 ,6575 ,13673 ,7098 ,0 ,0 ,0 ,6575 
United Republic of Tanzania,Jamhuri ya Muungano wa Tanzania,TZ,Pwani,TZ06,Bagamoyo,TZ0601,Fukayose,TZ0601171,9129 ,4823 ,4306 ,9129 ,4823 ,0 ,0 ,0 ,4306 
United Republic of Tanzania,Jamhuri ya Muungano wa Tanzania,TZ,Pwani,TZ06,Bagamoyo,TZ0601,Kerege,TZ0601181,18008 ,8609 ,9399 ,18008 ,8609 ,0 ,0 ,0 ,9399 
United Republic of Tanzania,Jamhuri ya Muungano wa Tanzania,TZ,Pwani,TZ06,Bagamoyo,TZ0601,Pera,TZ0601193,12701 ,6164 ,6537 ,7871 ,3854 ,4830 ,2310 ,2520 ,4017 
United Republic of Tanzania,Jamhuri ya Muungano wa Tanzania,TZ,Pwani,TZ06,Bagamoyo,TZ0601,Msoga,TZ0601203,10144 ,4961 ,5183 ,9634 ,4710 ,510 ,251 ,259 ,4924 
United Republic of Tanzania,Jamhuri ya Muungano wa Tanzania,TZ,Pwani,TZ06,Bagamoyo,TZ0601,Kimange,TZ0601211,8533 ,4174 ,4359 ,8533 ,4174 ,0 ,0 ,0 ,4359 
United Republic of Tanzania,Jamhuri ya Muungano wa Tanzania,TZ,Pwani,TZ06,Bagamoyo,TZ0601,Mandera,TZ0601221,9365 ,4676 ,4689 ,9365 ,4676 ,0 ,0 ,0 ,4689 
United Republic of Tanzania,Jamhuri ya Muungano wa Tanzania,TZ,Pwani,TZ06,Kibaha,TZ0602,Gwata,TZ0602011,5280 ,2585 ,2695 ,5280 ,2585 ,0 ,0 ,0 ,2695 
United Republic of Tanzania,Jamhuri ya Muungano wa Tanzania,TZ,Pwani,TZ06,Kibaha,TZ0602,Dutumi,TZ0602021,1812 ,939 ,873 ,1812 ,939 ,0 ,0 ,0 ,873 
United Republic of Tanzania,Jamhuri ya Muungano wa Tanzania,TZ,Pwani,TZ06,Kibaha,TZ0602,Magindu,TZ0602031,4991 ,2453 ,2538 ,4991 ,2453 ,0 ,0 ,0 ,2538 
United Republic of Tanzania,Jamhuri ya Muungano wa Tanzania,TZ,Pwani,TZ06,Kibaha,TZ0602,Soga,TZ0602041,4713 ,2428 ,2285 ,4713 ,2428 ,0 ,0 ,0 ,2285 
United Republic of Tanzania,Jamhuri ya Muungano wa Tanzania,TZ,Pwani,TZ06,Kibaha,TZ0602,Kikongo,TZ0602051,4238 ,2112 ,2126 ,4238 ,2112 ,0 ,0 ,0 ,2126 
United Republic of Tanzania,Jamhuri ya Muungano wa Tanzania,TZ,Pwani,TZ06,Kibaha,TZ0602,Ruvu,TZ0602061,3466 ,1719 ,1747 ,3466 ,1719 ,0 ,0 ,0 ,1747 
United Republic of Tanzania,Jamhuri ya Muungano wa Tanzania,TZ,Pwani,TZ06,Kibaha,TZ0602,Mlandizi,TZ0602073,17318 ,8546 ,8772 ,3047 ,1534 ,14271 ,7012 ,7259 ,1513 
United Republic of Tanzania,Jamhuri ya Muungano wa Tanzania,TZ,Pwani,TZ06,Kibaha,TZ0602,Kwala,TZ0602081,3472 ,1749 ,1723 ,3472 ,1749 ,0 ,0 ,0 ,1723 
United Republic of Tanzania,Jamhuri ya Muungano wa Tanzania,TZ,Pwani,TZ06,Kibaha,TZ0602,Kilangalanga,TZ0602093,10588 ,4997 ,5591 ,1889 ,908 ,8699 ,4089 ,4610 ,981 
United Republic of Tanzania,Jamhuri ya Muungano wa Tanzania,TZ,Pwani,TZ06,Kibaha,TZ0602,Janga,TZ0602103,10926 ,5242 ,5684 ,2057 ,1055 ,8869 ,4187 ,4682 ,1002 
United Republic of Tanzania,Jamhuri ya Muungano wa Tanzania,TZ,Pwani,TZ06,Kibaha,TZ0602,Bokomnemela,TZ0602111,3405 ,1745 ,1660 ,3405 ,1745 ,0 ,0 ,0 ,1660 
United Republic of Tanzania,Jamhuri ya Muungano wa Tanzania,TZ,Pwani,TZ06,Kisarawe,TZ0603,Kisarawe,TZ0603013,11838 ,5835 ,6003 ,4799 ,2497 ,7039 ,3338 ,3701 ,2302 
United Republic of Tanzania,Jamhuri ya Muungano wa Tanzania,TZ,Pwani,TZ06,Kisarawe,TZ0603,Msimbu,TZ0603021,11147 ,5569 ,5578 ,11147 ,5569 ,0 ,0 ,0 ,5578 
United Republic of Tanzania,Jamhuri ya Muungano wa Tanzania,TZ,Pwani,TZ06,Kisarawe,TZ0603,Masaki,TZ0603031,7202 ,3649 ,3553 ,7202 ,3649 ,0 ,0 ,0 ,3553 
United Republic of Tanzania,Jamhuri ya Muungano wa Tanzania,TZ,Pwani,TZ06,Kisarawe,TZ0603,Kibuta,TZ0603041,10146 ,5113 ,5033 ,10146 ,5113 ,0 ,0 ,0 ,5033 
United Republic of Tanzania,Jamhuri ya Muungano wa Tanzania,TZ,Pwani,TZ06,Kisarawe,TZ0603,Marumbo,TZ0603051,5682 ,2754 ,2928 ,5682 ,2754 ,0 ,0 ,0 ,2928 
United Republic of Tanzania,Jamhuri ya Muungano wa Tanzania,TZ,Pwani,TZ06,Kisarawe,TZ0603,Maneromango,TZ0603063,7896 ,3792 ,4104 ,5880 ,2836 ,2016 ,956 ,1060 ,3044 
United Republic of Tanzania,Jamhuri ya Muungano wa Tanzania,TZ,Pwani,TZ06,Kisarawe,TZ0603,Msanga,TZ0603073,5422 ,2652 ,2770 ,3901 ,1885 ,1521 ,767 ,754 ,2016 
United Republic of Tanzania,Jamhuri ya Muungano wa Tanzania,TZ,Pwani,TZ06,Kisarawe,TZ0603,Marui,TZ0603081,3793 ,1901 ,1892 ,3793 ,1901 ,0 ,0 ,0 ,1892 
United Republic of Tanzania,Jamhuri ya Muungano wa Tanzania,TZ,Pwani,TZ06,Kisarawe,TZ0603,Cholesamvula,TZ0603091,6061 ,3009 ,3052 ,6061 ,3009 ,0 ,0 ,0 ,3052 
United Republic of Tanzania,Jamhuri ya Muungano wa Tanzania,TZ,Pwani,TZ06,Kisarawe,TZ0603,Vikumbulu,TZ0603101,3248 ,1663 ,1585 ,3248 ,1663 ,0 ,0 ,0 ,1585 
United Republic of Tanzania,Jamhuri ya Muungano wa Tanzania,TZ,Pwani,TZ06,Kisarawe,TZ0603,Mafizi,TZ0603111,6546 ,3428 ,3118 ,6546 ,3428 ,0 ,0 ,0 ,3118 
United Republic of Tanzania,Jamhuri ya Muungano wa Tanzania,TZ,Pwani,TZ06,Kisarawe,TZ0603,Kurui,TZ0603121,2995 ,1527 ,1468 ,2995 ,1527 ,0 ,0 ,0 ,1468 
United Republic of Tanzania,Jamhuri ya Muungano wa Tanzania,TZ,Pwani,TZ06,Kisarawe,TZ0603,Mzenga,TZ0603131,5458 ,2664 ,2794 ,5458 ,2664 ,0 ,0 ,0 ,2794 
United Republic of Tanzania,Jamhuri ya Muungano wa Tanzania,TZ,Pwani,TZ06,Kisarawe,TZ0603,Vihingo,TZ0603141,3300 ,1707 ,1593 ,3300 ,1707 ,0 ,0 ,0 ,1593 
United Republic of Tanzania,Jamhuri ya Muungano wa Tanzania,TZ,Pwani,TZ06,Kisarawe,TZ0603,Kiluvya,TZ0603153,10864 ,5368 ,5496 ,4016 ,1987 ,6848 ,3381 ,3467 ,2029 
United Republic of Tanzania,Jamhuri ya Muungano wa Tanzania,TZ,Pwani,TZ06,Mkuranga,TZ0604,Mkuranga,TZ0604013,25847 ,12256 ,13591 ,16492 ,7952 ,9355 ,4304 ,5051 ,8540 
United Republic of Tanzania,Jamhuri ya Muungano wa Tanzania,TZ,Pwani,TZ06,Mkuranga,TZ0604,Tambani,TZ0604021,20204 ,10024 ,10180 ,20204 ,10024 ,0 ,0 ,0 ,10180 
United Republic of Tanzania,Jamhuri ya Muungano wa Tanzania,TZ,Pwani,TZ06,Mkuranga,TZ0604,Vikindu,TZ0604033,34762 ,16967 ,17795 ,16400 ,8295 ,18362 ,8672 ,9690 ,8105 
United Republic of Tanzania,Jamhuri ya Muungano wa Tanzania,TZ,Pwani,TZ06,Mkuranga,TZ0604,Mbezi,TZ0604041,7759 ,3765 ,3994 ,7759 ,3765 ,0 ,0 ,0 ,3994 
United Republic of Tanzania,Jamhuri ya Muungano wa Tanzania,TZ,Pwani,TZ06,Mkuranga,TZ0604,Shungubweni,TZ0604051,2985 ,1541 ,1444 ,2985 ,1541 ,0 ,0 ,0 ,1444 
United Republic of Tanzania,Jamhuri ya Muungano wa Tanzania,TZ,Pwani,TZ06,Mkuranga,TZ0604,Kisiju,TZ0604061,12113 ,5902 ,6211 ,12113 ,5902 ,0 ,0 ,0 ,6211 
United Republic of Tanzania,Jamhuri ya Muungano wa Tanzania,TZ,Pwani,TZ06,Mkuranga,TZ0604,Magawa,TZ0604071,5852 ,2874 ,2978 ,5852 ,2874 ,0 ,0 ,0 ,2978 
United Republic of Tanzania,Jamhuri ya Muungano wa Tanzania,TZ,Pwani,TZ06,Mkuranga,TZ0604,Kitomondo,TZ0604081,4880 ,2311 ,2569 ,4880 ,2311 ,0 ,0 ,0 ,2569 
United Republic of Tanzania,Jamhuri ya Muungano wa Tanzania,TZ,Pwani,TZ06,Mkuranga,TZ0604,Lukanga,TZ0604091,10355 ,4914 ,5441 ,10355 ,4914 ,0 ,0 ,0 ,5441 
United Republic of Tanzania,Jamhuri ya Muungano wa Tanzania,TZ,Pwani,TZ06,Mkuranga,TZ0604,Nyamato,TZ0604101,11834 ,5736 ,6098 ,11834 ,5736 ,0 ,0 ,0 ,6098 
United Republic of Tanzania,Jamhuri ya Muungano wa Tanzania,TZ,Pwani,TZ06,Mkuranga,TZ0604,Kimanzichana,TZ0604113,17846 ,8301 ,9545 ,9384 ,4426 ,8462 ,3875 ,4587 ,4958 
United Republic of Tanzania,Jamhuri ya Muungano wa Tanzania,TZ,Pwani,TZ06,Mkuranga,TZ0604,Mkamba,TZ0604121,14492 ,7190 ,7302 ,14492 ,7190 ,0 ,0 ,0 ,7302 
United Republic of Tanzania,Jamhuri ya Muungano wa Tanzania,TZ,Pwani,TZ06,Mkuranga,TZ0604,Panzuo,TZ0604131,7559 ,3829 ,3730 ,7559 ,3829 ,0 ,0 ,0 ,3730 
United Republic of Tanzania,Jamhuri ya Muungano wa Tanzania,TZ,Pwani,TZ06,Mkuranga,TZ0604,Bupu,TZ0604141,7241 ,3615 ,3626 ,7241 ,3615 ,0 ,0 ,0 ,3626 
United Republic of Tanzania,Jamhuri ya Muungano wa Tanzania,TZ,Pwani,TZ06,Mkuranga,TZ0604,Mwarusembe,TZ0604153,5182 ,2662 ,2520 ,5182 ,2662 ,0 ,0 ,0 ,2520 
United Republic of Tanzania,Jamhuri ya Muungano wa Tanzania,TZ,Pwani,TZ06,Mkuranga,TZ0604,Vianzi,TZ0604161,10264 ,5070 ,5194 ,10264 ,5070 ,0 ,0 ,0 ,5194 
United Republic of Tanzania,Jamhuri ya Muungano wa Tanzania,TZ,Pwani,TZ06,Mkuranga,TZ0604,Njia nne,TZ0604171,6627 ,3195 ,3432 ,6627 ,3195 ,0 ,0 ,0 ,3432 
United Republic of Tanzania,Jamhuri ya Muungano wa Tanzania,TZ,Pwani,TZ06,Mkuranga,TZ0604,Kiparang'anda,TZ0604181,10595 ,4974 ,5621 ,10595 ,4974 ,0 ,0 ,0 ,5621 
United Republic of Tanzania,Jamhuri ya Muungano wa Tanzania,TZ,Pwani,TZ06,Rufiji,TZ0605,Ikwiriri,TZ0605013,12200 ,5808 ,6392 ,3141 ,1568 ,9059 ,4240 ,4819 ,1573 
United Republic of Tanzania,Jamhuri ya Muungano wa Tanzania,TZ,Pwani,TZ06,Rufiji,TZ0605,Mgomba,TZ0605023,9027 ,4298 ,4729 ,2211 ,1113 ,6816 ,3185 ,3631 ,1098 
United Republic of Tanzania,Jamhuri ya Muungano wa Tanzania,TZ,Pwani,TZ06,Rufiji,TZ0605,Umwe,TZ0605032,10936 ,5182 ,5754 ,0 ,0 ,10936 ,5182 ,5754 ,0 
United Republic of Tanzania,Jamhuri ya Muungano wa Tanzania,TZ,Pwani,TZ06,Rufiji,TZ0605,Utete,TZ0605043,5878 ,2794 ,3084 ,1312 ,647 ,4566 ,2147 ,2419 ,665 
United Republic of Tanzania,Jamhuri ya Muungano wa Tanzania,TZ,Pwani,TZ06,Rufiji,TZ0605,Mkongo,TZ0605051,4619 ,2199 ,2420 ,4619 ,2199 ,0 ,0 ,0 ,2420 
United Republic of Tanzania,Jamhuri ya Muungano wa Tanzania,TZ,Pwani,TZ06,Rufiji,TZ0605,Ngorongo,TZ0605061,11946 ,5902 ,6044 ,11946 ,5902 ,0 ,0 ,0 ,6044 
United Republic of Tanzania,Jamhuri ya Muungano wa Tanzania,TZ,Pwani,TZ06,Rufiji,TZ0605,Mwaseni,TZ0605071,6391 ,3270 ,3121 ,6391 ,3270 ,0 ,0 ,0 ,3121 
United Republic of Tanzania,Jamhuri ya Muungano wa Tanzania,TZ,Pwani,TZ06,Rufiji,TZ0605,Kibiti,TZ0605083,15156 ,7150 ,8006 ,4216 ,2039 ,10940 ,5111 ,5829 ,2177 
United Republic of Tanzania,Jamhuri ya Muungano wa Tanzania,TZ,Pwani,TZ06,Rufiji,TZ0605,Bungu,TZ0605093,18719 ,8884 ,9835 ,12544 ,6070 ,6175 ,2814 ,3361 ,6474 
United Republic of Tanzania,Jamhuri ya Muungano wa Tanzania,TZ,Pwani,TZ06,Rufiji,TZ0605,Mahege,TZ0605101,5968 ,2831 ,3137 ,5968 ,2831 ,0 ,0 ,0 ,3137 
United Republic of Tanzania,Jamhuri ya Muungano wa Tanzania,TZ,Pwani,TZ06,Rufiji,TZ0605,Mchukwi,TZ0605111,7001 ,3411 ,3590 ,7001 ,3411 ,0 ,0 ,0 ,3590 
United Republic of Tanzania,Jamhuri ya Muungano wa Tanzania,TZ,Pwani,TZ06,Rufiji,TZ0605,Chumbi,TZ0605123,16334 ,7933 ,8401 ,11819 ,5846 ,4515 ,2087 ,2428 ,5973 
United Republic of Tanzania,Jamhuri ya Muungano wa Tanzania,TZ,Pwani,TZ06,Rufiji,TZ0605,Mbwara,TZ0605131,9709 ,4598 ,5111 ,9709 ,4598 ,0 ,0 ,0 ,5111 
United Republic of Tanzania,Jamhuri ya Muungano wa Tanzania,TZ,Pwani,TZ06,Rufiji,TZ0605,Mtunda,TZ0605141,8135 ,3998 ,4137 ,8135 ,3998 ,0 ,0 ,0 ,4137 
United Republic of Tanzania,Jamhuri ya Muungano wa Tanzania,TZ,Pwani,TZ06,Rufiji,TZ0605,Ruaruke,TZ0605151,7229 ,3450 ,3779 ,7229 ,3450 ,0 ,0 ,0 ,3779 
United Republic of Tanzania,Jamhuri ya Muungano wa Tanzania,TZ,Pwani,TZ06,Rufiji,TZ0605,Salale,TZ0605161,9076 ,4462 ,4614 ,9076 ,4462 ,0 ,0 ,0 ,4614 
United Republic of Tanzania,Jamhuri ya Muungano wa Tanzania,TZ,Pwani,TZ06,Rufiji,TZ0605,Mbuchi,TZ0605171,6025 ,2992 ,3033 ,6025 ,2992 ,0 ,0 ,0 ,3033 
United Republic of Tanzania,Jamhuri ya Muungano wa Tanzania,TZ,Pwani,TZ06,Rufiji,TZ0605,Kiongoroni,TZ0605181,4896 ,2433 ,2463 ,4896 ,2433 ,0 ,0 ,0 ,2463 
United Republic of Tanzania,Jamhuri ya Muungano wa Tanzania,TZ,Pwani,TZ06,Rufiji,TZ0605,Maparoni,TZ0605191,5783 ,2788 ,2995 ,5783 ,2788 ,0 ,0 ,0 ,2995 
United Republic of Tanzania,Jamhuri ya Muungano wa Tanzania,TZ,Pwani,TZ06,Rufiji,TZ0605,Chemchem,TZ0605203,5133 ,2446 ,2687 ,1944 ,930 ,3189 ,1516 ,1673 ,1014 
United Republic of Tanzania,Jamhuri ya Muungano wa Tanzania,TZ,Pwani,TZ06,Rufiji,TZ0605,Ngarambe,TZ0605211,2453 ,1253 ,1200 ,2453 ,1253 ,0 ,0 ,0 ,1200 
United Republic of Tanzania,Jamhuri ya Muungano wa Tanzania,TZ,Pwani,TZ06,Rufiji,TZ0605,Dimani,TZ0605221,5445 ,2701 ,2744 ,5445 ,2701 ,0 ,0 ,0 ,2744 
United Republic of Tanzania,Jamhuri ya Muungano wa Tanzania,TZ,Pwani,TZ06,Rufiji,TZ0605,Mtawanya,TZ0605231,6772 ,3251 ,3521 ,6772 ,3251 ,0 ,0 ,0 ,3521 
United Republic of Tanzania,Jamhuri ya Muungano wa Tanzania,TZ,Pwani,TZ06,Rufiji,TZ0605,Mjawa,TZ0605241,12045 ,5606 ,6439 ,12045 ,5606 ,0 ,0 ,0 ,6439 
United Republic of Tanzania,Jamhuri ya Muungano wa Tanzania,TZ,Pwani,TZ06,Rufiji,TZ0605,Mlanzi,TZ0605251,5216 ,2549 ,2667 ,5216 ,2549 ,0 ,0 ,0 ,2667 
United Republic of Tanzania,Jamhuri ya Muungano wa Tanzania,TZ,Pwani,TZ06,Rufiji,TZ0605,Mwambao,TZ0605261,11706 ,5560 ,6146 ,8390 ,4032 ,3316 ,1528 ,1788 ,4358 
United Republic of Tanzania,Jamhuri ya Muungano wa Tanzania,TZ,Pwani,TZ06,Mafia,TZ0606,Kanga,TZ0606011,3758 ,1859 ,1899 ,3758 ,1859 ,0 ,0 ,0 ,1899 
United Republic of Tanzania,Jamhuri ya Muungano wa Tanzania,TZ,Pwani,TZ06,Mafia,TZ0606,Kirongwe,TZ0606021,5701 ,2951 ,2750 ,5701 ,2951 ,0 ,0 ,0 ,2750 
United Republic of Tanzania,Jamhuri ya Muungano wa Tanzania,TZ,Pwani,TZ06,Mafia,TZ0606,Baleni,TZ0606031,5870 ,2994 ,2876 ,5870 ,2994 ,0 ,0 ,0 ,2876 
United Republic of Tanzania,Jamhuri ya Muungano wa Tanzania,TZ,Pwani,TZ06,Mafia,TZ0606,Kilindoni,TZ0606043,14221 ,6767 ,7454 ,2080 ,1022 ,12141 ,5745 ,6396 ,1058 
United Republic of Tanzania,Jamhuri ya Muungano wa Tanzania,TZ,Pwani,TZ06,Mafia,TZ0606,Miburani,TZ0606051,4106 ,1966 ,2140 ,4106 ,1966 ,0 ,0 ,0 ,2140 
United Republic of Tanzania,Jamhuri ya Muungano wa Tanzania,TZ,Pwani,TZ06,Mafia,TZ0606,Kiegeani,TZ0606061,4094 ,2022 ,2072 ,4094 ,2022 ,0 ,0 ,0 ,2072 
United Republic of Tanzania,Jamhuri ya Muungano wa Tanzania,TZ,Pwani,TZ06,Mafia,TZ0606,Jibondo,TZ0606071,3729 ,1873 ,1856 ,3729 ,1873 ,0 ,0 ,0 ,1856 
United Republic of Tanzania,Jamhuri ya Muungano wa Tanzania,TZ,Pwani,TZ06,Mafia,TZ0606,Ndagoni,TZ0606081,4959 ,2522 ,2437 ,4959 ,2522 ,0 ,0 ,0 ,2437 
United Republic of Tanzania,Jamhuri ya Muungano wa Tanzania,TZ,Pwani,TZ06,Kibaha Urban,TZ0607,Pangani,TZ0607012,6828 ,3500 ,3328 ,0 ,0 ,6828 ,3500 ,3328 ,0 
United Republic of Tanzania,Jamhuri ya Muungano wa Tanzania,TZ,Pwani,TZ06,Kibaha Urban,TZ0607,Mailimoja,TZ0607022,21606 ,10419 ,11187 ,0 ,0 ,21606 ,10419 ,11187 ,0 
United Republic of Tanzania,Jamhuri ya Muungano wa Tanzania,TZ,Pwani,TZ06,Kibaha Urban,TZ0607,Tumbi,TZ0607032,11650 ,5503 ,6147 ,0 ,0 ,11650 ,5503 ,6147 ,0 
United Republic of Tanzania,Jamhuri ya Muungano wa Tanzania,TZ,Pwani,TZ06,Kibaha Urban,TZ0607,Picha ya Ndege,TZ0607042,17994 ,8680 ,9314 ,0 ,0 ,17994 ,8680 ,9314 ,0 
United Republic of Tanzania,Jamhuri ya Muungano wa Tanzania,TZ,Pwani,TZ06,Kibaha Urban,TZ0607,Mkuza,TZ0607052,15132 ,7368 ,7764 ,0 ,0 ,15132 ,7368 ,7764 ,0 
United Republic of Tanzania,Jamhuri ya Muungano wa Tanzania,TZ,Pwani,TZ06,Kibaha Urban,TZ0607,Kibaha,TZ0607062,11828 ,5668 ,6160 ,0 ,0 ,11828 ,5668 ,6160 ,0 
United Republic of Tanzania,Jamhuri ya Muungano wa Tanzania,TZ,Pwani,TZ06,Kibaha Urban,TZ0607,Msangani,TZ0607072,5903 ,2954 ,2949 ,0 ,0 ,5903 ,2954 ,2949 ,0 
United Republic of Tanzania,Jamhuri ya Muungano wa Tanzania,TZ,Pwani,TZ06,Kibaha Urban,TZ0607,Kongowe,TZ0607082,18500 ,8944 ,9556 ,0 ,0 ,18500 ,8944 ,9556 ,0 
United Republic of Tanzania,Jamhuri ya Muungano wa Tanzania,TZ,Pwani,TZ06,Kibaha Urban,TZ0607,Misugusugu,TZ0607092,6137 ,3137 ,3000 ,0 ,0 ,6137 ,3137 ,3000 ,0 
United Republic of Tanzania,Jamhuri ya Muungano wa Tanzania,TZ,Pwani,TZ06,Kibaha Urban,TZ0607,Visiga,TZ0607102,8902 ,4491 ,4411 ,0 ,0 ,8902 ,4491 ,4411 ,0 
United Republic of Tanzania,Jamhuri ya Muungano wa Tanzania,TZ,Pwani,TZ06,Kibaha Urban,TZ0607,Mbwawa,TZ0607112,4008 ,1989 ,2019 ,0 ,0 ,4008 ,1989 ,2019 ,0 
United Republic of Tanzania,Jamhuri ya Muungano wa Tanzania,TZ,Dar-es-salaam,TZ07,Kinondoni,TZ0701,Magomeni,TZ0701012,24400 ,11906 ,12494 ,0 ,0 ,24400 ,11906 ,12494 ,0 
United Republic of Tanzania,Jamhuri ya Muungano wa Tanzania,TZ,Dar-es-salaam,TZ07,Kinondoni,TZ0701,Makurumla,TZ0701022,63352 ,30933 ,32419 ,0 ,0 ,63352 ,30933 ,32419 ,0 
United Republic of Tanzania,Jamhuri ya Muungano wa Tanzania,TZ,Dar-es-salaam,TZ07,Kinondoni,TZ0701,Ndugumbi,TZ0701032,36841 ,17894 ,18947 ,0 ,0 ,36841 ,17894 ,18947 ,0 
United Republic of Tanzania,Jamhuri ya Muungano wa Tanzania,TZ,Dar-es-salaam,TZ07,Kinondoni,TZ0701,Tandale,TZ0701042,54781 ,27205 ,27576 ,0 ,0 ,54781 ,27205 ,27576 ,0 
United Republic of Tanzania,Jamhuri ya Muungano wa Tanzania,TZ,Dar-es-salaam,TZ07,Kinondoni,TZ0701,Mwananyamala,TZ0701052,50560 ,24322 ,26238 ,0 ,0 ,50560 ,24322 ,26238 ,0 
United Republic of Tanzania,Jamhuri ya Muungano wa Tanzania,TZ,Dar-es-salaam,TZ07,Kinondoni,TZ0701,Msasani,TZ0701062,48920 ,24123 ,24797 ,0 ,0 ,48920 ,24123 ,24797 ,0 
United Republic of Tanzania,Jamhuri ya Muungano wa Tanzania,TZ,Dar-es-salaam,TZ07,Kinondoni,TZ0701,Kinondoni,TZ0701072,21239 ,10301 ,10938 ,0 ,0 ,21239 ,10301 ,10938 ,0 
United Republic of Tanzania,Jamhuri ya Muungano wa Tanzania,TZ,Dar-es-salaam,TZ07,Kinondoni,TZ0701,Mzimuni,TZ0701082,21486 ,10326 ,11160 ,0 ,0 ,21486 ,10326 ,11160 ,0 
United Republic of Tanzania,Jamhuri ya Muungano wa Tanzania,TZ,Dar-es-salaam,TZ07,Kinondoni,TZ0701,Kigogo,TZ0701092,57613 ,28229 ,29384 ,0 ,0 ,57613 ,28229 ,29384 ,0 
United Republic of Tanzania,Jamhuri ya Muungano wa Tanzania,TZ,Dar-es-salaam,TZ07,Kinondoni,TZ0701,Mabibo,TZ0701102,85735 ,41824 ,43911 ,0 ,0 ,85735 ,41824 ,43911 ,0 
United Republic of Tanzania,Jamhuri ya Muungano wa Tanzania,TZ,Dar-es-salaam,TZ07,Kinondoni,TZ0701,Manzese,TZ0701112,70507 ,34495 ,36012 ,0 ,0 ,70507 ,34495 ,36012 ,0 
United Republic of Tanzania,Jamhuri ya Muungano wa Tanzania,TZ,Dar-es-salaam,TZ07,Kinondoni,TZ0701,Ubungo,TZ0701122,56015 ,27221 ,28794 ,0 ,0 ,56015 ,27221 ,28794 ,0 
United Republic of Tanzania,Jamhuri ya Muungano wa Tanzania,TZ,Dar-es-salaam,TZ07,Kinondoni,TZ0701,Kibamba,TZ0701132,28885 ,13840 ,15045 ,0 ,0 ,28885 ,13840 ,15045 ,0 
United Republic of Tanzania,Jamhuri ya Muungano wa Tanzania,TZ,Dar-es-salaam,TZ07,Kinondoni,TZ0701,Goba,TZ0701142,42669 ,21066 ,21603 ,0 ,0 ,42669 ,21066 ,21603 ,0 
United Republic of Tanzania,Jamhuri ya Muungano wa Tanzania,TZ,Dar-es-salaam,TZ07,Kinondoni,TZ0701,Kawe,TZ0701152,67115 ,32426 ,34689 ,0 ,0 ,67115 ,32426 ,34689 ,0 
United Republic of Tanzania,Jamhuri ya Muungano wa Tanzania,TZ,Dar-es-salaam,TZ07,Kinondoni,TZ0701,Kunduchi,TZ0701162,75016 ,36610 ,38406 ,0 ,0 ,75016 ,36610 ,38406 ,0 
United Republic of Tanzania,Jamhuri ya Muungano wa Tanzania,TZ,Dar-es-salaam,TZ07,Kinondoni,TZ0701,Mbweni,TZ0701172,13766 ,6672 ,7094 ,0 ,0 ,13766 ,6672 ,7094 ,0 
United Republic of Tanzania,Jamhuri ya Muungano wa Tanzania,TZ,Dar-es-salaam,TZ07,Kinondoni,TZ0701,Bunju,TZ0701182,60236 ,29157 ,31079 ,0 ,0 ,60236 ,29157 ,31079 ,0 
United Republic of Tanzania,Jamhuri ya Muungano wa Tanzania,TZ,Dar-es-salaam,TZ07,Kinondoni,TZ0701,Makuburi,TZ0701192,57408 ,28021 ,29387 ,0 ,0 ,57408 ,28021 ,29387 ,0 
United Republic of Tanzania,Jamhuri ya Muungano wa Tanzania,TZ,Dar-es-salaam,TZ07,Kinondoni,TZ0701,Mburahati,TZ0701202,34123 ,16784 ,17339 ,0 ,0 ,34123 ,16784 ,17339 ,0 
United Republic of Tanzania,Jamhuri ya Muungano wa Tanzania,TZ,Dar-es-salaam,TZ07,Kinondoni,TZ0701,Makumbusho,TZ0701212,68093 ,33251 ,34842 ,0 ,0 ,68093 ,33251 ,34842 ,0 
United Republic of Tanzania,Jamhuri ya Muungano wa Tanzania,TZ,Dar-es-salaam,TZ07,Kinondoni,TZ0701,Sinza,TZ0701222,40546 ,18892 ,21654 ,0 ,0 ,40546 ,18892 ,21654 ,0 
United Republic of Tanzania,Jamhuri ya Muungano wa Tanzania,TZ,Dar-es-salaam,TZ07,Kinondoni,TZ0701,Kijitonyama,TZ0701232,58132 ,27509 ,30623 ,0 ,0 ,58132 ,27509 ,30623 ,0 
United Republic of Tanzania,Jamhuri ya Muungano wa Tanzania,TZ,Dar-es-salaam,TZ07,Kinondoni,TZ0701,Kimara,TZ0701242,76577 ,36654 ,39923 ,0 ,0 ,76577 ,36654 ,39923 ,0 
United Republic of Tanzania,Jamhuri ya Muungano wa Tanzania,TZ,Dar-es-salaam,TZ07,Kinondoni,TZ0701,Mikocheni,TZ0701252,32947 ,16108 ,16839 ,0 ,0 ,32947 ,16108 ,16839 ,0 
United Republic of Tanzania,Jamhuri ya Muungano wa Tanzania,TZ,Dar-es-salaam,TZ07,Kinondoni,TZ0701,Mbezi,TZ0701262,73414 ,35637 ,37777 ,0 ,0 ,73414 ,35637 ,37777 ,0 
United Republic of Tanzania,Jamhuri ya Muungano wa Tanzania,TZ,Dar-es-salaam,TZ07,Kinondoni,TZ0701,Hananasifu,TZ0701272,37115 ,17978 ,19137 ,0 ,0 ,37115 ,17978 ,19137 ,0 
United Republic of Tanzania,Jamhuri ya Muungano wa Tanzania,TZ,Dar-es-salaam,TZ07,Kinondoni,TZ0701,Saranga,TZ0701282,104127 ,49263 ,54864 ,0 ,0 ,104127 ,49263 ,54864 ,0 
United Republic of Tanzania,Jamhuri ya Muungano wa Tanzania,TZ,Dar-es-salaam,TZ07,Kinondoni,TZ0701,Kwembe,TZ0701292,56899 ,28040 ,28859 ,0 ,0 ,56899 ,28040 ,28859 ,0 
United Republic of Tanzania,Jamhuri ya Muungano wa Tanzania,TZ,Dar-es-salaam,TZ07,Kinondoni,TZ0701,Msigani,TZ0701302,55111 ,26479 ,28632 ,0 ,0 ,55111 ,26479 ,28632 ,0 
United Republic of Tanzania,Jamhuri ya Muungano wa Tanzania,TZ,Dar-es-salaam,TZ07,Kinondoni,TZ0701,Mbezi Juu,TZ0701312,41340 ,19844 ,21496 ,0 ,0 ,41340 ,19844 ,21496 ,0 
United Republic of Tanzania,Jamhuri ya Muungano wa Tanzania,TZ,Dar-es-salaam,TZ07,Kinondoni,TZ0701,Makongo,TZ0701322,43796 ,21289 ,22507 ,0 ,0 ,43796 ,21289 ,22507 ,0 
United Republic of Tanzania,Jamhuri ya Muungano wa Tanzania,TZ,Dar-es-salaam,TZ07,Kinondoni,TZ0701,Mabwepande,TZ0701332,25460 ,12500 ,12960 ,0 ,0 ,25460 ,12500 ,12960 ,0 
United Republic of Tanzania,Jamhuri ya Muungano wa Tanzania,TZ,Dar-es-salaam,TZ07,Kinondoni,TZ0701,Wazo,TZ0701342,90825 ,44003 ,46822 ,0 ,0 ,90825 ,44003 ,46822 ,0 
United Republic of Tanzania,Jamhuri ya Muungano wa Tanzania,TZ,Dar-es-salaam,TZ07,Ilala,TZ0702,Ukonga,TZ0702012,80034 ,39413 ,40621 ,0 ,0 ,80034 ,39413 ,40621 ,0 
United Republic of Tanzania,Jamhuri ya Muungano wa Tanzania,TZ,Dar-es-salaam,TZ07,Ilala,TZ0702,Pugu,TZ0702022,49422 ,24159 ,25263 ,0 ,0 ,49422 ,24159 ,25263 ,0 
United Republic of Tanzania,Jamhuri ya Muungano wa Tanzania,TZ,Dar-es-salaam,TZ07,Ilala,TZ0702,Msongola,TZ0702032,24461 ,12147 ,12314 ,0 ,0 ,24461 ,12147 ,12314 ,0 
United Republic of Tanzania,Jamhuri ya Muungano wa Tanzania,TZ,Dar-es-salaam,TZ07,Ilala,TZ0702,Tabata,TZ0702042,74742 ,35909 ,38833 ,0 ,0 ,74742 ,35909 ,38833 ,0 
United Republic of Tanzania,Jamhuri ya Muungano wa Tanzania,TZ,Dar-es-salaam,TZ07,Ilala,TZ0702,Kinyerezi,TZ0702052,38366 ,18593 ,19773 ,0 ,0 ,38366 ,18593 ,19773 ,0 
United Republic of Tanzania,Jamhuri ya Muungano wa Tanzania,TZ,Dar-es-salaam,TZ07,Ilala,TZ0702,Ilala,TZ0702062,31083 ,15242 ,15841 ,0 ,0 ,31083 ,15242 ,15841 ,0 
United Republic of Tanzania,Jamhuri ya Muungano wa Tanzania,TZ,Dar-es-salaam,TZ07,Ilala,TZ0702,Mchikichini,TZ0702072,25510 ,12977 ,12533 ,0 ,0 ,25510 ,12977 ,12533 ,0 
United Republic of Tanzania,Jamhuri ya Muungano wa Tanzania,TZ,Dar-es-salaam,TZ07,Ilala,TZ0702,Vingunguti,TZ0702082,106946 ,53248 ,53698 ,0 ,0 ,106946 ,53248 ,53698 ,0 
United Republic of Tanzania,Jamhuri ya Muungano wa Tanzania,TZ,Dar-es-salaam,TZ07,Ilala,TZ0702,Kipawa,TZ0702092,74180 ,35866 ,38314 ,0 ,0 ,74180 ,35866 ,38314 ,0 
United Republic of Tanzania,Jamhuri ya Muungano wa Tanzania,TZ,Dar-es-salaam,TZ07,Ilala,TZ0702,Buguruni,TZ0702102,70585 ,34547 ,36038 ,0 ,0 ,70585 ,34547 ,36038 ,0 
United Republic of Tanzania,Jamhuri ya Muungano wa Tanzania,TZ,Dar-es-salaam,TZ07,Ilala,TZ0702,Kariakoo,TZ0702112,13780 ,7306 ,6474 ,0 ,0 ,13780 ,7306 ,6474 ,0 
United Republic of Tanzania,Jamhuri ya Muungano wa Tanzania,TZ,Dar-es-salaam,TZ07,Ilala,TZ0702,Jangwani,TZ0702122,17647 ,9174 ,8473 ,0 ,0 ,17647 ,9174 ,8473 ,0 
United Republic of Tanzania,Jamhuri ya Muungano wa Tanzania,TZ,Dar-es-salaam,TZ07,Ilala,TZ0702,Gerezani,TZ0702132,7276 ,3767 ,3509 ,0 ,0 ,7276 ,3767 ,3509 ,0 
United Republic of Tanzania,Jamhuri ya Muungano wa Tanzania,TZ,Dar-es-salaam,TZ07,Ilala,TZ0702,Kisutu,TZ0702142,8308 ,4069 ,4239 ,0 ,0 ,8308 ,4069 ,4239 ,0 
United Republic of Tanzania,Jamhuri ya Muungano wa Tanzania,TZ,Dar-es-salaam,TZ07,Ilala,TZ0702,Mchafukoge,TZ0702152,10688 ,5422 ,5266 ,0 ,0 ,10688 ,5422 ,5266 ,0 
United Republic of Tanzania,Jamhuri ya Muungano wa Tanzania,TZ,Dar-es-salaam,TZ07,Ilala,TZ0702,Upanga Mashariki,TZ0702162,11167 ,5461 ,5706 ,0 ,0 ,11167 ,5461 ,5706 ,0 
United Republic of Tanzania,Jamhuri ya Muungano wa Tanzania,TZ,Dar-es-salaam,TZ07,Ilala,TZ0702,Upanga Magharibi,TZ0702172,13476 ,6786 ,6690 ,0 ,0 ,13476 ,6786 ,6690 ,0 
United Republic of Tanzania,Jamhuri ya Muungano wa Tanzania,TZ,Dar-es-salaam,TZ07,Ilala,TZ0702,Kivukoni,TZ0702182,6742 ,3531 ,3211 ,0 ,0 ,6742 ,3531 ,3211 ,0 
United Republic of Tanzania,Jamhuri ya Muungano wa Tanzania,TZ,Dar-es-salaam,TZ07,Ilala,TZ0702,Kiwalani,TZ0702192,82292 ,40247 ,42045 ,0 ,0 ,82292 ,40247 ,42045 ,0 
United Republic of Tanzania,Jamhuri ya Muungano wa Tanzania,TZ,Dar-es-salaam,TZ07,Ilala,TZ0702,Segerea,TZ0702202,83315 ,40065 ,43250 ,0 ,0 ,83315 ,40065 ,43250 ,0 
United Republic of Tanzania,Jamhuri ya Muungano wa Tanzania,TZ,Dar-es-salaam,TZ07,Ilala,TZ0702,Kitunda,TZ0702212,57132 ,27340 ,29792 ,0 ,0 ,57132 ,27340 ,29792 ,0 
United Republic of Tanzania,Jamhuri ya Muungano wa Tanzania,TZ,Dar-es-salaam,TZ07,Ilala,TZ0702,Chanika,TZ0702222,43912 ,21164 ,22748 ,0 ,0 ,43912 ,21164 ,22748 ,0 
United Republic of Tanzania,Jamhuri ya Muungano wa Tanzania,TZ,Dar-es-salaam,TZ07,Ilala,TZ0702,Kivule,TZ0702232,72032 ,34707 ,37325 ,0 ,0 ,72032 ,34707 ,37325 ,0 
United Republic of Tanzania,Jamhuri ya Muungano wa Tanzania,TZ,Dar-es-salaam,TZ07,Ilala,TZ0702,Gongolamboto,TZ0702242,57312 ,27927 ,29385 ,0 ,0 ,57312 ,27927 ,29385 ,0 
United Republic of Tanzania,Jamhuri ya Muungano wa Tanzania,TZ,Dar-es-salaam,TZ07,Ilala,TZ0702,Majohe,TZ0702252,81646 ,39550 ,42096 ,0 ,0 ,81646 ,39550 ,42096 ,0 
United Republic of Tanzania,Jamhuri ya Muungano wa Tanzania,TZ,Dar-es-salaam,TZ07,Ilala,TZ0702,Kimanga,TZ0702262,78557 ,37311 ,41246 ,0 ,0 ,78557 ,37311 ,41246 ,0 
United Republic of Tanzania,Jamhuri ya Muungano wa Tanzania,TZ,Dar-es-salaam,TZ07,Temeke,TZ0703,Kigamboni,TZ0703012,30496 ,15262 ,15234 ,0 ,0 ,30496 ,15262 ,15234 ,0 
United Republic of Tanzania,Jamhuri ya Muungano wa Tanzania,TZ,Dar-es-salaam,TZ07,Temeke,TZ0703,Vijibweni,TZ0703022,29010 ,14221 ,14789 ,0 ,0 ,29010 ,14221 ,14789 ,0 
United Republic of Tanzania,Jamhuri ya Muungano wa Tanzania,TZ,Dar-es-salaam,TZ07,Temeke,TZ0703,Kibada,TZ0703032,8585 ,4241 ,4344 ,0 ,0 ,8585 ,4241 ,4344 ,0 
United Republic of Tanzania,Jamhuri ya Muungano wa Tanzania,TZ,Dar-es-salaam,TZ07,Temeke,TZ0703,Kisarawe II,TZ0703042,8306 ,4233 ,4073 ,0 ,0 ,8306 ,4233 ,4073 ,0 
United Republic of Tanzania,Jamhuri ya Muungano wa Tanzania,TZ,Dar-es-salaam,TZ07,Temeke,TZ0703,Somangila,TZ0703052,19283 ,9734 ,9549 ,0 ,0 ,19283 ,9734 ,9549 ,0 
United Republic of Tanzania,Jamhuri ya Muungano wa Tanzania,TZ,Dar-es-salaam,TZ07,Temeke,TZ0703,Kimbiji,TZ0703062,6411 ,3425 ,2986 ,0 ,0 ,6411 ,3425 ,2986 ,0 
United Republic of Tanzania,Jamhuri ya Muungano wa Tanzania,TZ,Dar-es-salaam,TZ07,Temeke,TZ0703,Mbagala,TZ0703072,52582 ,25836 ,26746 ,0 ,0 ,52582 ,25836 ,26746 ,0 
United Republic of Tanzania,Jamhuri ya Muungano wa Tanzania,TZ,Dar-es-salaam,TZ07,Temeke,TZ0703,Chamazi,TZ0703082,63650 ,30258 ,33392 ,0 ,0 ,63650 ,30258 ,33392 ,0 
United Republic of Tanzania,Jamhuri ya Muungano wa Tanzania,TZ,Dar-es-salaam,TZ07,Temeke,TZ0703,Yombo Vituka,TZ0703092,76999 ,37638 ,39361 ,0 ,0 ,76999 ,37638 ,39361 ,0 
United Republic of Tanzania,Jamhuri ya Muungano wa Tanzania,TZ,Dar-es-salaam,TZ07,Temeke,TZ0703,Charambe,TZ0703102,101933 ,48961 ,52972 ,0 ,0 ,101933 ,48961 ,52972 ,0 
United Republic of Tanzania,Jamhuri ya Muungano wa Tanzania,TZ,Dar-es-salaam,TZ07,Temeke,TZ0703,Toangoma,TZ0703112,44578 ,21292 ,23286 ,0 ,0 ,44578 ,21292 ,23286 ,0 
United Republic of Tanzania,Jamhuri ya Muungano wa Tanzania,TZ,Dar-es-salaam,TZ07,Temeke,TZ0703,Miburani,TZ0703122,44290 ,21667 ,22623 ,0 ,0 ,44290 ,21667 ,22623 ,0 
United Republic of Tanzania,Jamhuri ya Muungano wa Tanzania,TZ,Dar-es-salaam,TZ07,Temeke,TZ0703,Temeke,TZ0703132,26047 ,12692 ,13355 ,0 ,0 ,26047 ,12692 ,13355 ,0 
United Republic of Tanzania,Jamhuri ya Muungano wa Tanzania,TZ,Dar-es-salaam,TZ07,Temeke,TZ0703,Mtoni,TZ0703142,59378 ,29184 ,30194 ,0 ,0 ,59378 ,29184 ,30194 ,0 
United Republic of Tanzania,Jamhuri ya Muungano wa Tanzania,TZ,Dar-es-salaam,TZ07,Temeke,TZ0703,Keko,TZ0703152,35163 ,17937 ,17226 ,0 ,0 ,35163 ,17937 ,17226 ,0 
United Republic of Tanzania,Jamhuri ya Muungano wa Tanzania,TZ,Dar-es-salaam,TZ07,Temeke,TZ0703,Kurasini,TZ0703162,26193 ,12831 ,13362 ,0 ,0 ,26193 ,12831 ,13362 ,0 
United Republic of Tanzania,Jamhuri ya Muungano wa Tanzania,TZ,Dar-es-salaam,TZ07,Temeke,TZ0703,Azimio,TZ0703172,76832 ,37462 ,39370 ,0 ,0 ,76832 ,37462 ,39370 ,0 
United Republic of Tanzania,Jamhuri ya Muungano wa Tanzania,TZ,Dar-es-salaam,TZ07,Temeke,TZ0703,Tandika,TZ0703182,49491 ,23832 ,25659 ,0 ,0 ,49491 ,23832 ,25659 ,0 
United Republic of Tanzania,Jamhuri ya Muungano wa Tanzania,TZ,Dar-es-salaam,TZ07,Temeke,TZ0703,Sandali,TZ0703192,52660 ,26050 ,26610 ,0 ,0 ,52660 ,26050 ,26610 ,0 
United Republic of Tanzania,Jamhuri ya Muungano wa Tanzania,TZ,Dar-es-salaam,TZ07,Temeke,TZ0703,Chang'ombe,TZ0703202,19302 ,9401 ,9901 ,0 ,0 ,19302 ,9401 ,9901 ,0 
United Republic of Tanzania,Jamhuri ya Muungano wa Tanzania,TZ,Dar-es-salaam,TZ07,Temeke,TZ0703,Mbagala Kuu,TZ0703212,74774 ,36146 ,38628 ,0 ,0 ,74774 ,36146 ,38628 ,0 
United Republic of Tanzania,Jamhuri ya Muungano wa Tanzania,TZ,Dar-es-salaam,TZ07,Temeke,TZ0703,Makangarawe,TZ0703222,53291 ,26007 ,27284 ,0 ,0 ,53291 ,26007 ,27284 ,0 
United Republic of Tanzania,Jamhuri ya Muungano wa Tanzania,TZ,Dar-es-salaam,TZ07,Temeke,TZ0703,Pemba Mnazi,TZ0703232,9672 ,4904 ,4768 ,0 ,0 ,9672 ,4904 ,4768 ,0 
United Republic of Tanzania,Jamhuri ya Muungano wa Tanzania,TZ,Dar-es-salaam,TZ07,Temeke,TZ0703,Mjimwema,TZ0703242,27789 ,13740 ,14049 ,0 ,0 ,27789 ,13740 ,14049 ,0 
United Republic of Tanzania,Jamhuri ya Muungano wa Tanzania,TZ,Dar-es-salaam,TZ07,Temeke,TZ0703,Tungi,TZ0703252,23380 ,11439 ,11941 ,0 ,0 ,23380 ,11439 ,11941 ,0 
United Republic of Tanzania,Jamhuri ya Muungano wa Tanzania,TZ,Dar-es-salaam,TZ07,Temeke,TZ0703,Kijichi,TZ0703262,69195 ,33764 ,35431 ,0 ,0 ,69195 ,33764 ,35431 ,0 
United Republic of Tanzania,Jamhuri ya Muungano wa Tanzania,TZ,Dar-es-salaam,TZ07,Temeke,TZ0703,Mianzini,TZ0703272,100649 ,48737 ,51912 ,0 ,0 ,100649 ,48737 ,51912 ,0 
United Republic of Tanzania,Jamhuri ya Muungano wa Tanzania,TZ,Dar-es-salaam,TZ07,Temeke,TZ0703,Kiburugwa,TZ0703282,78911 ,38833 ,40078 ,0 ,0 ,78911 ,38833 ,40078 ,0 
United Republic of Tanzania,Jamhuri ya Muungano wa Tanzania,TZ,Dar-es-salaam,TZ07,Temeke,TZ0703,Buza,TZ0703292,55082 ,26761 ,28321 ,0 ,0 ,55082 ,26761 ,28321 ,0 
United Republic of Tanzania,Jamhuri ya Muungano wa Tanzania,TZ,Dar-es-salaam,TZ07,Temeke,TZ0703,Kilakala,TZ0703302,44949 ,22568 ,22381 ,0 ,0 ,44949 ,22568 ,22381 ,0 
United Republic of Tanzania,Jamhuri ya Muungano wa Tanzania,TZ,Lindi,TZ08,Kilwa,TZ0801,Tingi,TZ0801011,6782 ,3235 ,3547 ,6782 ,3235 ,0 ,0 ,0 ,3547 
United Republic of Tanzania,Jamhuri ya Muungano wa Tanzania,TZ,Lindi,TZ08,Kilwa,TZ0801,Miteja,TZ0801021,6157 ,3042 ,3115 ,6157 ,3042 ,0 ,0 ,0 ,3115 
United Republic of Tanzania,Jamhuri ya Muungano wa Tanzania,TZ,Lindi,TZ08,Kilwa,TZ0801,Mingumbi,TZ0801031,9948 ,4754 ,5194 ,9948 ,4754 ,0 ,0 ,0 ,5194 
United Republic of Tanzania,Jamhuri ya Muungano wa Tanzania,TZ,Lindi,TZ08,Kilwa,TZ0801,Kinjumbi,TZ0801041,14426 ,6886 ,7540 ,14426 ,6886 ,0 ,0 ,0 ,7540 
United Republic of Tanzania,Jamhuri ya Muungano wa Tanzania,TZ,Lindi,TZ08,Kilwa,TZ0801,Chumo,TZ0801051,13897 ,6550 ,7347 ,13897 ,6550 ,0 ,0 ,0 ,7347 
United Republic of Tanzania,Jamhuri ya Muungano wa Tanzania,TZ,Lindi,TZ08,Kilwa,TZ0801,Kipatimu,TZ0801061,14606 ,7053 ,7553 ,14606 ,7053 ,0 ,0 ,0 ,7553 
United Republic of Tanzania,Jamhuri ya Muungano wa Tanzania,TZ,Lindi,TZ08,Kilwa,TZ0801,Kandawale,TZ0801071,5040 ,2452 ,2588 ,5040 ,2452 ,0 ,0 ,0 ,2588 
United Republic of Tanzania,Jamhuri ya Muungano wa Tanzania,TZ,Lindi,TZ08,Kilwa,TZ0801,Njinjo,TZ0801081,8094 ,3813 ,4281 ,8094 ,3813 ,0 ,0 ,0 ,4281 
United Republic of Tanzania,Jamhuri ya Muungano wa Tanzania,TZ,Lindi,TZ08,Kilwa,TZ0801,Mitole,TZ0801091,3352 ,1651 ,1701 ,3352 ,1651 ,0 ,0 ,0 ,1701 
United Republic of Tanzania,Jamhuri ya Muungano wa Tanzania,TZ,Lindi,TZ08,Kilwa,TZ0801,Miguruwe,TZ0801101,3381 ,1667 ,1714 ,3381 ,1667 ,0 ,0 ,0 ,1714 
United Republic of Tanzania,Jamhuri ya Muungano wa Tanzania,TZ,Lindi,TZ08,Kilwa,TZ0801,Likawage,TZ0801111,3569 ,1745 ,1824 ,3569 ,1745 ,0 ,0 ,0 ,1824 
United Republic of Tanzania,Jamhuri ya Muungano wa Tanzania,TZ,Lindi,TZ08,Kilwa,TZ0801,Nanjirinji,TZ0801121,7491 ,3691 ,3800 ,7491 ,3691 ,0 ,0 ,0 ,3800 
United Republic of Tanzania,Jamhuri ya Muungano wa Tanzania,TZ,Lindi,TZ08,Kilwa,TZ0801,Kirnjernje,TZ0801131,9752 ,4698 ,5054 ,9752 ,4698 ,0 ,0 ,0 ,5054 
United Republic of Tanzania,Jamhuri ya Muungano wa Tanzania,TZ,Lindi,TZ08,Kilwa,TZ0801,Mandawa,TZ0801141,6662 ,3140 ,3522 ,6662 ,3140 ,0 ,0 ,0 ,3522 
United Republic of Tanzania,Jamhuri ya Muungano wa Tanzania,TZ,Lindi,TZ08,Kilwa,TZ0801,Lihimalyao,TZ0801151,10434 ,5056 ,5378 ,10434 ,5056 ,0 ,0 ,0 ,5378 
United Republic of Tanzania,Jamhuri ya Muungano wa Tanzania,TZ,Lindi,TZ08,Kilwa,TZ0801,Pande,TZ0801161,11596 ,5642 ,5954 ,11596 ,5642 ,0 ,0 ,0 ,5954 
United Republic of Tanzania,Jamhuri ya Muungano wa Tanzania,TZ,Lindi,TZ08,Kilwa,TZ0801,Kikole,TZ0801171,4294 ,2082 ,2212 ,4294 ,2082 ,0 ,0 ,0 ,2212 
United Republic of Tanzania,Jamhuri ya Muungano wa Tanzania,TZ,Lindi,TZ08,Kilwa,TZ0801,Kivinjesingino,TZ0801183,19376 ,9035 ,10341 ,13952 ,6581 ,5424 ,2454 ,2970 ,7371 
United Republic of Tanzania,Jamhuri ya Muungano wa Tanzania,TZ,Lindi,TZ08,Kilwa,TZ0801,Songosongo,TZ0801191,3026 ,1634 ,1392 ,3026 ,1634 ,0 ,0 ,0 ,1392 
United Republic of Tanzania,Jamhuri ya Muungano wa Tanzania,TZ,Lindi,TZ08,Kilwa,TZ0801,Masoko,TZ0801202,13601 ,6462 ,7139 ,0 ,0 ,13601 ,6462 ,7139 ,0 
United Republic of Tanzania,Jamhuri ya Muungano wa Tanzania,TZ,Lindi,TZ08,Kilwa,TZ0801,Kibata,TZ0801211,8730 ,4109 ,4621 ,8730 ,4109 ,0 ,0 ,0 ,4621 
United Republic of Tanzania,Jamhuri ya Muungano wa Tanzania,TZ,Lindi,TZ08,Lindi,TZ0802,Mipingo,TZ0802011,5926 ,2941 ,2985 ,5926 ,2941 ,0 ,0 ,0 ,2985 
United Republic of Tanzania,Jamhuri ya Muungano wa Tanzania,TZ,Lindi,TZ08,Lindi,TZ0802,Kitomanga,TZ0802021,4720 ,2306 ,2414 ,4720 ,2306 ,0 ,0 ,0 ,2414 
United Republic of Tanzania,Jamhuri ya Muungano wa Tanzania,TZ,Lindi,TZ08,Lindi,TZ0802,Mchinga,TZ0802031,6063 ,2814 ,3249 ,6063 ,2814 ,0 ,0 ,0 ,3249 
United Republic of Tanzania,Jamhuri ya Muungano wa Tanzania,TZ,Lindi,TZ08,Lindi,TZ0802,Kilolambwani,TZ0802041,6286 ,3041 ,3245 ,6286 ,3041 ,0 ,0 ,0 ,3245 
United Republic of Tanzania,Jamhuri ya Muungano wa Tanzania,TZ,Lindi,TZ08,Lindi,TZ0802,Kilangala,TZ0802051,6498 ,3103 ,3395 ,6498 ,3103 ,0 ,0 ,0 ,3395 
United Republic of Tanzania,Jamhuri ya Muungano wa Tanzania,TZ,Lindi,TZ08,Lindi,TZ0802,Kiwalala,TZ0802063,13304 ,6334 ,6970 ,7718 ,3698 ,5586 ,2636 ,2950 ,4020 
United Republic of Tanzania,Jamhuri ya Muungano wa Tanzania,TZ,Lindi,TZ08,Lindi,TZ0802,Navanga,TZ0802071,3839 ,1808 ,2031 ,3839 ,1808 ,0 ,0 ,0 ,2031 
United Republic of Tanzania,Jamhuri ya Muungano wa Tanzania,TZ,Lindi,TZ08,Lindi,TZ0802,Mnolela,TZ0802081,11846 ,5508 ,6338 ,11846 ,5508 ,0 ,0 ,0 ,6338 
United Republic of Tanzania,Jamhuri ya Muungano wa Tanzania,TZ,Lindi,TZ08,Lindi,TZ0802,Sudi,TZ0802091,5544 ,2572 ,2972 ,5544 ,2572 ,0 ,0 ,0 ,2972 
United Republic of Tanzania,Jamhuri ya Muungano wa Tanzania,TZ,Lindi,TZ08,Lindi,TZ0802,Nachunyu,TZ0802101,6713 ,3180 ,3533 ,6713 ,3180 ,0 ,0 ,0 ,3533 
United Republic of Tanzania,Jamhuri ya Muungano wa Tanzania,TZ,Lindi,TZ08,Lindi,TZ0802,Mtama,TZ0802113,4398 ,2029 ,2369 ,3358 ,1560 ,1040 ,469 ,571 ,1798 
United Republic of Tanzania,Jamhuri ya Muungano wa Tanzania,TZ,Lindi,TZ08,Lindi,TZ0802,Nyangao,TZ0802123,9835 ,4575 ,5260 ,7733 ,3606 ,2102 ,969 ,1133 ,4127 
United Republic of Tanzania,Jamhuri ya Muungano wa Tanzania,TZ,Lindi,TZ08,Lindi,TZ0802,Namupa,TZ0802131,5769 ,2730 ,3039 ,5769 ,2730 ,0 ,0 ,0 ,3039 
United Republic of Tanzania,Jamhuri ya Muungano wa Tanzania,TZ,Lindi,TZ08,Lindi,TZ0802,Nyengedi,TZ0802141,5390 ,2527 ,2863 ,5390 ,2527 ,0 ,0 ,0 ,2863 
United Republic of Tanzania,Jamhuri ya Muungano wa Tanzania,TZ,Lindi,TZ08,Lindi,TZ0802,Mtua,TZ0802151,3561 ,1627 ,1934 ,3561 ,1627 ,0 ,0 ,0 ,1934 
United Republic of Tanzania,Jamhuri ya Muungano wa Tanzania,TZ,Lindi,TZ08,Lindi,TZ0802,Nahukahuka,TZ0802161,5026 ,2434 ,2592 ,5026 ,2434 ,0 ,0 ,0 ,2592 
United Republic of Tanzania,Jamhuri ya Muungano wa Tanzania,TZ,Lindi,TZ08,Lindi,TZ0802,Nyangamara,TZ0802171,7545 ,3511 ,4034 ,7545 ,3511 ,0 ,0 ,0 ,4034 
United Republic of Tanzania,Jamhuri ya Muungano wa Tanzania,TZ,Lindi,TZ08,Lindi,TZ0802,Mandwanga,TZ0802181,9227 ,4306 ,4921 ,9227 ,4306 ,0 ,0 ,0 ,4921 
United Republic of Tanzania,Jamhuri ya Muungano wa Tanzania,TZ,Lindi,TZ08,Lindi,TZ0802,Mnara,TZ0802191,10128 ,4817 ,5311 ,10128 ,4817 ,0 ,0 ,0 ,5311 
United Republic of Tanzania,Jamhuri ya Muungano wa Tanzania,TZ,Lindi,TZ08,Lindi,TZ0802,Chiponda,TZ0802201,6162 ,2915 ,3247 ,6162 ,2915 ,0 ,0 ,0 ,3247 
United Republic of Tanzania,Jamhuri ya Muungano wa Tanzania,TZ,Lindi,TZ08,Lindi,TZ0802,Pangatena,TZ0802211,4900 ,2259 ,2641 ,4900 ,2259 ,0 ,0 ,0 ,2641 
United Republic of Tanzania,Jamhuri ya Muungano wa Tanzania,TZ,Lindi,TZ08,Lindi,TZ0802,Longa,TZ0802221,3185 ,1453 ,1732 ,3185 ,1453 ,0 ,0 ,0 ,1732 
United Republic of Tanzania,Jamhuri ya Muungano wa Tanzania,TZ,Lindi,TZ08,Lindi,TZ0802,Rutamba,TZ0802231,11210 ,5335 ,5875 ,11210 ,5335 ,0 ,0 ,0 ,5875 
United Republic of Tanzania,Jamhuri ya Muungano wa Tanzania,TZ,Lindi,TZ08,Lindi,TZ0802,Milola,TZ0802241,9616 ,4486 ,5130 ,9616 ,4486 ,0 ,0 ,0 ,5130 
United Republic of Tanzania,Jamhuri ya Muungano wa Tanzania,TZ,Lindi,TZ08,Lindi,TZ0802,Kiwawa,TZ0802251,2668 ,1296 ,1372 ,2668 ,1296 ,0 ,0 ,0 ,1372 
United Republic of Tanzania,Jamhuri ya Muungano wa Tanzania,TZ,Lindi,TZ08,Lindi,TZ0802,Mtumbya,TZ0802261,1859 ,924 ,935 ,1859 ,924 ,0 ,0 ,0 ,935 
United Republic of Tanzania,Jamhuri ya Muungano wa Tanzania,TZ,Lindi,TZ08,Lindi,TZ0802,Matimba,TZ0802271,4934 ,2305 ,2629 ,4934 ,2305 ,0 ,0 ,0 ,2629 
United Republic of Tanzania,Jamhuri ya Muungano wa Tanzania,TZ,Lindi,TZ08,Lindi,TZ0802,Nangaru,TZ0802281,5280 ,2533 ,2747 ,5280 ,2533 ,0 ,0 ,0 ,2747 
United Republic of Tanzania,Jamhuri ya Muungano wa Tanzania,TZ,Lindi,TZ08,Lindi,TZ0802,Majengo,TZ0802293,6891 ,3153 ,3738 ,3455 ,1609 ,3436 ,1544 ,1892 ,1846 
United Republic of Tanzania,Jamhuri ya Muungano wa Tanzania,TZ,Lindi,TZ08,Lindi,TZ0802,Namangale,TZ0802301,5820 ,2825 ,2995 ,5820 ,2825 ,0 ,0 ,0 ,2995 
United Republic of Tanzania,Jamhuri ya Muungano wa Tanzania,TZ,Lindi,TZ08,Nachingwea,TZ0803,Nambambo,TZ0803012,16592 ,8003 ,8589 ,0 ,0 ,16592 ,8003 ,8589 ,0 
United Republic of Tanzania,Jamhuri ya Muungano wa Tanzania,TZ,Lindi,TZ08,Nachingwea,TZ0803,Kilimanihewa,TZ0803023,6835 ,3427 ,3408 ,1208 ,596 ,5627 ,2831 ,2796 ,612 
United Republic of Tanzania,Jamhuri ya Muungano wa Tanzania,TZ,Lindi,TZ08,Nachingwea,TZ0803,Ruponda,TZ0803031,6338 ,2962 ,3376 ,6338 ,2962 ,0 ,0 ,0 ,3376 
United Republic of Tanzania,Jamhuri ya Muungano wa Tanzania,TZ,Lindi,TZ08,Nachingwea,TZ0803,Minero Miembeni,TZ0803041,8512 ,4022 ,4490 ,8512 ,4022 ,0 ,0 ,0 ,4490 
United Republic of Tanzania,Jamhuri ya Muungano wa Tanzania,TZ,Lindi,TZ08,Nachingwea,TZ0803,Namapwia,TZ0803051,4323 ,2073 ,2250 ,4323 ,2073 ,0 ,0 ,0 ,2250 
United Republic of Tanzania,Jamhuri ya Muungano wa Tanzania,TZ,Lindi,TZ08,Nachingwea,TZ0803,Kipara Mnero,TZ0803061,4918 ,2383 ,2535 ,4918 ,2383 ,0 ,0 ,0 ,2535 
United Republic of Tanzania,Jamhuri ya Muungano wa Tanzania,TZ,Lindi,TZ08,Nachingwea,TZ0803,Lionja,TZ0803071,8522 ,4055 ,4467 ,8522 ,4055 ,0 ,0 ,0 ,4467 
United Republic of Tanzania,Jamhuri ya Muungano wa Tanzania,TZ,Lindi,TZ08,Nachingwea,TZ0803,Namikango,TZ0803081,3772 ,1877 ,1895 ,3772 ,1877 ,0 ,0 ,0 ,1895 
United Republic of Tanzania,Jamhuri ya Muungano wa Tanzania,TZ,Lindi,TZ08,Nachingwea,TZ0803,Nditi,TZ0803091,4721 ,2201 ,2520 ,4721 ,2201 ,0 ,0 ,0 ,2520 
United Republic of Tanzania,Jamhuri ya Muungano wa Tanzania,TZ,Lindi,TZ08,Nachingwea,TZ0803,Kilima Rondo,TZ0803101,4344 ,2053 ,2291 ,4344 ,2053 ,0 ,0 ,0 ,2291 
United Republic of Tanzania,Jamhuri ya Muungano wa Tanzania,TZ,Lindi,TZ08,Nachingwea,TZ0803,Mbondo,TZ0803111,7485 ,3692 ,3793 ,7485 ,3692 ,0 ,0 ,0 ,3793 
United Republic of Tanzania,Jamhuri ya Muungano wa Tanzania,TZ,Lindi,TZ08,Nachingwea,TZ0803,Kiegei,TZ0803121,5047 ,2728 ,2319 ,5047 ,2728 ,0 ,0 ,0 ,2319 
United Republic of Tanzania,Jamhuri ya Muungano wa Tanzania,TZ,Lindi,TZ08,Nachingwea,TZ0803,Mkoka,TZ0803131,5768 ,2713 ,3055 ,5768 ,2713 ,0 ,0 ,0 ,3055 
United Republic of Tanzania,Jamhuri ya Muungano wa Tanzania,TZ,Lindi,TZ08,Nachingwea,TZ0803,Chiola,TZ0803141,5385 ,2514 ,2871 ,5385 ,2514 ,0 ,0 ,0 ,2871 
United Republic of Tanzania,Jamhuri ya Muungano wa Tanzania,TZ,Lindi,TZ08,Nachingwea,TZ0803,Mpiruka,TZ0803151,5766 ,2836 ,2930 ,5766 ,2836 ,0 ,0 ,0 ,2930 
United Republic of Tanzania,Jamhuri ya Muungano wa Tanzania,TZ,Lindi,TZ08,Nachingwea,TZ0803,Nangowe,TZ0803161,8935 ,4218 ,4717 ,8935 ,4218 ,0 ,0 ,0 ,4717 
United Republic of Tanzania,Jamhuri ya Muungano wa Tanzania,TZ,Lindi,TZ08,Nachingwea,TZ0803,Mkotokuyana,TZ0803171,2900 ,1371 ,1529 ,2900 ,1371 ,0 ,0 ,0 ,1529 
United Republic of Tanzania,Jamhuri ya Muungano wa Tanzania,TZ,Lindi,TZ08,Nachingwea,TZ0803,Naipanga,TZ0803183,10665 ,5117 ,5548 ,7664 ,3692 ,3001 ,1425 ,1576 ,3972 
United Republic of Tanzania,Jamhuri ya Muungano wa Tanzania,TZ,Lindi,TZ08,Nachingwea,TZ0803,Stesheni,TZ0803191,8071 ,4006 ,4065 ,8071 ,4006 ,0 ,0 ,0 ,4065 
United Republic of Tanzania,Jamhuri ya Muungano wa Tanzania,TZ,Lindi,TZ08,Nachingwea,TZ0803,Naipingo,TZ0803201,16226 ,8004 ,8222 ,16226 ,8004 ,0 ,0 ,0 ,8222 
United Republic of Tanzania,Jamhuri ya Muungano wa Tanzania,TZ,Lindi,TZ08,Nachingwea,TZ0803,Mtua,TZ0803211,7759 ,3838 ,3921 ,7759 ,3838 ,0 ,0 ,0 ,3921 
United Republic of Tanzania,Jamhuri ya Muungano wa Tanzania,TZ,Lindi,TZ08,Nachingwea,TZ0803,Minerongongo,TZ0803221,5101 ,2434 ,2667 ,5101 ,2434 ,0 ,0 ,0 ,2667 
United Republic of Tanzania,Jamhuri ya Muungano wa Tanzania,TZ,Lindi,TZ08,Nachingwea,TZ0803,Matekwe,TZ0803231,3096 ,1555 ,1541 ,3096 ,1555 ,0 ,0 ,0 ,1541 
United Republic of Tanzania,Jamhuri ya Muungano wa Tanzania,TZ,Lindi,TZ08,Nachingwea,TZ0803,Marambo,TZ0803241,8764 ,4198 ,4566 ,8764 ,4198 ,0 ,0 ,0 ,4566 
United Republic of Tanzania,Jamhuri ya Muungano wa Tanzania,TZ,Lindi,TZ08,Nachingwea,TZ0803,Namatula,TZ0803251,3604 ,1691 ,1913 ,3604 ,1691 ,0 ,0 ,0 ,1913 
United Republic of Tanzania,Jamhuri ya Muungano wa Tanzania,TZ,Lindi,TZ08,Nachingwea,TZ0803,Ndomoni,TZ0803261,5015 ,2411 ,2604 ,5015 ,2411 ,0 ,0 ,0 ,2604 
United Republic of Tanzania,Jamhuri ya Muungano wa Tanzania,TZ,Lindi,TZ08,Liwale,TZ0804,Liwale Mjini,TZ0804013,8651 ,4064 ,4587 ,6023 ,2807 ,2628 ,1257 ,1371 ,3216 
United Republic of Tanzania,Jamhuri ya Muungano wa Tanzania,TZ,Lindi,TZ08,Liwale,TZ0804,Mihumo,TZ0804021,5348 ,2557 ,2791 ,5348 ,2557 ,0 ,0 ,0 ,2791 
United Republic of Tanzania,Jamhuri ya Muungano wa Tanzania,TZ,Lindi,TZ08,Liwale,TZ0804,Ngongowele,TZ0804031,3644 ,1794 ,1850 ,3644 ,1794 ,0 ,0 ,0 ,1850 
United Republic of Tanzania,Jamhuri ya Muungano wa Tanzania,TZ,Lindi,TZ08,Liwale,TZ0804,Mlembwe,TZ0804041,2971 ,1450 ,1521 ,2971 ,1450 ,0 ,0 ,0 ,1521 
United Republic of Tanzania,Jamhuri ya Muungano wa Tanzania,TZ,Lindi,TZ08,Liwale,TZ0804,Makata,TZ0804051,6244 ,2954 ,3290 ,6244 ,2954 ,0 ,0 ,0 ,3290 
United Republic of Tanzania,Jamhuri ya Muungano wa Tanzania,TZ,Lindi,TZ08,Liwale,TZ0804,Barikiwa,TZ0804061,4817 ,2378 ,2439 ,4817 ,2378 ,0 ,0 ,0 ,2439 
United Republic of Tanzania,Jamhuri ya Muungano wa Tanzania,TZ,Lindi,TZ08,Liwale,TZ0804,Mkutano,TZ0804071,1614 ,754 ,860 ,1614 ,754 ,0 ,0 ,0 ,860 
United Republic of Tanzania,Jamhuri ya Muungano wa Tanzania,TZ,Lindi,TZ08,Liwale,TZ0804,Mbaya,TZ0804081,6042 ,2904 ,3138 ,6042 ,2904 ,0 ,0 ,0 ,3138 
United Republic of Tanzania,Jamhuri ya Muungano wa Tanzania,TZ,Lindi,TZ08,Liwale,TZ0804,Kimambi,TZ0804091,754 ,368 ,386 ,754 ,368 ,0 ,0 ,0 ,386 
United Republic of Tanzania,Jamhuri ya Muungano wa Tanzania,TZ,Lindi,TZ08,Liwale,TZ0804,Kiangara,TZ0804101,4309 ,2110 ,2199 ,4309 ,2110 ,0 ,0 ,0 ,2199 
United Republic of Tanzania,Jamhuri ya Muungano wa Tanzania,TZ,Lindi,TZ08,Liwale,TZ0804,Kibutuka,TZ0804111,3920 ,1982 ,1938 ,3920 ,1982 ,0 ,0 ,0 ,1938 
United Republic of Tanzania,Jamhuri ya Muungano wa Tanzania,TZ,Lindi,TZ08,Liwale,TZ0804,Nangano,TZ0804121,2849 ,1424 ,1425 ,2849 ,1424 ,0 ,0 ,0 ,1425 
United Republic of Tanzania,Jamhuri ya Muungano wa Tanzania,TZ,Lindi,TZ08,Liwale,TZ0804,Mpigamiti,TZ0804131,2096 ,999 ,1097 ,2096 ,999 ,0 ,0 ,0 ,1097 
United Republic of Tanzania,Jamhuri ya Muungano wa Tanzania,TZ,Lindi,TZ08,Liwale,TZ0804,Mirui,TZ0804141,4521 ,2260 ,2261 ,4521 ,2260 ,0 ,0 ,0 ,2261 
United Republic of Tanzania,Jamhuri ya Muungano wa Tanzania,TZ,Lindi,TZ08,Liwale,TZ0804,Liwale 'B',TZ0804151,8151 ,3963 ,4188 ,8151 ,3963 ,0 ,0 ,0 ,4188 
United Republic of Tanzania,Jamhuri ya Muungano wa Tanzania,TZ,Lindi,TZ08,Liwale,TZ0804,Mangirikiti,TZ0804161,5362 ,2548 ,2814 ,5362 ,2548 ,0 ,0 ,0 ,2814 
United Republic of Tanzania,Jamhuri ya Muungano wa Tanzania,TZ,Lindi,TZ08,Liwale,TZ0804,Nangando,TZ0804173,6591 ,3107 ,3484 ,908 ,483 ,5683 ,2624 ,3059 ,425 
United Republic of Tanzania,Jamhuri ya Muungano wa Tanzania,TZ,Lindi,TZ08,Liwale,TZ0804,Likongowele,TZ0804183,6482 ,2930 ,3552 ,1415 ,631 ,5067 ,2299 ,2768 ,784 
United Republic of Tanzania,Jamhuri ya Muungano wa Tanzania,TZ,Lindi,TZ08,Liwale,TZ0804,Kichonda,TZ0804191,3286 ,1581 ,1705 ,3286 ,1581 ,0 ,0 ,0 ,1705 
United Republic of Tanzania,Jamhuri ya Muungano wa Tanzania,TZ,Lindi,TZ08,Liwale,TZ0804,Lilombe,TZ0804201,3728 ,1900 ,1828 ,3728 ,1900 ,0 ,0 ,0 ,1828 
United Republic of Tanzania,Jamhuri ya Muungano wa Tanzania,TZ,Lindi,TZ08,Ruangwa,TZ0805,Ruangwa,TZ0805013,5435 ,2546 ,2889 ,786 ,420 ,4649 ,2126 ,2523 ,366 
United Republic of Tanzania,Jamhuri ya Muungano wa Tanzania,TZ,Lindi,TZ08,Ruangwa,TZ0805,Mbekenyera,TZ0805023,11257 ,5398 ,5859 ,8623 ,4156 ,2634 ,1242 ,1392 ,4467 
United Republic of Tanzania,Jamhuri ya Muungano wa Tanzania,TZ,Lindi,TZ08,Ruangwa,TZ0805,Nkowe,TZ0805033,5264 ,2610 ,2654 ,3052 ,1534 ,2212 ,1076 ,1136 ,1518 
United Republic of Tanzania,Jamhuri ya Muungano wa Tanzania,TZ,Lindi,TZ08,Ruangwa,TZ0805,Malolo,TZ0805041,7405 ,3572 ,3833 ,7405 ,3572 ,0 ,0 ,0 ,3833 
United Republic of Tanzania,Jamhuri ya Muungano wa Tanzania,TZ,Lindi,TZ08,Ruangwa,TZ0805,Luchelegwa,TZ0805051,4528 ,2210 ,2318 ,4528 ,2210 ,0 ,0 ,0 ,2318 
United Republic of Tanzania,Jamhuri ya Muungano wa Tanzania,TZ,Lindi,TZ08,Ruangwa,TZ0805,Chienjele,TZ0805061,8691 ,4216 ,4475 ,8691 ,4216 ,0 ,0 ,0 ,4475 
United Republic of Tanzania,Jamhuri ya Muungano wa Tanzania,TZ,Lindi,TZ08,Ruangwa,TZ0805,Namichiga,TZ0805071,5165 ,2542 ,2623 ,5165 ,2542 ,0 ,0 ,0 ,2623 
United Republic of Tanzania,Jamhuri ya Muungano wa Tanzania,TZ,Lindi,TZ08,Ruangwa,TZ0805,Narung'ombe,TZ0805081,8407 ,4086 ,4321 ,8407 ,4086 ,0 ,0 ,0 ,4321 
United Republic of Tanzania,Jamhuri ya Muungano wa Tanzania,TZ,Lindi,TZ08,Ruangwa,TZ0805,Makanjiro,TZ0805091,3323 ,1632 ,1691 ,3323 ,1632 ,0 ,0 ,0 ,1691 
United Republic of Tanzania,Jamhuri ya Muungano wa Tanzania,TZ,Lindi,TZ08,Ruangwa,TZ0805,Likunja,TZ0805101,8425 ,4123 ,4302 ,8425 ,4123 ,0 ,0 ,0 ,4302 
United Republic of Tanzania,Jamhuri ya Muungano wa Tanzania,TZ,Lindi,TZ08,Ruangwa,TZ0805,Mnacho,TZ0805111,6607 ,3195 ,3412 ,6607 ,3195 ,0 ,0 ,0 ,3412 
United Republic of Tanzania,Jamhuri ya Muungano wa Tanzania,TZ,Lindi,TZ08,Ruangwa,TZ0805,Mandawa,TZ0805121,13192 ,6404 ,6788 ,13192 ,6404 ,0 ,0 ,0 ,6788 
United Republic of Tanzania,Jamhuri ya Muungano wa Tanzania,TZ,Lindi,TZ08,Ruangwa,TZ0805,Nambilanje,TZ0805131,6182 ,3044 ,3138 ,6182 ,3044 ,0 ,0 ,0 ,3138 
United Republic of Tanzania,Jamhuri ya Muungano wa Tanzania,TZ,Lindi,TZ08,Ruangwa,TZ0805,Chunyu,TZ0805141,5810 ,2801 ,3009 ,5810 ,2801 ,0 ,0 ,0 ,3009 
United Republic of Tanzania,Jamhuri ya Muungano wa Tanzania,TZ,Lindi,TZ08,Ruangwa,TZ0805,Mandarawe,TZ0805151,3796 ,1807 ,1989 ,3796 ,1807 ,0 ,0 ,0 ,1989 
United Republic of Tanzania,Jamhuri ya Muungano wa Tanzania,TZ,Lindi,TZ08,Ruangwa,TZ0805,Nachingwea,TZ0805163,8142 ,3769 ,4373 ,4216 ,1979 ,3926 ,1790 ,2136 ,2237 
United Republic of Tanzania,Jamhuri ya Muungano wa Tanzania,TZ,Lindi,TZ08,Ruangwa,TZ0805,Matambarale,TZ0805171,5071 ,2492 ,2579 ,5071 ,2492 ,0 ,0 ,0 ,2579 
United Republic of Tanzania,Jamhuri ya Muungano wa Tanzania,TZ,Lindi,TZ08,Ruangwa,TZ0805,Chibula,TZ0805181,2937 ,1476 ,1461 ,2937 ,1476 ,0 ,0 ,0 ,1461 
United Republic of Tanzania,Jamhuri ya Muungano wa Tanzania,TZ,Lindi,TZ08,Ruangwa,TZ0805,Nandagala,TZ0805191,5314 ,2529 ,2785 ,5314 ,2529 ,0 ,0 ,0 ,2785 
United Republic of Tanzania,Jamhuri ya Muungano wa Tanzania,TZ,Lindi,TZ08,Ruangwa,TZ0805,Nanganga,TZ0805201,4959 ,2425 ,2534 ,4959 ,2425 ,0 ,0 ,0 ,2534 
United Republic of Tanzania,Jamhuri ya Muungano wa Tanzania,TZ,Lindi,TZ08,Ruangwa,TZ0805,Chinongwe,TZ0805211,7700 ,3652 ,4048 ,7700 ,3652 ,0 ,0 ,0 ,4048 
United Republic of Tanzania,Jamhuri ya Muungano wa Tanzania,TZ,Lindi,TZ08,Lindi Urban,TZ0806,Ndoro,TZ0806012,1836 ,848 ,988 ,0 ,0 ,1836 ,848 ,988 ,0 
United Republic of Tanzania,Jamhuri ya Muungano wa Tanzania,TZ,Lindi,TZ08,Lindi Urban,TZ0806,Makonde,TZ0806022,1091 ,530 ,561 ,0 ,0 ,1091 ,530 ,561 ,0 
United Republic of Tanzania,Jamhuri ya Muungano wa Tanzania,TZ,Lindi,TZ08,Lindi Urban,TZ0806,Mikumbi,TZ0806032,2006 ,956 ,1050 ,0 ,0 ,2006 ,956 ,1050 ,0 
United Republic of Tanzania,Jamhuri ya Muungano wa Tanzania,TZ,Lindi,TZ08,Lindi Urban,TZ0806,Mitandi,TZ0806042,2515 ,1169 ,1346 ,0 ,0 ,2515 ,1169 ,1346 ,0 
United Republic of Tanzania,Jamhuri ya Muungano wa Tanzania,TZ,Lindi,TZ08,Lindi Urban,TZ0806,Rahaleo,TZ0806052,2111 ,960 ,1151 ,0 ,0 ,2111 ,960 ,1151 ,0 
United Republic of Tanzania,Jamhuri ya Muungano wa Tanzania,TZ,Lindi,TZ08,Lindi Urban,TZ0806,Mwenge,TZ0806062,2808 ,1230 ,1578 ,0 ,0 ,2808 ,1230 ,1578 ,0 
United Republic of Tanzania,Jamhuri ya Muungano wa Tanzania,TZ,Lindi,TZ08,Lindi Urban,TZ0806,Matopeni,TZ0806072,3578 ,1633 ,1945 ,0 ,0 ,3578 ,1633 ,1945 ,0 
United Republic of Tanzania,Jamhuri ya Muungano wa Tanzania,TZ,Lindi,TZ08,Lindi Urban,TZ0806,Wailes,TZ0806082,2812 ,1357 ,1455 ,0 ,0 ,2812 ,1357 ,1455 ,0 
United Republic of Tanzania,Jamhuri ya Muungano wa Tanzania,TZ,Lindi,TZ08,Lindi Urban,TZ0806,Nachingwea,TZ0806092,3176 ,1491 ,1685 ,0 ,0 ,3176 ,1491 ,1685 ,0 
United Republic of Tanzania,Jamhuri ya Muungano wa Tanzania,TZ,Lindi,TZ08,Lindi Urban,TZ0806,Rasbura,TZ0806102,6599 ,3197 ,3402 ,0 ,0 ,6599 ,3197 ,3402 ,0 
United Republic of Tanzania,Jamhuri ya Muungano wa Tanzania,TZ,Lindi,TZ08,Lindi Urban,TZ0806,Mtanda,TZ0806112,5683 ,2743 ,2940 ,0 ,0 ,5683 ,2743 ,2940 ,0 
United Republic of Tanzania,Jamhuri ya Muungano wa Tanzania,TZ,Lindi,TZ08,Lindi Urban,TZ0806,Jamhuri,TZ0806122,6571 ,3344 ,3227 ,0 ,0 ,6571 ,3344 ,3227 ,0 
United Republic of Tanzania,Jamhuri ya Muungano wa Tanzania,TZ,Lindi,TZ08,Lindi Urban,TZ0806,Msinjahili,TZ0806132,6391 ,3045 ,3346 ,0 ,0 ,6391 ,3045 ,3346 ,0 
United Republic of Tanzania,Jamhuri ya Muungano wa Tanzania,TZ,Lindi,TZ08,Lindi Urban,TZ0806,Mingoyo,TZ0806142,11812 ,5538 ,6274 ,0 ,0 ,11812 ,5538 ,6274 ,0 
United Republic of Tanzania,Jamhuri ya Muungano wa Tanzania,TZ,Lindi,TZ08,Lindi Urban,TZ0806,Ng'apa,TZ0806152,7760 ,3701 ,4059 ,0 ,0 ,7760 ,3701 ,4059 ,0 
United Republic of Tanzania,Jamhuri ya Muungano wa Tanzania,TZ,Lindi,TZ08,Lindi Urban,TZ0806,Tandangongoro,TZ0806162,3550 ,1646 ,1904 ,0 ,0 ,3550 ,1646 ,1904 ,0 
United Republic of Tanzania,Jamhuri ya Muungano wa Tanzania,TZ,Lindi,TZ08,Lindi Urban,TZ0806,Chikonji,TZ0806172,5354 ,2557 ,2797 ,0 ,0 ,5354 ,2557 ,2797 ,0 
United Republic of Tanzania,Jamhuri ya Muungano wa Tanzania,TZ,Lindi,TZ08,Lindi Urban,TZ0806,Mbanja,TZ0806182,3188 ,1580 ,1608 ,0 ,0 ,3188 ,1580 ,1608 ,0 
United Republic of Tanzania,Jamhuri ya Muungano wa Tanzania,TZ,Mtwara,TZ09,Mtwara,TZ0901,Madimba,TZ0901013,13139 ,6223 ,6916 ,11086 ,5265 ,2053 ,958 ,1095 ,5821 
United Republic of Tanzania,Jamhuri ya Muungano wa Tanzania,TZ,Mtwara,TZ09,Mtwara,TZ0901,Ziwani,TZ0901021,8919 ,4342 ,4577 ,8919 ,4342 ,0 ,0 ,0 ,4577 
United Republic of Tanzania,Jamhuri ya Muungano wa Tanzania,TZ,Mtwara,TZ09,Mtwara,TZ0901,Nanguruwe,TZ0901031,6213 ,2954 ,3259 ,6213 ,2954 ,0 ,0 ,0 ,3259 
United Republic of Tanzania,Jamhuri ya Muungano wa Tanzania,TZ,Mtwara,TZ09,Mtwara,TZ0901,Mahurunga,TZ0901041,8214 ,3905 ,4309 ,8214 ,3905 ,0 ,0 ,0 ,4309 
United Republic of Tanzania,Jamhuri ya Muungano wa Tanzania,TZ,Mtwara,TZ09,Mtwara,TZ0901,Kitaya,TZ0901051,8542 ,4074 ,4468 ,8542 ,4074 ,0 ,0 ,0 ,4468 
United Republic of Tanzania,Jamhuri ya Muungano wa Tanzania,TZ,Mtwara,TZ09,Mtwara,TZ0901,Kiromba,TZ0901061,4766 ,2264 ,2502 ,4766 ,2264 ,0 ,0 ,0 ,2502 
United Republic of Tanzania,Jamhuri ya Muungano wa Tanzania,TZ,Mtwara,TZ09,Mtwara,TZ0901,Njengwa,TZ0901071,10066 ,4695 ,5371 ,10066 ,4695 ,0 ,0 ,0 ,5371 
United Republic of Tanzania,Jamhuri ya Muungano wa Tanzania,TZ,Mtwara,TZ09,Mtwara,TZ0901,Nitekela,TZ0901081,9664 ,4538 ,5126 ,9664 ,4538 ,0 ,0 ,0 ,5126 
United Republic of Tanzania,Jamhuri ya Muungano wa Tanzania,TZ,Mtwara,TZ09,Mtwara,TZ0901,Nanyamba,TZ0901093,13320 ,6139 ,7181 ,2024 ,958 ,11296 ,5181 ,6115 ,1066 
United Republic of Tanzania,Jamhuri ya Muungano wa Tanzania,TZ,Mtwara,TZ09,Mtwara,TZ0901,Mtiniko,TZ0901101,7423 ,3443 ,3980 ,7423 ,3443 ,0 ,0 ,0 ,3980 
United Republic of Tanzania,Jamhuri ya Muungano wa Tanzania,TZ,Mtwara,TZ09,Mtwara,TZ0901,Dihimba,TZ0901111,6911 ,3265 ,3646 ,6911 ,3265 ,0 ,0 ,0 ,3646 
United Republic of Tanzania,Jamhuri ya Muungano wa Tanzania,TZ,Mtwara,TZ09,Mtwara,TZ0901,Mnima,TZ0901121,12365 ,5777 ,6588 ,12365 ,5777 ,0 ,0 ,0 ,6588 
United Republic of Tanzania,Jamhuri ya Muungano wa Tanzania,TZ,Mtwara,TZ09,Mtwara,TZ0901,Kitere,TZ0901131,10270 ,4823 ,5447 ,10270 ,4823 ,0 ,0 ,0 ,5447 
United Republic of Tanzania,Jamhuri ya Muungano wa Tanzania,TZ,Mtwara,TZ09,Mtwara,TZ0901,Ndumbwe,TZ0901141,6232 ,2883 ,3349 ,6232 ,2883 ,0 ,0 ,0 ,3349 
United Republic of Tanzania,Jamhuri ya Muungano wa Tanzania,TZ,Mtwara,TZ09,Mtwara,TZ0901,Mayanga,TZ0901151,9528 ,4571 ,4957 ,9528 ,4571 ,0 ,0 ,0 ,4957 
United Republic of Tanzania,Jamhuri ya Muungano wa Tanzania,TZ,Mtwara,TZ09,Mtwara,TZ0901,Naumbu,TZ0901161,9745 ,4662 ,5083 ,9745 ,4662 ,0 ,0 ,0 ,5083 
United Republic of Tanzania,Jamhuri ya Muungano wa Tanzania,TZ,Mtwara,TZ09,Mtwara,TZ0901,Chawi,TZ0901171,6644 ,3192 ,3452 ,6644 ,3192 ,0 ,0 ,0 ,3452 
United Republic of Tanzania,Jamhuri ya Muungano wa Tanzania,TZ,Mtwara,TZ09,Mtwara,TZ0901,Namtumbuka,TZ0901181,8163 ,3927 ,4236 ,8163 ,3927 ,0 ,0 ,0 ,4236 
United Republic of Tanzania,Jamhuri ya Muungano wa Tanzania,TZ,Mtwara,TZ09,Mtwara,TZ0901,Libobe,TZ0901191,5641 ,2658 ,2983 ,5641 ,2658 ,0 ,0 ,0 ,2983 
United Republic of Tanzania,Jamhuri ya Muungano wa Tanzania,TZ,Mtwara,TZ09,Mtwara,TZ0901,Mpapura,TZ0901201,4933 ,2284 ,2649 ,4933 ,2284 ,0 ,0 ,0 ,2649 
United Republic of Tanzania,Jamhuri ya Muungano wa Tanzania,TZ,Mtwara,TZ09,Mtwara,TZ0901,Muungano,TZ0901211,3551 ,1698 ,1853 ,3551 ,1698 ,0 ,0 ,0 ,1853 
United Republic of Tanzania,Jamhuri ya Muungano wa Tanzania,TZ,Mtwara,TZ09,Mtwara,TZ0901,Mbawala,TZ0901221,8052 ,3917 ,4135 ,8052 ,3917 ,0 ,0 ,0 ,4135 
United Republic of Tanzania,Jamhuri ya Muungano wa Tanzania,TZ,Mtwara,TZ09,Mtwara,TZ0901,Msanga Mkuu,TZ0901231,10844 ,5194 ,5650 ,10844 ,5194 ,0 ,0 ,0 ,5650 
United Republic of Tanzania,Jamhuri ya Muungano wa Tanzania,TZ,Mtwara,TZ09,Mtwara,TZ0901,Tangazo,TZ0901241,8751 ,4134 ,4617 ,8751 ,4134 ,0 ,0 ,0 ,4617 
United Republic of Tanzania,Jamhuri ya Muungano wa Tanzania,TZ,Mtwara,TZ09,Mtwara,TZ0901,Kiyanga,TZ0901251,5065 ,2435 ,2630 ,5065 ,2435 ,0 ,0 ,0 ,2630 
United Republic of Tanzania,Jamhuri ya Muungano wa Tanzania,TZ,Mtwara,TZ09,Mtwara,TZ0901,Milango Minne,TZ0901261,16848 ,7997 ,8851 ,16848 ,7997 ,0 ,0 ,0 ,8851 
United Republic of Tanzania,Jamhuri ya Muungano wa Tanzania,TZ,Mtwara,TZ09,Mtwara,TZ0901,Mbembaleo,TZ0901271,6125 ,2898 ,3227 ,6125 ,2898 ,0 ,0 ,0 ,3227 
United Republic of Tanzania,Jamhuri ya Muungano wa Tanzania,TZ,Mtwara,TZ09,Mtwara,TZ0901,Mtimbwilimbwi,TZ0901281,8232 ,3894 ,4338 ,8232 ,3894 ,0 ,0 ,0 ,4338 
United Republic of Tanzania,Jamhuri ya Muungano wa Tanzania,TZ,Mtwara,TZ09,Newala,TZ0902,Luchindu,TZ0902013,20740 ,9519 ,11221 ,2656 ,1247 ,18084 ,8272 ,9812 ,1409 
United Republic of Tanzania,Jamhuri ya Muungano wa Tanzania,TZ,Mtwara,TZ09,Newala,TZ0902,Makote,TZ0902021,9055 ,4126 ,4929 ,9055 ,4126 ,0 ,0 ,0 ,4929 
United Republic of Tanzania,Jamhuri ya Muungano wa Tanzania,TZ,Mtwara,TZ09,Newala,TZ0902,Nanguruwe,TZ0902031,7413 ,3483 ,3930 ,7413 ,3483 ,0 ,0 ,0 ,3930 
United Republic of Tanzania,Jamhuri ya Muungano wa Tanzania,TZ,Mtwara,TZ09,Newala,TZ0902,Mkunya,TZ0902041,6363 ,2970 ,3393 ,6363 ,2970 ,0 ,0 ,0 ,3393 
United Republic of Tanzania,Jamhuri ya Muungano wa Tanzania,TZ,Mtwara,TZ09,Newala,TZ0902,Mcholi I,TZ0902051,11652 ,5348 ,6304 ,11652 ,5348 ,0 ,0 ,0 ,6304 
United Republic of Tanzania,Jamhuri ya Muungano wa Tanzania,TZ,Mtwara,TZ09,Newala,TZ0902,Namiyonga,TZ0902061,6365 ,2884 ,3481 ,6365 ,2884 ,0 ,0 ,0 ,3481 
United Republic of Tanzania,Jamhuri ya Muungano wa Tanzania,TZ,Mtwara,TZ09,Newala,TZ0902,Mnekachi,TZ0902071,6130 ,2810 ,3320 ,6130 ,2810 ,0 ,0 ,0 ,3320 
United Republic of Tanzania,Jamhuri ya Muungano wa Tanzania,TZ,Mtwara,TZ09,Newala,TZ0902,Chitekete,TZ0902081,3920 ,1839 ,2081 ,3920 ,1839 ,0 ,0 ,0 ,2081 
United Republic of Tanzania,Jamhuri ya Muungano wa Tanzania,TZ,Mtwara,TZ09,Newala,TZ0902,Mnyambe,TZ0902091,7578 ,3592 ,3986 ,7578 ,3592 ,0 ,0 ,0 ,3986 
United Republic of Tanzania,Jamhuri ya Muungano wa Tanzania,TZ,Mtwara,TZ09,Newala,TZ0902,Chilangala,TZ0902101,9675 ,4507 ,5168 ,9675 ,4507 ,0 ,0 ,0 ,5168 
United Republic of Tanzania,Jamhuri ya Muungano wa Tanzania,TZ,Mtwara,TZ09,Newala,TZ0902,Mkoma II,TZ0902111,2834 ,1367 ,1467 ,2834 ,1367 ,0 ,0 ,0 ,1467 
United Republic of Tanzania,Jamhuri ya Muungano wa Tanzania,TZ,Mtwara,TZ09,Newala,TZ0902,Kitangari,TZ0902123,11391 ,5251 ,6140 ,7110 ,3266 ,4281 ,1985 ,2296 ,3844 
United Republic of Tanzania,Jamhuri ya Muungano wa Tanzania,TZ,Mtwara,TZ09,Newala,TZ0902,Malatu,TZ0902131,6266 ,2945 ,3321 ,6266 ,2945 ,0 ,0 ,0 ,3321 
United Republic of Tanzania,Jamhuri ya Muungano wa Tanzania,TZ,Mtwara,TZ09,Newala,TZ0902,Mchemo,TZ0902141,8885 ,4097 ,4788 ,8885 ,4097 ,0 ,0 ,0 ,4788 
United Republic of Tanzania,Jamhuri ya Muungano wa Tanzania,TZ,Mtwara,TZ09,Newala,TZ0902,Mtopwa,TZ0902151,8477 ,3820 ,4657 ,8477 ,3820 ,0 ,0 ,0 ,4657 
United Republic of Tanzania,Jamhuri ya Muungano wa Tanzania,TZ,Mtwara,TZ09,Newala,TZ0902,Chiwonga,TZ0902161,5298 ,2445 ,2853 ,5298 ,2445 ,0 ,0 ,0 ,2853 
United Republic of Tanzania,Jamhuri ya Muungano wa Tanzania,TZ,Mtwara,TZ09,Newala,TZ0902,Maputi,TZ0902171,6421 ,3070 ,3351 ,6421 ,3070 ,0 ,0 ,0 ,3351 
United Republic of Tanzania,Jamhuri ya Muungano wa Tanzania,TZ,Mtwara,TZ09,Newala,TZ0902,Makukwe,TZ0902181,6320 ,2888 ,3432 ,6320 ,2888 ,0 ,0 ,0 ,3432 
United Republic of Tanzania,Jamhuri ya Muungano wa Tanzania,TZ,Mtwara,TZ09,Newala,TZ0902,Mkwedu,TZ0902191,6436 ,2981 ,3455 ,6436 ,2981 ,0 ,0 ,0 ,3455 
United Republic of Tanzania,Jamhuri ya Muungano wa Tanzania,TZ,Mtwara,TZ09,Newala,TZ0902,Mcholi II,TZ0902201,6002 ,2737 ,3265 ,6002 ,2737 ,0 ,0 ,0 ,3265 
United Republic of Tanzania,Jamhuri ya Muungano wa Tanzania,TZ,Mtwara,TZ09,Newala,TZ0902,Mtonya,TZ0902213,1912 ,848 ,1064 ,0 ,0 ,1912 ,848 ,1064 ,0 
United Republic of Tanzania,Jamhuri ya Muungano wa Tanzania,TZ,Mtwara,TZ09,Newala,TZ0902,Makonga,TZ0902221,7892 ,3575 ,4317 ,7892 ,3575 ,0 ,0 ,0 ,4317 
United Republic of Tanzania,Jamhuri ya Muungano wa Tanzania,TZ,Mtwara,TZ09,Newala,TZ0902,Nakahako,TZ0902231,4507 ,2171 ,2336 ,4507 ,2171 ,0 ,0 ,0 ,2336 
United Republic of Tanzania,Jamhuri ya Muungano wa Tanzania,TZ,Mtwara,TZ09,Newala,TZ0902,Chihangu,TZ0902241,5774 ,2698 ,3076 ,5774 ,2698 ,0 ,0 ,0 ,3076 
United Republic of Tanzania,Jamhuri ya Muungano wa Tanzania,TZ,Mtwara,TZ09,Newala,TZ0902,Nambali,TZ0902251,6295 ,2880 ,3415 ,6295 ,2880 ,0 ,0 ,0 ,3415 
United Republic of Tanzania,Jamhuri ya Muungano wa Tanzania,TZ,Mtwara,TZ09,Newala,TZ0902,Nandwahi,TZ0902261,6261 ,2925 ,3336 ,6261 ,2925 ,0 ,0 ,0 ,3336 
United Republic of Tanzania,Jamhuri ya Muungano wa Tanzania,TZ,Mtwara,TZ09,Newala,TZ0902,Mtunguru,TZ0902271,6047 ,2723 ,3324 ,6047 ,2723 ,0 ,0 ,0 ,3324 
United Republic of Tanzania,Jamhuri ya Muungano wa Tanzania,TZ,Mtwara,TZ09,Newala,TZ0902,Mdimba MpeleMpele,TZ0902281,3856 ,1802 ,2054 ,3856 ,1802 ,0 ,0 ,0 ,2054 
United Republic of Tanzania,Jamhuri ya Muungano wa Tanzania,TZ,Mtwara,TZ09,Masasi,TZ0903,Namatutwe,TZ0903011,14122 ,6943 ,7179 ,14122 ,6943 ,0 ,0 ,0 ,7179 
United Republic of Tanzania,Jamhuri ya Muungano wa Tanzania,TZ,Mtwara,TZ09,Masasi,TZ0903,Namajani,TZ0903021,13739 ,6571 ,7168 ,13739 ,6571 ,0 ,0 ,0 ,7168 
United Republic of Tanzania,Jamhuri ya Muungano wa Tanzania,TZ,Mtwara,TZ09,Masasi,TZ0903,Mlingula,TZ0903031,9095 ,4410 ,4685 ,9095 ,4410 ,0 ,0 ,0 ,4685 
United Republic of Tanzania,Jamhuri ya Muungano wa Tanzania,TZ,Mtwara,TZ09,Masasi,TZ0903,Chiwale,TZ0903041,11311 ,5505 ,5806 ,11311 ,5505 ,0 ,0 ,0 ,5806 
United Republic of Tanzania,Jamhuri ya Muungano wa Tanzania,TZ,Mtwara,TZ09,Masasi,TZ0903,Lukuledi,TZ0903053,17060 ,8194 ,8866 ,11025 ,5361 ,6035 ,2833 ,3202 ,5664 
United Republic of Tanzania,Jamhuri ya Muungano wa Tanzania,TZ,Mtwara,TZ09,Masasi,TZ0903,Mpanyani,TZ0903061,7559 ,3654 ,3905 ,7559 ,3654 ,0 ,0 ,0 ,3905 
United Republic of Tanzania,Jamhuri ya Muungano wa Tanzania,TZ,Mtwara,TZ09,Masasi,TZ0903,Chigugu,TZ0903071,17495 ,8289 ,9206 ,17495 ,8289 ,0 ,0 ,0 ,9206 
United Republic of Tanzania,Jamhuri ya Muungano wa Tanzania,TZ,Mtwara,TZ09,Masasi,TZ0903,Mwena,TZ0903083,27908 ,13331 ,14577 ,14077 ,6723 ,13831 ,6608 ,7223 ,7354 
United Republic of Tanzania,Jamhuri ya Muungano wa Tanzania,TZ,Mtwara,TZ09,Masasi,TZ0903,Nanganga,TZ0903093,16655 ,7968 ,8687 ,14515 ,6944 ,2140 ,1024 ,1116 ,7571 
United Republic of Tanzania,Jamhuri ya Muungano wa Tanzania,TZ,Mtwara,TZ09,Masasi,TZ0903,Chiwata,TZ0903101,5654 ,2789 ,2865 ,5654 ,2789 ,0 ,0 ,0 ,2865 
United Republic of Tanzania,Jamhuri ya Muungano wa Tanzania,TZ,Mtwara,TZ09,Masasi,TZ0903,Mkundi,TZ0903111,5510 ,2698 ,2812 ,5510 ,2698 ,0 ,0 ,0 ,2812 
United Republic of Tanzania,Jamhuri ya Muungano wa Tanzania,TZ,Mtwara,TZ09,Masasi,TZ0903,Mkululu,TZ0903121,8105 ,3867 ,4238 ,8105 ,3867 ,0 ,0 ,0 ,4238 
United Republic of Tanzania,Jamhuri ya Muungano wa Tanzania,TZ,Mtwara,TZ09,Masasi,TZ0903,Nanjota,TZ0903131,9094 ,4290 ,4804 ,9094 ,4290 ,0 ,0 ,0 ,4804 
United Republic of Tanzania,Jamhuri ya Muungano wa Tanzania,TZ,Mtwara,TZ09,Masasi,TZ0903,Chiungutwa,TZ0903143,13676 ,6521 ,7155 ,10367 ,4964 ,3309 ,1557 ,1752 ,5403 
United Republic of Tanzania,Jamhuri ya Muungano wa Tanzania,TZ,Mtwara,TZ09,Masasi,TZ0903,Mbuyuni,TZ0903151,8394 ,4002 ,4392 ,8394 ,4002 ,0 ,0 ,0 ,4392 
United Republic of Tanzania,Jamhuri ya Muungano wa Tanzania,TZ,Mtwara,TZ09,Masasi,TZ0903,Lipumburu,TZ0903161,7266 ,3546 ,3720 ,7266 ,3546 ,0 ,0 ,0 ,3720 
United Republic of Tanzania,Jamhuri ya Muungano wa Tanzania,TZ,Mtwara,TZ09,Masasi,TZ0903,Sindano,TZ0903171,5485 ,2640 ,2845 ,5485 ,2640 ,0 ,0 ,0 ,2845 
United Republic of Tanzania,Jamhuri ya Muungano wa Tanzania,TZ,Mtwara,TZ09,Masasi,TZ0903,Namalenga,TZ0903183,11507 ,5447 ,6060 ,5749 ,2766 ,5758 ,2681 ,3077 ,2983 
United Republic of Tanzania,Jamhuri ya Muungano wa Tanzania,TZ,Mtwara,TZ09,Masasi,TZ0903,Mchauru,TZ0903191,10887 ,5249 ,5638 ,10887 ,5249 ,0 ,0 ,0 ,5638 
United Republic of Tanzania,Jamhuri ya Muungano wa Tanzania,TZ,Mtwara,TZ09,Masasi,TZ0903,Mnavira,TZ0903201,11674 ,5625 ,6049 ,11674 ,5625 ,0 ,0 ,0 ,6049 
United Republic of Tanzania,Jamhuri ya Muungano wa Tanzania,TZ,Mtwara,TZ09,Masasi,TZ0903,Chikolopola,TZ0903211,7219 ,3455 ,3764 ,7219 ,3455 ,0 ,0 ,0 ,3764 
United Republic of Tanzania,Jamhuri ya Muungano wa Tanzania,TZ,Mtwara,TZ09,Masasi,TZ0903,Lulindi,TZ0903223,8578 ,3982 ,4596 ,8487 ,3929 ,91 ,53 ,38 ,4558 
United Republic of Tanzania,Jamhuri ya Muungano wa Tanzania,TZ,Mtwara,TZ09,Tandahimba,TZ0904,Tandahimba,TZ0904013,20569 ,9658 ,10911 ,4166 ,1958 ,16403 ,7700 ,8703 ,2208 
United Republic of Tanzania,Jamhuri ya Muungano wa Tanzania,TZ,Mtwara,TZ09,Tandahimba,TZ0904,Kitama,TZ0904023,12859 ,6031 ,6828 ,3286 ,1582 ,9573 ,4449 ,5124 ,1704 
United Republic of Tanzania,Jamhuri ya Muungano wa Tanzania,TZ,Mtwara,TZ09,Tandahimba,TZ0904,Michenjele,TZ0904031,6333 ,2995 ,3338 ,6333 ,2995 ,0 ,0 ,0 ,3338 
United Republic of Tanzania,Jamhuri ya Muungano wa Tanzania,TZ,Mtwara,TZ09,Tandahimba,TZ0904,Mihambwe,TZ0904041,10239 ,4760 ,5479 ,10239 ,4760 ,0 ,0 ,0 ,5479 
United Republic of Tanzania,Jamhuri ya Muungano wa Tanzania,TZ,Mtwara,TZ09,Tandahimba,TZ0904,Mkoreha,TZ0904051,10244 ,4865 ,5379 ,10244 ,4865 ,0 ,0 ,0 ,5379 
United Republic of Tanzania,Jamhuri ya Muungano wa Tanzania,TZ,Mtwara,TZ09,Tandahimba,TZ0904,Maundo,TZ0904061,10232 ,4750 ,5482 ,10232 ,4750 ,0 ,0 ,0 ,5482 
United Republic of Tanzania,Jamhuri ya Muungano wa Tanzania,TZ,Mtwara,TZ09,Tandahimba,TZ0904,Naputa,TZ0904071,7671 ,3564 ,4107 ,7671 ,3564 ,0 ,0 ,0 ,4107 
United Republic of Tanzania,Jamhuri ya Muungano wa Tanzania,TZ,Mtwara,TZ09,Tandahimba,TZ0904,Namikupa,TZ0904083,8100 ,3695 ,4405 ,6494 ,2969 ,1606 ,726 ,880 ,3525 
United Republic of Tanzania,Jamhuri ya Muungano wa Tanzania,TZ,Mtwara,TZ09,Tandahimba,TZ0904,Mnyawa,TZ0904091,8152 ,3664 ,4488 ,8152 ,3664 ,0 ,0 ,0 ,4488 
United Republic of Tanzania,Jamhuri ya Muungano wa Tanzania,TZ,Mtwara,TZ09,Tandahimba,TZ0904,Mkundi,TZ0904101,8203 ,3786 ,4417 ,8203 ,3786 ,0 ,0 ,0 ,4417 
United Republic of Tanzania,Jamhuri ya Muungano wa Tanzania,TZ,Mtwara,TZ09,Tandahimba,TZ0904,Lukokoda,TZ0904111,5329 ,2439 ,2890 ,5329 ,2439 ,0 ,0 ,0 ,2890 
United Republic of Tanzania,Jamhuri ya Muungano wa Tanzania,TZ,Mtwara,TZ09,Tandahimba,TZ0904,Mahuta,TZ0904123,5722 ,2514 ,3208 ,1433 ,660 ,4289 ,1854 ,2435 ,773 
United Republic of Tanzania,Jamhuri ya Muungano wa Tanzania,TZ,Mtwara,TZ09,Tandahimba,TZ0904,Nanhyanga,TZ0904133,8531 ,3979 ,4552 ,3328 ,1596 ,5203 ,2383 ,2820 ,1732 
United Republic of Tanzania,Jamhuri ya Muungano wa Tanzania,TZ,Mtwara,TZ09,Tandahimba,TZ0904,Chingungwe,TZ0904141,7082 ,3197 ,3885 ,7082 ,3197 ,0 ,0 ,0 ,3885 
United Republic of Tanzania,Jamhuri ya Muungano wa Tanzania,TZ,Mtwara,TZ09,Tandahimba,TZ0904,Mdimba Mnyoma,TZ0904151,8270 ,3794 ,4476 ,8270 ,3794 ,0 ,0 ,0 ,4476 
United Republic of Tanzania,Jamhuri ya Muungano wa Tanzania,TZ,Mtwara,TZ09,Tandahimba,TZ0904,Milongodi,TZ0904161,6685 ,3133 ,3552 ,6685 ,3133 ,0 ,0 ,0 ,3552 
United Republic of Tanzania,Jamhuri ya Muungano wa Tanzania,TZ,Mtwara,TZ09,Tandahimba,TZ0904,Lyenje,TZ0904171,3794 ,1778 ,2016 ,3794 ,1778 ,0 ,0 ,0 ,2016 
United Republic of Tanzania,Jamhuri ya Muungano wa Tanzania,TZ,Mtwara,TZ09,Tandahimba,TZ0904,Chaume,TZ0904181,10085 ,4655 ,5430 ,10085 ,4655 ,0 ,0 ,0 ,5430 
United Republic of Tanzania,Jamhuri ya Muungano wa Tanzania,TZ,Mtwara,TZ09,Tandahimba,TZ0904,Mkonjowano,TZ0904191,5226 ,2401 ,2825 ,5226 ,2401 ,0 ,0 ,0 ,2825 
United Republic of Tanzania,Jamhuri ya Muungano wa Tanzania,TZ,Mtwara,TZ09,Tandahimba,TZ0904,Luagala,TZ0904201,6653 ,3159 ,3494 ,6653 ,3159 ,0 ,0 ,0 ,3494 
United Republic of Tanzania,Jamhuri ya Muungano wa Tanzania,TZ,Mtwara,TZ09,Tandahimba,TZ0904,Ngunja,TZ0904211,9697 ,4417 ,5280 ,9697 ,4417 ,0 ,0 ,0 ,5280 
United Republic of Tanzania,Jamhuri ya Muungano wa Tanzania,TZ,Mtwara,TZ09,Tandahimba,TZ0904,Mkwiti,TZ0904221,4819 ,2285 ,2534 ,4819 ,2285 ,0 ,0 ,0 ,2534 
United Republic of Tanzania,Jamhuri ya Muungano wa Tanzania,TZ,Mtwara,TZ09,Tandahimba,TZ0904,Litehu,TZ0904231,5528 ,2517 ,3011 ,5528 ,2517 ,0 ,0 ,0 ,3011 
United Republic of Tanzania,Jamhuri ya Muungano wa Tanzania,TZ,Mtwara,TZ09,Tandahimba,TZ0904,Nambahu,TZ0904241,6960 ,3300 ,3660 ,6960 ,3300 ,0 ,0 ,0 ,3660 
United Republic of Tanzania,Jamhuri ya Muungano wa Tanzania,TZ,Mtwara,TZ09,Tandahimba,TZ0904,Miuta,TZ0904251,1600 ,792 ,808 ,0 ,0 ,1600 ,792 ,808 ,0 
United Republic of Tanzania,Jamhuri ya Muungano wa Tanzania,TZ,Mtwara,TZ09,Tandahimba,TZ0904,Kwanyama,TZ0904261,4077 ,1887 ,2190 ,4077 ,1887 ,0 ,0 ,0 ,2190 
United Republic of Tanzania,Jamhuri ya Muungano wa Tanzania,TZ,Mtwara,TZ09,Tandahimba,TZ0904,Mchichira,TZ0904271,5636 ,2619 ,3017 ,5636 ,2619 ,0 ,0 ,0 ,3017 
United Republic of Tanzania,Jamhuri ya Muungano wa Tanzania,TZ,Mtwara,TZ09,Tandahimba,TZ0904,Chikongola,TZ0904283,6947 ,3074 ,3873 ,2154 ,985 ,4793 ,2089 ,2704 ,1169 
United Republic of Tanzania,Jamhuri ya Muungano wa Tanzania,TZ,Mtwara,TZ09,Tandahimba,TZ0904,Dinduma,TZ0904291,4406 ,1974 ,2432 ,4406 ,1974 ,0 ,0 ,0 ,2432 
United Republic of Tanzania,Jamhuri ya Muungano wa Tanzania,TZ,Mtwara,TZ09,Tandahimba,TZ0904,Mdumbwe,TZ0904301,7228 ,3376 ,3852 ,7228 ,3376 ,0 ,0 ,0 ,3852 
United Republic of Tanzania,Jamhuri ya Muungano wa Tanzania,TZ,Mtwara,TZ09,Mtwara Urban,TZ0905,Majengo,TZ0905012,3859 ,1767 ,2092 ,0 ,0 ,3859 ,1767 ,2092 ,0 
United Republic of Tanzania,Jamhuri ya Muungano wa Tanzania,TZ,Mtwara,TZ09,Mtwara Urban,TZ0905,Chikongola,TZ0905022,14787 ,6956 ,7831 ,0 ,0 ,14787 ,6956 ,7831 ,0 
United Republic of Tanzania,Jamhuri ya Muungano wa Tanzania,TZ,Mtwara,TZ09,Mtwara Urban,TZ0905,Likombe,TZ0905032,13302 ,6589 ,6713 ,0 ,0 ,13302 ,6589 ,6713 ,0 
United Republic of Tanzania,Jamhuri ya Muungano wa Tanzania,TZ,Mtwara,TZ09,Mtwara Urban,TZ0905,Railway,TZ0905042,2789 ,1289 ,1500 ,0 ,0 ,2789 ,1289 ,1500 ,0 
United Republic of Tanzania,Jamhuri ya Muungano wa Tanzania,TZ,Mtwara,TZ09,Mtwara Urban,TZ0905,Shangani,TZ0905052,12896 ,5911 ,6985 ,0 ,0 ,12896 ,5911 ,6985 ,0 
United Republic of Tanzania,Jamhuri ya Muungano wa Tanzania,TZ,Mtwara,TZ09,Mtwara Urban,TZ0905,Vigaeni,TZ0905062,3673 ,1756 ,1917 ,0 ,0 ,3673 ,1756 ,1917 ,0 
United Republic of Tanzania,Jamhuri ya Muungano wa Tanzania,TZ,Mtwara,TZ09,Mtwara Urban,TZ0905,Chuno,TZ0905072,8884 ,4098 ,4786 ,0 ,0 ,8884 ,4098 ,4786 ,0 
United Republic of Tanzania,Jamhuri ya Muungano wa Tanzania,TZ,Mtwara,TZ09,Mtwara Urban,TZ0905,Jangwani,TZ0905083,4215 ,1983 ,2232 ,2194 ,1009 ,2021 ,974 ,1047 ,1185 
United Republic of Tanzania,Jamhuri ya Muungano wa Tanzania,TZ,Mtwara,TZ09,Mtwara Urban,TZ0905,Kisungule,TZ0905092,1123 ,530 ,593 ,0 ,0 ,1123 ,530 ,593 ,0 
United Republic of Tanzania,Jamhuri ya Muungano wa Tanzania,TZ,Mtwara,TZ09,Mtwara Urban,TZ0905,Mitengo,TZ0905102,4785 ,2253 ,2532 ,4785 ,2253 ,0 ,0 ,0 ,2532 
United Republic of Tanzania,Jamhuri ya Muungano wa Tanzania,TZ,Mtwara,TZ09,Mtwara Urban,TZ0905,Mtonya,TZ0905112,7639 ,3565 ,4074 ,3602 ,1587 ,4037 ,1978 ,2059 ,2015 
United Republic of Tanzania,Jamhuri ya Muungano wa Tanzania,TZ,Mtwara,TZ09,Mtwara Urban,TZ0905,Ufukoni,TZ0905122,25011 ,11729 ,13282 ,0 ,0 ,25011 ,11729 ,13282 ,0 
United Republic of Tanzania,Jamhuri ya Muungano wa Tanzania,TZ,Mtwara,TZ09,Mtwara Urban,TZ0905,Magengeni,TZ0905132,1800 ,835 ,965 ,0 ,0 ,1800 ,835 ,965 ,0 
United Republic of Tanzania,Jamhuri ya Muungano wa Tanzania,TZ,Mtwara,TZ09,Mtwara Urban,TZ0905,Rahaleo,TZ0905142,5208 ,2360 ,2848 ,0 ,0 ,5208 ,2360 ,2848 ,0 
United Republic of Tanzania,Jamhuri ya Muungano wa Tanzania,TZ,Mtwara,TZ09,Mtwara Urban,TZ0905,Naliendele,TZ0905151,7240 ,3619 ,3621 ,5479 ,2627 ,1761 ,992 ,769 ,2852 
United Republic of Tanzania,Jamhuri ya Muungano wa Tanzania,TZ,Mtwara,TZ09,Nanyumbu,TZ0906,Mangaka,TZ0906013,16494 ,7817 ,8677 ,10085 ,4769 ,6409 ,3048 ,3361 ,5316 
United Republic of Tanzania,Jamhuri ya Muungano wa Tanzania,TZ,Mtwara,TZ09,Nanyumbu,TZ0906,Nangomba,TZ0906021,8178 ,3955 ,4223 ,8178 ,3955 ,0 ,0 ,0 ,4223 
United Republic of Tanzania,Jamhuri ya Muungano wa Tanzania,TZ,Mtwara,TZ09,Nanyumbu,TZ0906,Lumesule,TZ0906031,7656 ,3684 ,3972 ,7656 ,3684 ,0 ,0 ,0 ,3972 
United Republic of Tanzania,Jamhuri ya Muungano wa Tanzania,TZ,Mtwara,TZ09,Nanyumbu,TZ0906,Likokona,TZ0906043,18629 ,8846 ,9783 ,5256 ,2521 ,13373 ,6325 ,7048 ,2735 
United Republic of Tanzania,Jamhuri ya Muungano wa Tanzania,TZ,Mtwara,TZ09,Nanyumbu,TZ0906,Sengenya,TZ0906051,13479 ,6491 ,6988 ,13479 ,6491 ,0 ,0 ,0 ,6988 
United Republic of Tanzania,Jamhuri ya Muungano wa Tanzania,TZ,Mtwara,TZ09,Nanyumbu,TZ0906,Mnanje,TZ0906061,7912 ,3738 ,4174 ,7912 ,3738 ,0 ,0 ,0 ,4174 
United Republic of Tanzania,Jamhuri ya Muungano wa Tanzania,TZ,Mtwara,TZ09,Nanyumbu,TZ0906,Mikangaula,TZ0906071,4137 ,1936 ,2201 ,4137 ,1936 ,0 ,0 ,0 ,2201 
United Republic of Tanzania,Jamhuri ya Muungano wa Tanzania,TZ,Mtwara,TZ09,Nanyumbu,TZ0906,Maratani,TZ0906081,6668 ,3109 ,3559 ,6668 ,3109 ,0 ,0 ,0 ,3559 
United Republic of Tanzania,Jamhuri ya Muungano wa Tanzania,TZ,Mtwara,TZ09,Nanyumbu,TZ0906,Nandete,TZ0906091,10067 ,4818 ,5249 ,10067 ,4818 ,0 ,0 ,0 ,5249 
United Republic of Tanzania,Jamhuri ya Muungano wa Tanzania,TZ,Mtwara,TZ09,Nanyumbu,TZ0906,Mkonona,TZ0906101,8137 ,4034 ,4103 ,8137 ,4034 ,0 ,0 ,0 ,4103 
United Republic of Tanzania,Jamhuri ya Muungano wa Tanzania,TZ,Mtwara,TZ09,Nanyumbu,TZ0906,Nanyumbu,TZ0906111,10826 ,5127 ,5699 ,10826 ,5127 ,0 ,0 ,0 ,5699 
United Republic of Tanzania,Jamhuri ya Muungano wa Tanzania,TZ,Mtwara,TZ09,Nanyumbu,TZ0906,Masuguru,TZ0906121,5945 ,3011 ,2934 ,5945 ,3011 ,0 ,0 ,0 ,2934 
United Republic of Tanzania,Jamhuri ya Muungano wa Tanzania,TZ,Mtwara,TZ09,Nanyumbu,TZ0906,Chipuputa,TZ0906131,9926 ,4748 ,5178 ,9926 ,4748 ,0 ,0 ,0 ,5178 
United Republic of Tanzania,Jamhuri ya Muungano wa Tanzania,TZ,Mtwara,TZ09,Nanyumbu,TZ0906,Napacho,TZ0906141,10092 ,4862 ,5230 ,10092 ,4862 ,0 ,0 ,0 ,5230 
United Republic of Tanzania,Jamhuri ya Muungano wa Tanzania,TZ,Mtwara,TZ09,Masasi  Township Authority,TZ0907,Mwenge Mtapika,TZ0907013,6355 ,3019 ,3336 ,4819 ,2284 ,1536 ,735 ,801 ,2535 
United Republic of Tanzania,Jamhuri ya Muungano wa Tanzania,TZ,Mtwara,TZ09,Masasi  Township Authority,TZ0907,Temeke,TZ0907023,11547 ,5555 ,5992 ,7422 ,3617 ,4125 ,1938 ,2187 ,3805 
United Republic of Tanzania,Jamhuri ya Muungano wa Tanzania,TZ,Mtwara,TZ09,Masasi  Township Authority,TZ0907,Mkuti,TZ0907032,7807 ,3767 ,4040 ,0 ,0 ,7807 ,3767 ,4040 ,0 
United Republic of Tanzania,Jamhuri ya Muungano wa Tanzania,TZ,Mtwara,TZ09,Masasi  Township Authority,TZ0907,Mpindimbi,TZ0907043,12861 ,6175 ,6686 ,9951 ,4809 ,2910 ,1366 ,1544 ,5142 
United Republic of Tanzania,Jamhuri ya Muungano wa Tanzania,TZ,Mtwara,TZ09,Masasi  Township Authority,TZ0907,Nyasa,TZ0907052,14368 ,6803 ,7565 ,0 ,0 ,14368 ,6803 ,7565 ,0 
United Republic of Tanzania,Jamhuri ya Muungano wa Tanzania,TZ,Mtwara,TZ09,Masasi  Township Authority,TZ0907,Marika,TZ0907063,11175 ,5339 ,5836 ,9780 ,4666 ,1395 ,673 ,722 ,5114 
United Republic of Tanzania,Jamhuri ya Muungano wa Tanzania,TZ,Mtwara,TZ09,Masasi  Township Authority,TZ0907,Mkomaindo,TZ0907072,4030 ,2009 ,2021 ,0 ,0 ,4030 ,2009 ,2021 ,0 
United Republic of Tanzania,Jamhuri ya Muungano wa Tanzania,TZ,Mtwara,TZ09,Masasi  Township Authority,TZ0907,Mtandi,TZ0907082,4771 ,2294 ,2477 ,0 ,0 ,4771 ,2294 ,2477 ,0 
United Republic of Tanzania,Jamhuri ya Muungano wa Tanzania,TZ,Mtwara,TZ09,Masasi  Township Authority,TZ0907,Jida,TZ0907092,8237 ,3962 ,4275 ,0 ,0 ,8237 ,3962 ,4275 ,0 
United Republic of Tanzania,Jamhuri ya Muungano wa Tanzania,TZ,Mtwara,TZ09,Masasi  Township Authority,TZ0907,Migongo,TZ0907102,4447 ,2106 ,2341 ,0 ,0 ,4447 ,2106 ,2341 ,0 
United Republic of Tanzania,Jamhuri ya Muungano wa Tanzania,TZ,Mtwara,TZ09,Masasi  Township Authority,TZ0907,Mwenge,TZ0907113,7222 ,3430 ,3792 ,4967 ,2368 ,2255 ,1062 ,1193 ,2599 
United Republic of Tanzania,Jamhuri ya Muungano wa Tanzania,TZ,Mtwara,TZ09,Masasi  Township Authority,TZ0907,Sululu,TZ0907123,9876 ,4652 ,5224 ,7443 ,3488 ,2433 ,1164 ,1269 ,3955 
United Republic of Tanzania,Jamhuri ya Muungano wa Tanzania,TZ,Ruvuma,TZ10,Tunduru,TZ1001,Kalulu,TZ1001011,4271 ,2103 ,2168 ,4271 ,2103 ,0 ,0 ,0 ,2168 
United Republic of Tanzania,Jamhuri ya Muungano wa Tanzania,TZ,Ruvuma,TZ10,Tunduru,TZ1001,Ligunga,TZ1001021,8452 ,4057 ,4395 ,8452 ,4057 ,0 ,0 ,0 ,4395 
United Republic of Tanzania,Jamhuri ya Muungano wa Tanzania,TZ,Ruvuma,TZ10,Tunduru,TZ1001,Mlingoti  Mashariki,TZ1001033,6135 ,2874 ,3261 ,0 ,0 ,6135 ,2874 ,3261 ,0 
United Republic of Tanzania,Jamhuri ya Muungano wa Tanzania,TZ,Ruvuma,TZ10,Tunduru,TZ1001,Mindu,TZ1001041,4444 ,2177 ,2267 ,4444 ,2177 ,0 ,0 ,0 ,2267 
United Republic of Tanzania,Jamhuri ya Muungano wa Tanzania,TZ,Ruvuma,TZ10,Tunduru,TZ1001,Ngapa,TZ1001051,6068 ,3061 ,3007 ,6068 ,3061 ,0 ,0 ,0 ,3007 
United Republic of Tanzania,Jamhuri ya Muungano wa Tanzania,TZ,Ruvuma,TZ10,Tunduru,TZ1001,Nakapanya,TZ1001061,14402 ,7043 ,7359 ,14402 ,7043 ,0 ,0 ,0 ,7359 
United Republic of Tanzania,Jamhuri ya Muungano wa Tanzania,TZ,Ruvuma,TZ10,Tunduru,TZ1001,Muhuwesi,TZ1001071,17540 ,8514 ,9026 ,17540 ,8514 ,0 ,0 ,0 ,9026 
United Republic of Tanzania,Jamhuri ya Muungano wa Tanzania,TZ,Ruvuma,TZ10,Tunduru,TZ1001,Tuwemacho,TZ1001081,8841 ,4292 ,4549 ,8841 ,4292 ,0 ,0 ,0 ,4549 
United Republic of Tanzania,Jamhuri ya Muungano wa Tanzania,TZ,Ruvuma,TZ10,Tunduru,TZ1001,Ligoma,TZ1001091,7989 ,3914 ,4075 ,7989 ,3914 ,0 ,0 ,0 ,4075 
United Republic of Tanzania,Jamhuri ya Muungano wa Tanzania,TZ,Ruvuma,TZ10,Tunduru,TZ1001,Misechela,TZ1001101,8169 ,3945 ,4224 ,8169 ,3945 ,0 ,0 ,0 ,4224 
United Republic of Tanzania,Jamhuri ya Muungano wa Tanzania,TZ,Ruvuma,TZ10,Tunduru,TZ1001,Namasakata,TZ1001111,9938 ,4764 ,5174 ,9938 ,4764 ,0 ,0 ,0 ,5174 
United Republic of Tanzania,Jamhuri ya Muungano wa Tanzania,TZ,Ruvuma,TZ10,Tunduru,TZ1001,Mtina,TZ1001121,17617 ,8442 ,9175 ,17617 ,8442 ,0 ,0 ,0 ,9175 
United Republic of Tanzania,Jamhuri ya Muungano wa Tanzania,TZ,Ruvuma,TZ10,Tunduru,TZ1001,Mchesi,TZ1001131,8781 ,4202 ,4579 ,8781 ,4202 ,0 ,0 ,0 ,4579 
United Republic of Tanzania,Jamhuri ya Muungano wa Tanzania,TZ,Ruvuma,TZ10,Tunduru,TZ1001,Lukumbule,TZ1001141,8755 ,4235 ,4520 ,8755 ,4235 ,0 ,0 ,0 ,4520 
United Republic of Tanzania,Jamhuri ya Muungano wa Tanzania,TZ,Ruvuma,TZ10,Tunduru,TZ1001,Nalasi-Magharibi,TZ1001151,8003 ,3856 ,4147 ,8003 ,3856 ,0 ,0 ,0 ,4147 
United Republic of Tanzania,Jamhuri ya Muungano wa Tanzania,TZ,Ruvuma,TZ10,Tunduru,TZ1001,Mchoteka,TZ1001161,12288 ,5827 ,6461 ,12288 ,5827 ,0 ,0 ,0 ,6461 
United Republic of Tanzania,Jamhuri ya Muungano wa Tanzania,TZ,Ruvuma,TZ10,Tunduru,TZ1001,Marumba,TZ1001171,11445 ,5505 ,5940 ,11445 ,5505 ,0 ,0 ,0 ,5940 
United Republic of Tanzania,Jamhuri ya Muungano wa Tanzania,TZ,Ruvuma,TZ10,Tunduru,TZ1001,Mbesa,TZ1001181,15592 ,7422 ,8170 ,15592 ,7422 ,0 ,0 ,0 ,8170 
United Republic of Tanzania,Jamhuri ya Muungano wa Tanzania,TZ,Ruvuma,TZ10,Tunduru,TZ1001,Mlingoti  Magharibi,TZ1001191,4345 ,2110 ,2235 ,4345 ,2110 ,0 ,0 ,0 ,2235 
United Republic of Tanzania,Jamhuri ya Muungano wa Tanzania,TZ,Ruvuma,TZ10,Tunduru,TZ1001,Kidodoma,TZ1001201,9264 ,4485 ,4779 ,9264 ,4485 ,0 ,0 ,0 ,4779 
United Republic of Tanzania,Jamhuri ya Muungano wa Tanzania,TZ,Ruvuma,TZ10,Tunduru,TZ1001,Nandembo,TZ1001211,7663 ,3764 ,3899 ,7663 ,3764 ,0 ,0 ,0 ,3899 
United Republic of Tanzania,Jamhuri ya Muungano wa Tanzania,TZ,Ruvuma,TZ10,Tunduru,TZ1001,Nampungu,TZ1001221,4692 ,2270 ,2422 ,4692 ,2270 ,0 ,0 ,0 ,2422 
United Republic of Tanzania,Jamhuri ya Muungano wa Tanzania,TZ,Ruvuma,TZ10,Tunduru,TZ1001,Matemanga,TZ1001231,9398 ,4619 ,4779 ,9398 ,4619 ,0 ,0 ,0 ,4779 
United Republic of Tanzania,Jamhuri ya Muungano wa Tanzania,TZ,Ruvuma,TZ10,Tunduru,TZ1001,Namwinyu,TZ1001241,10476 ,4979 ,5497 ,10476 ,4979 ,0 ,0 ,0 ,5497 
United Republic of Tanzania,Jamhuri ya Muungano wa Tanzania,TZ,Ruvuma,TZ10,Tunduru,TZ1001,Mbati,TZ1001251,5548 ,2680 ,2868 ,5548 ,2680 ,0 ,0 ,0 ,2868 
United Republic of Tanzania,Jamhuri ya Muungano wa Tanzania,TZ,Ruvuma,TZ10,Tunduru,TZ1001,Nalasi Mashariki,TZ1001261,8282 ,3905 ,4377 ,8282 ,3905 ,0 ,0 ,0 ,4377 
United Republic of Tanzania,Jamhuri ya Muungano wa Tanzania,TZ,Ruvuma,TZ10,Tunduru,TZ1001,Mchuluka,TZ1001271,3584 ,1756 ,1828 ,3584 ,1756 ,0 ,0 ,0 ,1828 
United Republic of Tanzania,Jamhuri ya Muungano wa Tanzania,TZ,Ruvuma,TZ10,Tunduru,TZ1001,Namiungo,TZ1001281,9530 ,4630 ,4900 ,9530 ,4630 ,0 ,0 ,0 ,4900 
United Republic of Tanzania,Jamhuri ya Muungano wa Tanzania,TZ,Ruvuma,TZ10,Tunduru,TZ1001,Jakika,TZ1001291,3768 ,1792 ,1976 ,3768 ,1792 ,0 ,0 ,0 ,1976 
United Republic of Tanzania,Jamhuri ya Muungano wa Tanzania,TZ,Ruvuma,TZ10,Tunduru,TZ1001,Masonya,TZ1001303,5933 ,2833 ,3100 ,2732 ,1340 ,3201 ,1493 ,1708 ,1392 
United Republic of Tanzania,Jamhuri ya Muungano wa Tanzania,TZ,Ruvuma,TZ10,Tunduru,TZ1001,Sisikwasisi,TZ1001311,5776 ,2785 ,2991 ,5776 ,2785 ,0 ,0 ,0 ,2991 
United Republic of Tanzania,Jamhuri ya Muungano wa Tanzania,TZ,Ruvuma,TZ10,Tunduru,TZ1001,Mchangani,TZ1001321,6031 ,2868 ,3163 ,6031 ,2868 ,0 ,0 ,0 ,3163 
United Republic of Tanzania,Jamhuri ya Muungano wa Tanzania,TZ,Ruvuma,TZ10,Tunduru,TZ1001,Majengo,TZ1001333,7660 ,3693 ,3967 ,3834 ,1842 ,3826 ,1851 ,1975 ,1992 
United Republic of Tanzania,Jamhuri ya Muungano wa Tanzania,TZ,Ruvuma,TZ10,Tunduru,TZ1001,Nanjoka,TZ1001343,9486 ,4384 ,5102 ,0 ,0 ,9486 ,4384 ,5102 ,0 
United Republic of Tanzania,Jamhuri ya Muungano wa Tanzania,TZ,Ruvuma,TZ10,Tunduru,TZ1001,Nakayaya,TZ1001353,8113 ,3874 ,4239 ,0 ,0 ,8113 ,3874 ,4239 ,0 
United Republic of Tanzania,Jamhuri ya Muungano wa Tanzania,TZ,Ruvuma,TZ10,Songea,TZ1002,Wino,TZ1002011,12298 ,6061 ,6237 ,12298 ,6061 ,0 ,0 ,0 ,6237 
United Republic of Tanzania,Jamhuri ya Muungano wa Tanzania,TZ,Ruvuma,TZ10,Songea,TZ1002,Ndongosi,TZ1002021,6446 ,3305 ,3141 ,6446 ,3305 ,0 ,0 ,0 ,3141 
United Republic of Tanzania,Jamhuri ya Muungano wa Tanzania,TZ,Ruvuma,TZ10,Songea,TZ1002,Matumbi,TZ1002031,1878 ,1030 ,848 ,1878 ,1030 ,0 ,0 ,0 ,848 
United Republic of Tanzania,Jamhuri ya Muungano wa Tanzania,TZ,Ruvuma,TZ10,Songea,TZ1002,Mpandangino,TZ1002041,4733 ,2430 ,2303 ,4733 ,2430 ,0 ,0 ,0 ,2303 
United Republic of Tanzania,Jamhuri ya Muungano wa Tanzania,TZ,Ruvuma,TZ10,Songea,TZ1002,Gumbiro,TZ1002051,5716 ,2941 ,2775 ,5716 ,2941 ,0 ,0 ,0 ,2775 
United Republic of Tanzania,Jamhuri ya Muungano wa Tanzania,TZ,Ruvuma,TZ10,Songea,TZ1002,Mpitimbi,TZ1002061,14554 ,7125 ,7429 ,14554 ,7125 ,0 ,0 ,0 ,7429 
United Republic of Tanzania,Jamhuri ya Muungano wa Tanzania,TZ,Ruvuma,TZ10,Songea,TZ1002,Muhuruku,TZ1002071,16579 ,8288 ,8291 ,16579 ,8288 ,0 ,0 ,0 ,8291 
United Republic of Tanzania,Jamhuri ya Muungano wa Tanzania,TZ,Ruvuma,TZ10,Songea,TZ1002,Magagura,TZ1002081,16018 ,8081 ,7937 ,16018 ,8081 ,0 ,0 ,0 ,7937 
United Republic of Tanzania,Jamhuri ya Muungano wa Tanzania,TZ,Ruvuma,TZ10,Songea,TZ1002,Litisha,TZ1002091,14362 ,7121 ,7241 ,14362 ,7121 ,0 ,0 ,0 ,7241 
United Republic of Tanzania,Jamhuri ya Muungano wa Tanzania,TZ,Ruvuma,TZ10,Songea,TZ1002,Kilagano,TZ1002101,12479 ,6365 ,6114 ,12479 ,6365 ,0 ,0 ,0 ,6114 
United Republic of Tanzania,Jamhuri ya Muungano wa Tanzania,TZ,Ruvuma,TZ10,Songea,TZ1002,Maposeni,TZ1002111,5795 ,2844 ,2951 ,5795 ,2844 ,0 ,0 ,0 ,2951 
United Republic of Tanzania,Jamhuri ya Muungano wa Tanzania,TZ,Ruvuma,TZ10,Songea,TZ1002,Peramiho,TZ1002123,15031 ,7076 ,7955 ,2213 ,1057 ,12818 ,6019 ,6799 ,1156 
United Republic of Tanzania,Jamhuri ya Muungano wa Tanzania,TZ,Ruvuma,TZ10,Songea,TZ1002,Mahanje,TZ1002133,11997 ,5955 ,6042 ,1857 ,960 ,10140 ,4995 ,5145 ,897 
United Republic of Tanzania,Jamhuri ya Muungano wa Tanzania,TZ,Ruvuma,TZ10,Songea,TZ1002,Matimira,TZ1002141,11397 ,5668 ,5729 ,11397 ,5668 ,0 ,0 ,0 ,5729 
United Republic of Tanzania,Jamhuri ya Muungano wa Tanzania,TZ,Ruvuma,TZ10,Songea,TZ1002,Mtyangimbole,TZ1002151,9337 ,4557 ,4780 ,9337 ,4557 ,0 ,0 ,0 ,4780 
United Republic of Tanzania,Jamhuri ya Muungano wa Tanzania,TZ,Ruvuma,TZ10,Songea,TZ1002,Mkongotema,TZ1002161,6548 ,3359 ,3189 ,6548 ,3359 ,0 ,0 ,0 ,3189 
United Republic of Tanzania,Jamhuri ya Muungano wa Tanzania,TZ,Ruvuma,TZ10,Songea,TZ1002,Mbinga Mhalule,TZ1002171,8653 ,4342 ,4311 ,8653 ,4342 ,0 ,0 ,0 ,4311 
United Republic of Tanzania,Jamhuri ya Muungano wa Tanzania,TZ,Ruvuma,TZ10,Mbinga,TZ1003,Ruanda,TZ1003011,7374 ,3711 ,3663 ,7374 ,3711 ,0 ,0 ,0 ,3663 
United Republic of Tanzania,Jamhuri ya Muungano wa Tanzania,TZ,Ruvuma,TZ10,Mbinga,TZ1003,Litumbandyosi,TZ1003021,8743 ,4423 ,4320 ,8743 ,4423 ,0 ,0 ,0 ,4320 
United Republic of Tanzania,Jamhuri ya Muungano wa Tanzania,TZ,Ruvuma,TZ10,Mbinga,TZ1003,Kigonsera,TZ1003033,10275 ,5053 ,5222 ,7458 ,3726 ,2817 ,1327 ,1490 ,3732 
United Republic of Tanzania,Jamhuri ya Muungano wa Tanzania,TZ,Ruvuma,TZ10,Mbinga,TZ1003,Kihangi Mahuka,TZ1003041,12832 ,6364 ,6468 ,12832 ,6364 ,0 ,0 ,0 ,6468 
United Republic of Tanzania,Jamhuri ya Muungano wa Tanzania,TZ,Ruvuma,TZ10,Mbinga,TZ1003,Utiri,TZ1003051,7974 ,3882 ,4092 ,7974 ,3882 ,0 ,0 ,0 ,4092 
United Republic of Tanzania,Jamhuri ya Muungano wa Tanzania,TZ,Ruvuma,TZ10,Mbinga,TZ1003,Mbinga Mjini,TZ1003063,37893 ,17752 ,20141 ,2240 ,878 ,35653 ,16874 ,18779 ,1362 
United Republic of Tanzania,Jamhuri ya Muungano wa Tanzania,TZ,Ruvuma,TZ10,Mbinga,TZ1003,Kilimani,TZ1003071,11529 ,5665 ,5864 ,11529 ,5665 ,0 ,0 ,0 ,5864 
United Republic of Tanzania,Jamhuri ya Muungano wa Tanzania,TZ,Ruvuma,TZ10,Mbinga,TZ1003,Mbangamao,TZ1003081,12105 ,5947 ,6158 ,12105 ,5947 ,0 ,0 ,0 ,6158 
United Republic of Tanzania,Jamhuri ya Muungano wa Tanzania,TZ,Ruvuma,TZ10,Mbinga,TZ1003,Kihungu,TZ1003091,3904 ,1912 ,1992 ,3904 ,1912 ,0 ,0 ,0 ,1992 
United Republic of Tanzania,Jamhuri ya Muungano wa Tanzania,TZ,Ruvuma,TZ10,Mbinga,TZ1003,Kikolo,TZ1003101,4949 ,2488 ,2461 ,4949 ,2488 ,0 ,0 ,0 ,2461 
United Republic of Tanzania,Jamhuri ya Muungano wa Tanzania,TZ,Ruvuma,TZ10,Mbinga,TZ1003,Kambarage,TZ1003111,9712 ,4696 ,5016 ,9712 ,4696 ,0 ,0 ,0 ,5016 
United Republic of Tanzania,Jamhuri ya Muungano wa Tanzania,TZ,Ruvuma,TZ10,Mbinga,TZ1003,Mapera,TZ1003121,10513 ,4980 ,5533 ,10513 ,4980 ,0 ,0 ,0 ,5533 
United Republic of Tanzania,Jamhuri ya Muungano wa Tanzania,TZ,Ruvuma,TZ10,Mbinga,TZ1003,Kipapa,TZ1003131,7012 ,3342 ,3670 ,7012 ,3342 ,0 ,0 ,0 ,3670 
United Republic of Tanzania,Jamhuri ya Muungano wa Tanzania,TZ,Ruvuma,TZ10,Mbinga,TZ1003,Kipololo,TZ1003141,4381 ,2178 ,2203 ,4381 ,2178 ,0 ,0 ,0 ,2203 
United Republic of Tanzania,Jamhuri ya Muungano wa Tanzania,TZ,Ruvuma,TZ10,Mbinga,TZ1003,Nyoni,TZ1003151,10918 ,5238 ,5680 ,10918 ,5238 ,0 ,0 ,0 ,5680 
United Republic of Tanzania,Jamhuri ya Muungano wa Tanzania,TZ,Ruvuma,TZ10,Mbinga,TZ1003,Luwaita,TZ1003161,8030 ,3883 ,4147 ,8030 ,3883 ,0 ,0 ,0 ,4147 
United Republic of Tanzania,Jamhuri ya Muungano wa Tanzania,TZ,Ruvuma,TZ10,Mbinga,TZ1003,Maguu,TZ1003173,13396 ,6299 ,7097 ,10114 ,4875 ,3282 ,1424 ,1858 ,5239 
United Republic of Tanzania,Jamhuri ya Muungano wa Tanzania,TZ,Ruvuma,TZ10,Mbinga,TZ1003,Kitumbalomo,TZ1003181,9106 ,4527 ,4579 ,9106 ,4527 ,0 ,0 ,0 ,4579 
United Republic of Tanzania,Jamhuri ya Muungano wa Tanzania,TZ,Ruvuma,TZ10,Mbinga,TZ1003,Mkako,TZ1003191,12736 ,6818 ,5918 ,12736 ,6818 ,0 ,0 ,0 ,5918 
United Republic of Tanzania,Jamhuri ya Muungano wa Tanzania,TZ,Ruvuma,TZ10,Mbinga,TZ1003,Mikalanga,TZ1003201,8425 ,3983 ,4442 ,8425 ,3983 ,0 ,0 ,0 ,4442 
United Republic of Tanzania,Jamhuri ya Muungano wa Tanzania,TZ,Ruvuma,TZ10,Mbinga,TZ1003,Langiro,TZ1003211,11239 ,5481 ,5758 ,11239 ,5481 ,0 ,0 ,0 ,5758 
United Republic of Tanzania,Jamhuri ya Muungano wa Tanzania,TZ,Ruvuma,TZ10,Mbinga,TZ1003,Mbuji,TZ1003221,11245 ,5466 ,5779 ,11245 ,5466 ,0 ,0 ,0 ,5779 
United Republic of Tanzania,Jamhuri ya Muungano wa Tanzania,TZ,Ruvuma,TZ10,Mbinga,TZ1003,Litembo,TZ1003231,12443 ,5868 ,6575 ,12443 ,5868 ,0 ,0 ,0 ,6575 
United Republic of Tanzania,Jamhuri ya Muungano wa Tanzania,TZ,Ruvuma,TZ10,Mbinga,TZ1003,Ngima,TZ1003241,10061 ,4933 ,5128 ,10061 ,4933 ,0 ,0 ,0 ,5128 
United Republic of Tanzania,Jamhuri ya Muungano wa Tanzania,TZ,Ruvuma,TZ10,Mbinga,TZ1003,Myangayanga,TZ1003251,10805 ,5155 ,5650 ,10805 ,5155 ,0 ,0 ,0 ,5650 
United Republic of Tanzania,Jamhuri ya Muungano wa Tanzania,TZ,Ruvuma,TZ10,Mbinga,TZ1003,Mkumbi,TZ1003261,11583 ,5575 ,6008 ,11583 ,5575 ,0 ,0 ,0 ,6008 
United Republic of Tanzania,Jamhuri ya Muungano wa Tanzania,TZ,Ruvuma,TZ10,Mbinga,TZ1003,Linda,TZ1003271,11111 ,5393 ,5718 ,11111 ,5393 ,0 ,0 ,0 ,5718 
United Republic of Tanzania,Jamhuri ya Muungano wa Tanzania,TZ,Ruvuma,TZ10,Mbinga,TZ1003,Matiri,TZ1003283,11860 ,5967 ,5893 ,7193 ,3642 ,4667 ,2325 ,2342 ,3551 
United Republic of Tanzania,Jamhuri ya Muungano wa Tanzania,TZ,Ruvuma,TZ10,Mbinga,TZ1003,Ukata,TZ1003291,5159 ,2559 ,2600 ,5159 ,2559 ,0 ,0 ,0 ,2600 
United Republic of Tanzania,Jamhuri ya Muungano wa Tanzania,TZ,Ruvuma,TZ10,Mbinga,TZ1003,Kitanda,TZ1003301,7832 ,3858 ,3974 ,7832 ,3858 ,0 ,0 ,0 ,3974 
United Republic of Tanzania,Jamhuri ya Muungano wa Tanzania,TZ,Ruvuma,TZ10,Mbinga,TZ1003,Kitura,TZ1003311,7341 ,3679 ,3662 ,7341 ,3679 ,0 ,0 ,0 ,3662 
United Republic of Tanzania,Jamhuri ya Muungano wa Tanzania,TZ,Ruvuma,TZ10,Mbinga,TZ1003,Namswea,TZ1003321,8079 ,4050 ,4029 ,8079 ,4050 ,0 ,0 ,0 ,4029 
United Republic of Tanzania,Jamhuri ya Muungano wa Tanzania,TZ,Ruvuma,TZ10,Mbinga,TZ1003,Mpepai,TZ1003331,12693 ,6271 ,6422 ,12693 ,6271 ,0 ,0 ,0 ,6422 
United Republic of Tanzania,Jamhuri ya Muungano wa Tanzania,TZ,Ruvuma,TZ10,Mbinga,TZ1003,Mpapa,TZ1003341,10425 ,5006 ,5419 ,10425 ,5006 ,0 ,0 ,0 ,5419 
United Republic of Tanzania,Jamhuri ya Muungano wa Tanzania,TZ,Ruvuma,TZ10,Songea Urban,TZ1004,Mjini,TZ1004012,9443 ,4441 ,5002 ,0 ,0 ,9443 ,4441 ,5002 ,0 
United Republic of Tanzania,Jamhuri ya Muungano wa Tanzania,TZ,Ruvuma,TZ10,Songea Urban,TZ1004,Majengo,TZ1004022,7400 ,3366 ,4034 ,0 ,0 ,7400 ,3366 ,4034 ,0 
United Republic of Tanzania,Jamhuri ya Muungano wa Tanzania,TZ,Ruvuma,TZ10,Songea Urban,TZ1004,Misufini,TZ1004032,4599 ,2076 ,2523 ,0 ,0 ,4599 ,2076 ,2523 ,0 
United Republic of Tanzania,Jamhuri ya Muungano wa Tanzania,TZ,Ruvuma,TZ10,Songea Urban,TZ1004,Mfaranyaki,TZ1004042,9115 ,4184 ,4931 ,0 ,0 ,9115 ,4184 ,4931 ,0 
United Republic of Tanzania,Jamhuri ya Muungano wa Tanzania,TZ,Ruvuma,TZ10,Songea Urban,TZ1004,Lizaboni,TZ1004052,14815 ,6780 ,8035 ,0 ,0 ,14815 ,6780 ,8035 ,0 
United Republic of Tanzania,Jamhuri ya Muungano wa Tanzania,TZ,Ruvuma,TZ10,Songea Urban,TZ1004,Matarawe,TZ1004062,6949 ,3197 ,3752 ,0 ,0 ,6949 ,3197 ,3752 ,0 
United Republic of Tanzania,Jamhuri ya Muungano wa Tanzania,TZ,Ruvuma,TZ10,Songea Urban,TZ1004,Bombambili,TZ1004072,28058 ,12989 ,15069 ,0 ,0 ,28058 ,12989 ,15069 ,0 
United Republic of Tanzania,Jamhuri ya Muungano wa Tanzania,TZ,Ruvuma,TZ10,Songea Urban,TZ1004,Matogoro,TZ1004082,5127 ,2405 ,2722 ,0 ,0 ,5127 ,2405 ,2722 ,0 
United Republic of Tanzania,Jamhuri ya Muungano wa Tanzania,TZ,Ruvuma,TZ10,Songea Urban,TZ1004,Ruvuma,TZ1004092,13543 ,6481 ,7062 ,0 ,0 ,13543 ,6481 ,7062 ,0 
United Republic of Tanzania,Jamhuri ya Muungano wa Tanzania,TZ,Ruvuma,TZ10,Songea Urban,TZ1004,Subira,TZ1004102,7662 ,3752 ,3910 ,0 ,0 ,7662 ,3752 ,3910 ,0 
United Republic of Tanzania,Jamhuri ya Muungano wa Tanzania,TZ,Ruvuma,TZ10,Songea Urban,TZ1004,Ruhuwiko,TZ1004112,7377 ,3565 ,3812 ,0 ,0 ,7377 ,3565 ,3812 ,0 
United Republic of Tanzania,Jamhuri ya Muungano wa Tanzania,TZ,Ruvuma,TZ10,Songea Urban,TZ1004,Mshangano,TZ1004122,8205 ,4077 ,4128 ,0 ,0 ,8205 ,4077 ,4128 ,0 
United Republic of Tanzania,Jamhuri ya Muungano wa Tanzania,TZ,Ruvuma,TZ10,Songea Urban,TZ1004,Mletele,TZ1004132,5331 ,2634 ,2697 ,0 ,0 ,5331 ,2634 ,2697 ,0 
United Republic of Tanzania,Jamhuri ya Muungano wa Tanzania,TZ,Ruvuma,TZ10,Songea Urban,TZ1004,Seedfarm,TZ1004142,6228 ,3029 ,3199 ,0 ,0 ,6228 ,3029 ,3199 ,0 
United Republic of Tanzania,Jamhuri ya Muungano wa Tanzania,TZ,Ruvuma,TZ10,Songea Urban,TZ1004,Tanga,TZ1004152,8754 ,4312 ,4442 ,0 ,0 ,8754 ,4312 ,4442 ,0 
United Republic of Tanzania,Jamhuri ya Muungano wa Tanzania,TZ,Ruvuma,TZ10,Songea Urban,TZ1004,Msamala,TZ1004162,18920 ,8943 ,9977 ,0 ,0 ,18920 ,8943 ,9977 ,0 
United Republic of Tanzania,Jamhuri ya Muungano wa Tanzania,TZ,Ruvuma,TZ10,Songea Urban,TZ1004,Lilambo,TZ1004172,11981 ,5837 ,6144 ,0 ,0 ,11981 ,5837 ,6144 ,0 
United Republic of Tanzania,Jamhuri ya Muungano wa Tanzania,TZ,Ruvuma,TZ10,Songea Urban,TZ1004,Mwengemshindo,TZ1004182,2601 ,1356 ,1245 ,0 ,0 ,2601 ,1356 ,1245 ,0 
United Republic of Tanzania,Jamhuri ya Muungano wa Tanzania,TZ,Ruvuma,TZ10,Songea Urban,TZ1004,Mjimwema,TZ1004192,12055 ,5653 ,6402 ,0 ,0 ,12055 ,5653 ,6402 ,0 
United Republic of Tanzania,Jamhuri ya Muungano wa Tanzania,TZ,Ruvuma,TZ10,Songea Urban,TZ1004,Mateka,TZ1004202,13537 ,6479 ,7058 ,0 ,0 ,13537 ,6479 ,7058 ,0 
United Republic of Tanzania,Jamhuri ya Muungano wa Tanzania,TZ,Ruvuma,TZ10,Songea Urban,TZ1004,Ndilimalitembo,TZ1004212,1609 ,791 ,818 ,0 ,0 ,1609 ,791 ,818 ,0 
United Republic of Tanzania,Jamhuri ya Muungano wa Tanzania,TZ,Ruvuma,TZ10,Namtumbo,TZ1005,Rwinga,TZ1005013,13668 ,6491 ,7177 ,7148 ,3378 ,6520 ,3113 ,3407 ,3770 
United Republic of Tanzania,Jamhuri ya Muungano wa Tanzania,TZ,Ruvuma,TZ10,Namtumbo,TZ1005,Mkongo,TZ1005021,7012 ,3420 ,3592 ,7012 ,3420 ,0 ,0 ,0 ,3592 
United Republic of Tanzania,Jamhuri ya Muungano wa Tanzania,TZ,Ruvuma,TZ10,Namtumbo,TZ1005,Ligera,TZ1005031,11796 ,5855 ,5941 ,11796 ,5855 ,0 ,0 ,0 ,5941 
United Republic of Tanzania,Jamhuri ya Muungano wa Tanzania,TZ,Ruvuma,TZ10,Namtumbo,TZ1005,Lusewa,TZ1005041,18883 ,9137 ,9746 ,18883 ,9137 ,0 ,0 ,0 ,9746 
United Republic of Tanzania,Jamhuri ya Muungano wa Tanzania,TZ,Ruvuma,TZ10,Namtumbo,TZ1005,Magazini,TZ1005051,8639 ,4136 ,4503 ,8639 ,4136 ,0 ,0 ,0 ,4503 
United Republic of Tanzania,Jamhuri ya Muungano wa Tanzania,TZ,Ruvuma,TZ10,Namtumbo,TZ1005,Msindo,TZ1005061,6882 ,3369 ,3513 ,6882 ,3369 ,0 ,0 ,0 ,3513 
United Republic of Tanzania,Jamhuri ya Muungano wa Tanzania,TZ,Ruvuma,TZ10,Namtumbo,TZ1005,Luchili,TZ1005071,13824 ,6654 ,7170 ,13824 ,6654 ,0 ,0 ,0 ,7170 
United Republic of Tanzania,Jamhuri ya Muungano wa Tanzania,TZ,Ruvuma,TZ10,Namtumbo,TZ1005,Namabengo,TZ1005081,10055 ,4883 ,5172 ,10055 ,4883 ,0 ,0 ,0 ,5172 
United Republic of Tanzania,Jamhuri ya Muungano wa Tanzania,TZ,Ruvuma,TZ10,Namtumbo,TZ1005,Kitanda,TZ1005091,10498 ,5221 ,5277 ,10498 ,5221 ,0 ,0 ,0 ,5277 
United Republic of Tanzania,Jamhuri ya Muungano wa Tanzania,TZ,Ruvuma,TZ10,Namtumbo,TZ1005,Luegu,TZ1005101,7754 ,3732 ,4022 ,7754 ,3732 ,0 ,0 ,0 ,4022 
United Republic of Tanzania,Jamhuri ya Muungano wa Tanzania,TZ,Ruvuma,TZ10,Namtumbo,TZ1005,Namtumbo,TZ1005113,19275 ,9462 ,9813 ,4935 ,2486 ,14340 ,6976 ,7364 ,2449 
United Republic of Tanzania,Jamhuri ya Muungano wa Tanzania,TZ,Ruvuma,TZ10,Namtumbo,TZ1005,Mgombasi,TZ1005121,9996 ,4830 ,5166 ,9996 ,4830 ,0 ,0 ,0 ,5166 
United Republic of Tanzania,Jamhuri ya Muungano wa Tanzania,TZ,Ruvuma,TZ10,Namtumbo,TZ1005,Litola,TZ1005131,10752 ,5207 ,5545 ,10752 ,5207 ,0 ,0 ,0 ,5545 
United Republic of Tanzania,Jamhuri ya Muungano wa Tanzania,TZ,Ruvuma,TZ10,Namtumbo,TZ1005,Likuyuseka,TZ1005141,10811 ,5452 ,5359 ,10811 ,5452 ,0 ,0 ,0 ,5359 
United Republic of Tanzania,Jamhuri ya Muungano wa Tanzania,TZ,Ruvuma,TZ10,Namtumbo,TZ1005,Mputa,TZ1005151,11117 ,5427 ,5690 ,11117 ,5427 ,0 ,0 ,0 ,5690 
United Republic of Tanzania,Jamhuri ya Muungano wa Tanzania,TZ,Ruvuma,TZ10,Namtumbo,TZ1005,Hanga,TZ1005163,14218 ,6998 ,7220 ,7671 ,3767 ,6547 ,3231 ,3316 ,3904 
United Republic of Tanzania,Jamhuri ya Muungano wa Tanzania,TZ,Ruvuma,TZ10,Namtumbo,TZ1005,Limamu,TZ1005171,6288 ,3106 ,3182 ,6288 ,3106 ,0 ,0 ,0 ,3182 
United Republic of Tanzania,Jamhuri ya Muungano wa Tanzania,TZ,Ruvuma,TZ10,Namtumbo,TZ1005,Mchomoro,TZ1005181,10171 ,4955 ,5216 ,10171 ,4955 ,0 ,0 ,0 ,5216 
United Republic of Tanzania,Jamhuri ya Muungano wa Tanzania,TZ,Ruvuma,TZ10,Nyasa,TZ1006,Liparamba,TZ1006011,9673 ,4868 ,4805 ,9673 ,4868 ,0 ,0 ,0 ,4805 
United Republic of Tanzania,Jamhuri ya Muungano wa Tanzania,TZ,Ruvuma,TZ10,Nyasa,TZ1006,Tingi,TZ1006021,23028 ,11711 ,11317 ,23028 ,11711 ,0 ,0 ,0 ,11317 
United Republic of Tanzania,Jamhuri ya Muungano wa Tanzania,TZ,Ruvuma,TZ10,Nyasa,TZ1006,Chiwanda,TZ1006031,7084 ,3421 ,3663 ,7084 ,3421 ,0 ,0 ,0 ,3663 
United Republic of Tanzania,Jamhuri ya Muungano wa Tanzania,TZ,Ruvuma,TZ10,Nyasa,TZ1006,Mtipwili,TZ1006041,7102 ,3361 ,3741 ,7102 ,3361 ,0 ,0 ,0 ,3741 
United Republic of Tanzania,Jamhuri ya Muungano wa Tanzania,TZ,Ruvuma,TZ10,Nyasa,TZ1006,Kingerikiti,TZ1006051,15875 ,7680 ,8195 ,15875 ,7680 ,0 ,0 ,0 ,8195 
United Republic of Tanzania,Jamhuri ya Muungano wa Tanzania,TZ,Ruvuma,TZ10,Nyasa,TZ1006,Luhangarasi,TZ1006061,7970 ,3811 ,4159 ,7970 ,3811 ,0 ,0 ,0 ,4159 
United Republic of Tanzania,Jamhuri ya Muungano wa Tanzania,TZ,Ruvuma,TZ10,Nyasa,TZ1006,Kilosa,TZ1006071,7816 ,3764 ,4052 ,7816 ,3764 ,0 ,0 ,0 ,4052 
United Republic of Tanzania,Jamhuri ya Muungano wa Tanzania,TZ,Ruvuma,TZ10,Nyasa,TZ1006,Mbambabay,TZ1006083,10066 ,4811 ,5255 ,5339 ,2588 ,4727 ,2223 ,2504 ,2751 
United Republic of Tanzania,Jamhuri ya Muungano wa Tanzania,TZ,Ruvuma,TZ10,Nyasa,TZ1006,Lipingo,TZ1006091,8945 ,4379 ,4566 ,8945 ,4379 ,0 ,0 ,0 ,4566 
United Republic of Tanzania,Jamhuri ya Muungano wa Tanzania,TZ,Ruvuma,TZ10,Nyasa,TZ1006,Liuli,TZ1006103,12611 ,6058 ,6553 ,9372 ,4531 ,3239 ,1527 ,1712 ,4841 
United Republic of Tanzania,Jamhuri ya Muungano wa Tanzania,TZ,Ruvuma,TZ10,Nyasa,TZ1006,Kihagara,TZ1006111,10321 ,4998 ,5323 ,10321 ,4998 ,0 ,0 ,0 ,5323 
United Republic of Tanzania,Jamhuri ya Muungano wa Tanzania,TZ,Ruvuma,TZ10,Nyasa,TZ1006,Ngumbo,TZ1006121,3933 ,1921 ,2012 ,3933 ,1921 ,0 ,0 ,0 ,2012 
United Republic of Tanzania,Jamhuri ya Muungano wa Tanzania,TZ,Ruvuma,TZ10,Nyasa,TZ1006,Liwundi,TZ1006131,4906 ,2453 ,2453 ,4906 ,2453 ,0 ,0 ,0 ,2453 
United Republic of Tanzania,Jamhuri ya Muungano wa Tanzania,TZ,Ruvuma,TZ10,Nyasa,TZ1006,Mbaha,TZ1006141,6972 ,3406 ,3566 ,6972 ,3406 ,0 ,0 ,0 ,3566 
United Republic of Tanzania,Jamhuri ya Muungano wa Tanzania,TZ,Ruvuma,TZ10,Nyasa,TZ1006,Lituhi,TZ1006151,9858 ,4750 ,5108 ,9858 ,4750 ,0 ,0 ,0 ,5108 
United Republic of Tanzania,Jamhuri ya Muungano wa Tanzania,TZ,Iringa,TZ11,Iringa,TZ1101,Kalenga,TZ1101013,6963 ,3175 ,3788 ,3546 ,1675 ,3417 ,1500 ,1917 ,1871 
United Republic of Tanzania,Jamhuri ya Muungano wa Tanzania,TZ,Iringa,TZ11,Iringa,TZ1101,Kiwere,TZ1101021,9776 ,4747 ,5029 ,9776 ,4747 ,0 ,0 ,0 ,5029 
United Republic of Tanzania,Jamhuri ya Muungano wa Tanzania,TZ,Iringa,TZ11,Iringa,TZ1101,Nzihi,TZ1101031,14872 ,7025 ,7847 ,14872 ,7025 ,0 ,0 ,0 ,7847 
United Republic of Tanzania,Jamhuri ya Muungano wa Tanzania,TZ,Iringa,TZ11,Iringa,TZ1101,Ulanda,TZ1101041,9257 ,4384 ,4873 ,9257 ,4384 ,0 ,0 ,0 ,4873 
United Republic of Tanzania,Jamhuri ya Muungano wa Tanzania,TZ,Iringa,TZ11,Iringa,TZ1101,Mseke,TZ1101053,15868 ,7565 ,8303 ,10260 ,4908 ,5608 ,2657 ,2951 ,5352 
United Republic of Tanzania,Jamhuri ya Muungano wa Tanzania,TZ,Iringa,TZ11,Iringa,TZ1101,Maguliwa,TZ1101061,13639 ,6663 ,6976 ,13639 ,6663 ,0 ,0 ,0 ,6976 
United Republic of Tanzania,Jamhuri ya Muungano wa Tanzania,TZ,Iringa,TZ11,Iringa,TZ1101,Mgama,TZ1101071,12561 ,5943 ,6618 ,12561 ,5943 ,0 ,0 ,0 ,6618 
United Republic of Tanzania,Jamhuri ya Muungano wa Tanzania,TZ,Iringa,TZ11,Iringa,TZ1101,Ifunda,TZ1101083,12199 ,5795 ,6404 ,10253 ,4891 ,1946 ,904 ,1042 ,5362 
United Republic of Tanzania,Jamhuri ya Muungano wa Tanzania,TZ,Iringa,TZ11,Iringa,TZ1101,Lumuli,TZ1101091,7852 ,3808 ,4044 ,7852 ,3808 ,0 ,0 ,0 ,4044 
United Republic of Tanzania,Jamhuri ya Muungano wa Tanzania,TZ,Iringa,TZ11,Iringa,TZ1101,Maboga,TZ1101101,12642 ,6161 ,6481 ,12642 ,6161 ,0 ,0 ,0 ,6481 
United Republic of Tanzania,Jamhuri ya Muungano wa Tanzania,TZ,Iringa,TZ11,Iringa,TZ1101,Wasa,TZ1101111,10595 ,5095 ,5500 ,10595 ,5095 ,0 ,0 ,0 ,5500 
United Republic of Tanzania,Jamhuri ya Muungano wa Tanzania,TZ,Iringa,TZ11,Iringa,TZ1101,Mahuninga,TZ1101121,4331 ,2128 ,2203 ,4331 ,2128 ,0 ,0 ,0 ,2203 
United Republic of Tanzania,Jamhuri ya Muungano wa Tanzania,TZ,Iringa,TZ11,Iringa,TZ1101,Idodi,TZ1101131,10202 ,5128 ,5074 ,10202 ,5128 ,0 ,0 ,0 ,5074 
United Republic of Tanzania,Jamhuri ya Muungano wa Tanzania,TZ,Iringa,TZ11,Iringa,TZ1101,Mlowa,TZ1101141,9483 ,4690 ,4793 ,9483 ,4690 ,0 ,0 ,0 ,4793 
United Republic of Tanzania,Jamhuri ya Muungano wa Tanzania,TZ,Iringa,TZ11,Iringa,TZ1101,Itunundu,TZ1101151,14420 ,7187 ,7233 ,14420 ,7187 ,0 ,0 ,0 ,7233 
United Republic of Tanzania,Jamhuri ya Muungano wa Tanzania,TZ,Iringa,TZ11,Iringa,TZ1101,Ilolo Mpya,TZ1101161,6376 ,3099 ,3277 ,6376 ,3099 ,0 ,0 ,0 ,3277 
United Republic of Tanzania,Jamhuri ya Muungano wa Tanzania,TZ,Iringa,TZ11,Iringa,TZ1101,Nduli,TZ1101171,8045 ,3881 ,4164 ,8045 ,3881 ,0 ,0 ,0 ,4164 
United Republic of Tanzania,Jamhuri ya Muungano wa Tanzania,TZ,Iringa,TZ11,Iringa,TZ1101,Kihorogota,TZ1101181,7688 ,3800 ,3888 ,7688 ,3800 ,0 ,0 ,0 ,3888 
United Republic of Tanzania,Jamhuri ya Muungano wa Tanzania,TZ,Iringa,TZ11,Iringa,TZ1101,Izazi,TZ1101191,5281 ,2608 ,2673 ,5281 ,2608 ,0 ,0 ,0 ,2673 
United Republic of Tanzania,Jamhuri ya Muungano wa Tanzania,TZ,Iringa,TZ11,Iringa,TZ1101,Malenga Makali,TZ1101201,7917 ,3925 ,3992 ,7917 ,3925 ,0 ,0 ,0 ,3992 
United Republic of Tanzania,Jamhuri ya Muungano wa Tanzania,TZ,Iringa,TZ11,Iringa,TZ1101,Nyang'oro,TZ1101211,9810 ,4866 ,4944 ,9810 ,4866 ,0 ,0 ,0 ,4944 
United Republic of Tanzania,Jamhuri ya Muungano wa Tanzania,TZ,Iringa,TZ11,Iringa,TZ1101,Luhota,TZ1101221,9568 ,4510 ,5058 ,9568 ,4510 ,0 ,0 ,0 ,5058 
United Republic of Tanzania,Jamhuri ya Muungano wa Tanzania,TZ,Iringa,TZ11,Iringa,TZ1101,Lyamgungwe,TZ1101231,9836 ,4688 ,5148 ,9836 ,4688 ,0 ,0 ,0 ,5148 
United Republic of Tanzania,Jamhuri ya Muungano wa Tanzania,TZ,Iringa,TZ11,Iringa,TZ1101,Mlenge,TZ1101241,9463 ,4686 ,4777 ,9463 ,4686 ,0 ,0 ,0 ,4777 
United Republic of Tanzania,Jamhuri ya Muungano wa Tanzania,TZ,Iringa,TZ11,Iringa,TZ1101,Migoli,TZ1101253,10937 ,5556 ,5381 ,4753 ,2476 ,6184 ,3080 ,3104 ,2277 
United Republic of Tanzania,Jamhuri ya Muungano wa Tanzania,TZ,Iringa,TZ11,Mufindi,TZ1102,Kiyowela,TZ1102011,7540 ,3696 ,3844 ,7540 ,3696 ,0 ,0 ,0 ,3844 
United Republic of Tanzania,Jamhuri ya Muungano wa Tanzania,TZ,Iringa,TZ11,Mufindi,TZ1102,Makungu,TZ1102023,12751 ,6360 ,6391 ,6870 ,3398 ,5881 ,2962 ,2919 ,3472 
United Republic of Tanzania,Jamhuri ya Muungano wa Tanzania,TZ,Iringa,TZ11,Mufindi,TZ1102,Mninga,TZ1102031,14799 ,7017 ,7782 ,14799 ,7017 ,0 ,0 ,0 ,7782 
United Republic of Tanzania,Jamhuri ya Muungano wa Tanzania,TZ,Iringa,TZ11,Mufindi,TZ1102,Kasanga,TZ1102041,7908 ,3648 ,4260 ,7908 ,3648 ,0 ,0 ,0 ,4260 
United Republic of Tanzania,Jamhuri ya Muungano wa Tanzania,TZ,Iringa,TZ11,Mufindi,TZ1102,Igowole,TZ1102053,13459 ,6399 ,7060 ,5289 ,2549 ,8170 ,3850 ,4320 ,2740 
United Republic of Tanzania,Jamhuri ya Muungano wa Tanzania,TZ,Iringa,TZ11,Mufindi,TZ1102,Mtambula,TZ1102061,10477 ,4869 ,5608 ,10477 ,4869 ,0 ,0 ,0 ,5608 
United Republic of Tanzania,Jamhuri ya Muungano wa Tanzania,TZ,Iringa,TZ11,Mufindi,TZ1102,Itandula,TZ1102071,11866 ,5427 ,6439 ,11866 ,5427 ,0 ,0 ,0 ,6439 
United Republic of Tanzania,Jamhuri ya Muungano wa Tanzania,TZ,Iringa,TZ11,Mufindi,TZ1102,Mbalamaziwa,TZ1102081,8021 ,3736 ,4285 ,8021 ,3736 ,0 ,0 ,0 ,4285 
United Republic of Tanzania,Jamhuri ya Muungano wa Tanzania,TZ,Iringa,TZ11,Mufindi,TZ1102,Idunda,TZ1102091,6110 ,2924 ,3186 ,6110 ,2924 ,0 ,0 ,0 ,3186 
United Republic of Tanzania,Jamhuri ya Muungano wa Tanzania,TZ,Iringa,TZ11,Mufindi,TZ1102,Malangali,TZ1102103,5849 ,2765 ,3084 ,4299 ,2037 ,1550 ,728 ,822 ,2262 
United Republic of Tanzania,Jamhuri ya Muungano wa Tanzania,TZ,Iringa,TZ11,Mufindi,TZ1102,Nyololo,TZ1102113,11979 ,5643 ,6336 ,7914 ,3697 ,4065 ,1946 ,2119 ,4217 
United Republic of Tanzania,Jamhuri ya Muungano wa Tanzania,TZ,Iringa,TZ11,Mufindi,TZ1102,Ihowanza,TZ1102121,10756 ,5070 ,5686 ,10756 ,5070 ,0 ,0 ,0 ,5686 
United Republic of Tanzania,Jamhuri ya Muungano wa Tanzania,TZ,Iringa,TZ11,Mufindi,TZ1102,Ikweha,TZ1102131,8213 ,3982 ,4231 ,8213 ,3982 ,0 ,0 ,0 ,4231 
United Republic of Tanzania,Jamhuri ya Muungano wa Tanzania,TZ,Iringa,TZ11,Mufindi,TZ1102,Sadani,TZ1102141,8585 ,4111 ,4474 ,8585 ,4111 ,0 ,0 ,0 ,4474 
United Republic of Tanzania,Jamhuri ya Muungano wa Tanzania,TZ,Iringa,TZ11,Mufindi,TZ1102,Igombavanu,TZ1102151,7101 ,3395 ,3706 ,7101 ,3395 ,0 ,0 ,0 ,3706 
United Republic of Tanzania,Jamhuri ya Muungano wa Tanzania,TZ,Iringa,TZ11,Mufindi,TZ1102,Bumilayinga,TZ1102161,6136 ,3008 ,3128 ,6136 ,3008 ,0 ,0 ,0 ,3128 
United Republic of Tanzania,Jamhuri ya Muungano wa Tanzania,TZ,Iringa,TZ11,Mufindi,TZ1102,Mtwango,TZ1102173,17073 ,8008 ,9065 ,12580 ,5939 ,4493 ,2069 ,2424 ,6641 
United Republic of Tanzania,Jamhuri ya Muungano wa Tanzania,TZ,Iringa,TZ11,Mufindi,TZ1102,Isalavanu,TZ1102181,7483 ,3570 ,3913 ,7483 ,3570 ,0 ,0 ,0 ,3913 
United Republic of Tanzania,Jamhuri ya Muungano wa Tanzania,TZ,Iringa,TZ11,Mufindi,TZ1102,Rungemba,TZ1102191,6120 ,2819 ,3301 ,6120 ,2819 ,0 ,0 ,0 ,3301 
United Republic of Tanzania,Jamhuri ya Muungano wa Tanzania,TZ,Iringa,TZ11,Mufindi,TZ1102,Ifwagi,TZ1102201,16722 ,8088 ,8634 ,16722 ,8088 ,0 ,0 ,0 ,8634 
United Republic of Tanzania,Jamhuri ya Muungano wa Tanzania,TZ,Iringa,TZ11,Mufindi,TZ1102,Mdabulo,TZ1102211,9342 ,4410 ,4932 ,9342 ,4410 ,0 ,0 ,0 ,4932 
United Republic of Tanzania,Jamhuri ya Muungano wa Tanzania,TZ,Iringa,TZ11,Mufindi,TZ1102,Ihalimba,TZ1102221,11205 ,5277 ,5928 ,11205 ,5277 ,0 ,0 ,0 ,5928 
United Republic of Tanzania,Jamhuri ya Muungano wa Tanzania,TZ,Iringa,TZ11,Mufindi,TZ1102,Kibengu,TZ1102231,15806 ,7284 ,8522 ,15806 ,7284 ,0 ,0 ,0 ,8522 
United Republic of Tanzania,Jamhuri ya Muungano wa Tanzania,TZ,Iringa,TZ11,Mufindi,TZ1102,Mapanda,TZ1102241,11693 ,5504 ,6189 ,11693 ,5504 ,0 ,0 ,0 ,6189 
United Republic of Tanzania,Jamhuri ya Muungano wa Tanzania,TZ,Iringa,TZ11,Mufindi,TZ1102,Mpanga,TZ1102251,727 ,406 ,321 ,727 ,406 ,0 ,0 ,0 ,321 
United Republic of Tanzania,Jamhuri ya Muungano wa Tanzania,TZ,Iringa,TZ11,Mufindi,TZ1102,Ihanu,TZ1102261,8540 ,3970 ,4570 ,8540 ,3970 ,0 ,0 ,0 ,4570 
United Republic of Tanzania,Jamhuri ya Muungano wa Tanzania,TZ,Iringa,TZ11,Mufindi,TZ1102,Luhanga,TZ1102271,14019 ,6640 ,7379 ,14019 ,6640 ,0 ,0 ,0 ,7379 
United Republic of Tanzania,Jamhuri ya Muungano wa Tanzania,TZ,Iringa,TZ11,Iringa Urban,TZ1103,Kihesa,TZ1103012,18196 ,8528 ,9668 ,0 ,0 ,18196 ,8528 ,9668 ,0 
United Republic of Tanzania,Jamhuri ya Muungano wa Tanzania,TZ,Iringa,TZ11,Iringa Urban,TZ1103,Mtwivila,TZ1103022,21017 ,9768 ,11249 ,0 ,0 ,21017 ,9768 ,11249 ,0 
United Republic of Tanzania,Jamhuri ya Muungano wa Tanzania,TZ,Iringa,TZ11,Iringa Urban,TZ1103,Gangilonga,TZ1103032,9599 ,4730 ,4869 ,0 ,0 ,9599 ,4730 ,4869 ,0 
United Republic of Tanzania,Jamhuri ya Muungano wa Tanzania,TZ,Iringa,TZ11,Iringa Urban,TZ1103,Kitanzini,TZ1103042,3617 ,1790 ,1827 ,0 ,0 ,3617 ,1790 ,1827 ,0 
United Republic of Tanzania,Jamhuri ya Muungano wa Tanzania,TZ,Iringa,TZ11,Iringa Urban,TZ1103,Ruaha,TZ1103052,16984 ,7918 ,9066 ,0 ,0 ,16984 ,7918 ,9066 ,0 
United Republic of Tanzania,Jamhuri ya Muungano wa Tanzania,TZ,Iringa,TZ11,Iringa Urban,TZ1103,Mshindo,TZ1103062,1892 ,852 ,1040 ,0 ,0 ,1892 ,852 ,1040 ,0 
United Republic of Tanzania,Jamhuri ya Muungano wa Tanzania,TZ,Iringa,TZ11,Iringa Urban,TZ1103,Mivinjeni,TZ1103072,4780 ,2265 ,2515 ,0 ,0 ,4780 ,2265 ,2515 ,0 
United Republic of Tanzania,Jamhuri ya Muungano wa Tanzania,TZ,Iringa,TZ11,Iringa Urban,TZ1103,Mlandege,TZ1103082,4640 ,2200 ,2440 ,0 ,0 ,4640 ,2200 ,2440 ,0 
United Republic of Tanzania,Jamhuri ya Muungano wa Tanzania,TZ,Iringa,TZ11,Iringa Urban,TZ1103,Mwangata,TZ1103092,13486 ,6421 ,7065 ,0 ,0 ,13486 ,6421 ,7065 ,0 
United Republic of Tanzania,Jamhuri ya Muungano wa Tanzania,TZ,Iringa,TZ11,Iringa Urban,TZ1103,Kwakilosa,TZ1103102,7948 ,3785 ,4163 ,0 ,0 ,7948 ,3785 ,4163 ,0 
United Republic of Tanzania,Jamhuri ya Muungano wa Tanzania,TZ,Iringa,TZ11,Iringa Urban,TZ1103,Makorongoni,TZ1103112,7790 ,3634 ,4156 ,0 ,0 ,7790 ,3634 ,4156 ,0 
United Republic of Tanzania,Jamhuri ya Muungano wa Tanzania,TZ,Iringa,TZ11,Iringa Urban,TZ1103,Ilala,TZ1103122,4448 ,2110 ,2338 ,0 ,0 ,4448 ,2110 ,2338 ,0 
United Republic of Tanzania,Jamhuri ya Muungano wa Tanzania,TZ,Iringa,TZ11,Iringa Urban,TZ1103,Mkwawa,TZ1103132,9673 ,4623 ,5050 ,0 ,0 ,9673 ,4623 ,5050 ,0 
United Republic of Tanzania,Jamhuri ya Muungano wa Tanzania,TZ,Iringa,TZ11,Iringa Urban,TZ1103,Kitwiru,TZ1103142,11461 ,5512 ,5949 ,0 ,0 ,11461 ,5512 ,5949 ,0 
United Republic of Tanzania,Jamhuri ya Muungano wa Tanzania,TZ,Iringa,TZ11,Iringa Urban,TZ1103,Isakalilo,TZ1103152,9188 ,4549 ,4639 ,0 ,0 ,9188 ,4549 ,4639 ,0 
United Republic of Tanzania,Jamhuri ya Muungano wa Tanzania,TZ,Iringa,TZ11,Iringa Urban,TZ1103,Nduli,TZ1103162,6626 ,3247 ,3379 ,0 ,0 ,6626 ,3247 ,3379 ,0 
United Republic of Tanzania,Jamhuri ya Muungano wa Tanzania,TZ,Iringa,TZ11,Kilolo,TZ1104,Image,TZ1104011,9180 ,4404 ,4776 ,9180 ,4404 ,0 ,0 ,0 ,4776 
United Republic of Tanzania,Jamhuri ya Muungano wa Tanzania,TZ,Iringa,TZ11,Kilolo,TZ1104,Irole,TZ1104021,12146 ,5734 ,6412 ,12146 ,5734 ,0 ,0 ,0 ,6412 
United Republic of Tanzania,Jamhuri ya Muungano wa Tanzania,TZ,Iringa,TZ11,Kilolo,TZ1104,Ilula,TZ1104033,11109 ,5264 ,5845 ,6477 ,3116 ,4632 ,2148 ,2484 ,3361 
United Republic of Tanzania,Jamhuri ya Muungano wa Tanzania,TZ,Iringa,TZ11,Kilolo,TZ1104,Uhambingeto,TZ1104041,10327 ,5100 ,5227 ,10327 ,5100 ,0 ,0 ,0 ,5227 
United Republic of Tanzania,Jamhuri ya Muungano wa Tanzania,TZ,Iringa,TZ11,Kilolo,TZ1104,Udekwa,TZ1104051,5803 ,2949 ,2854 ,5803 ,2949 ,0 ,0 ,0 ,2854 
United Republic of Tanzania,Jamhuri ya Muungano wa Tanzania,TZ,Iringa,TZ11,Kilolo,TZ1104,Mahenge,TZ1104061,10039 ,5074 ,4965 ,10039 ,5074 ,0 ,0 ,0 ,4965 
United Republic of Tanzania,Jamhuri ya Muungano wa Tanzania,TZ,Iringa,TZ11,Kilolo,TZ1104,Mtitu,TZ1104071,11328 ,5558 ,5770 ,11328 ,5558 ,0 ,0 ,0 ,5770 
United Republic of Tanzania,Jamhuri ya Muungano wa Tanzania,TZ,Iringa,TZ11,Kilolo,TZ1104,Dabaga,TZ1104081,7787 ,3700 ,4087 ,7787 ,3700 ,0 ,0 ,0 ,4087 
United Republic of Tanzania,Jamhuri ya Muungano wa Tanzania,TZ,Iringa,TZ11,Kilolo,TZ1104,Ukumbi,TZ1104091,12912 ,6352 ,6560 ,12912 ,6352 ,0 ,0 ,0 ,6560 
United Republic of Tanzania,Jamhuri ya Muungano wa Tanzania,TZ,Iringa,TZ11,Kilolo,TZ1104,Ukwega,TZ1104101,12195 ,5913 ,6282 ,12195 ,5913 ,0 ,0 ,0 ,6282 
United Republic of Tanzania,Jamhuri ya Muungano wa Tanzania,TZ,Iringa,TZ11,Kilolo,TZ1104,Boma la Ng'ombe,TZ1104111,11313 ,5358 ,5955 ,11313 ,5358 ,0 ,0 ,0 ,5955 
United Republic of Tanzania,Jamhuri ya Muungano wa Tanzania,TZ,Iringa,TZ11,Kilolo,TZ1104,Idete,TZ1104121,8059 ,3791 ,4268 ,8059 ,3791 ,0 ,0 ,0 ,4268 
United Republic of Tanzania,Jamhuri ya Muungano wa Tanzania,TZ,Iringa,TZ11,Kilolo,TZ1104,Masisiwe,TZ1104131,10053 ,4729 ,5324 ,10053 ,4729 ,0 ,0 ,0 ,5324 
United Republic of Tanzania,Jamhuri ya Muungano wa Tanzania,TZ,Iringa,TZ11,Kilolo,TZ1104,Ng'uruhe,TZ1104141,11012 ,5339 ,5673 ,11012 ,5339 ,0 ,0 ,0 ,5673 
United Republic of Tanzania,Jamhuri ya Muungano wa Tanzania,TZ,Iringa,TZ11,Kilolo,TZ1104,Ng'ang'ange,TZ1104151,4123 ,1942 ,2181 ,4123 ,1942 ,0 ,0 ,0 ,2181 
United Republic of Tanzania,Jamhuri ya Muungano wa Tanzania,TZ,Iringa,TZ11,Kilolo,TZ1104,Ihimbo,TZ1104161,10212 ,4978 ,5234 ,10212 ,4978 ,0 ,0 ,0 ,5234 
United Republic of Tanzania,Jamhuri ya Muungano wa Tanzania,TZ,Iringa,TZ11,Kilolo,TZ1104,Lugalo,TZ1104171,12359 ,6004 ,6355 ,12359 ,6004 ,0 ,0 ,0 ,6355 
United Republic of Tanzania,Jamhuri ya Muungano wa Tanzania,TZ,Iringa,TZ11,Kilolo,TZ1104,Nyalumbu,TZ1104183,15306 ,7406 ,7900 ,8151 ,3995 ,7155 ,3411 ,3744 ,4156 
United Republic of Tanzania,Jamhuri ya Muungano wa Tanzania,TZ,Iringa,TZ11,Kilolo,TZ1104,Mlafu,TZ1104191,6386 ,3190 ,3196 ,6386 ,3190 ,0 ,0 ,0 ,3196 
United Republic of Tanzania,Jamhuri ya Muungano wa Tanzania,TZ,Iringa,TZ11,Kilolo,TZ1104,Ibumu,TZ1104201,6681 ,3252 ,3429 ,6681 ,3252 ,0 ,0 ,0 ,3429 
United Republic of Tanzania,Jamhuri ya Muungano wa Tanzania,TZ,Iringa,TZ11,Kilolo,TZ1104,Ruaha Mbuyuni,TZ1104211,12151 ,6144 ,6007 ,12151 ,6144 ,0 ,0 ,0 ,6007 
United Republic of Tanzania,Jamhuri ya Muungano wa Tanzania,TZ,Iringa,TZ11,Kilolo,TZ1104,Kimala,TZ1104221,7649 ,3675 ,3974 ,7649 ,3675 ,0 ,0 ,0 ,3974 
United Republic of Tanzania,Jamhuri ya Muungano wa Tanzania,TZ,Iringa,TZ11,Mafinga Township Authority,TZ1105,Sao Hill,TZ1105012,12765 ,6668 ,6097 ,0 ,0 ,12765 ,6668 ,6097 ,0 
United Republic of Tanzania,Jamhuri ya Muungano wa Tanzania,TZ,Iringa,TZ11,Mafinga Township Authority,TZ1105,Boma,TZ1105022,21723 ,10241 ,11482 ,0 ,0 ,21723 ,10241 ,11482 ,0 
United Republic of Tanzania,Jamhuri ya Muungano wa Tanzania,TZ,Iringa,TZ11,Mafinga Township Authority,TZ1105,Kinyanambo,TZ1105032,17414 ,8216 ,9198 ,0 ,0 ,17414 ,8216 ,9198 ,0 
United Republic of Tanzania,Jamhuri ya Muungano wa Tanzania,TZ,Mbeya,TZ12,Chunya,TZ1201,Kambikatoto,TZ1201011,7091 ,3585 ,3506 ,7091 ,3585 ,0 ,0 ,0 ,3506 
United Republic of Tanzania,Jamhuri ya Muungano wa Tanzania,TZ,Mbeya,TZ12,Chunya,TZ1201,Mafyeko,TZ1201021,9409 ,4916 ,4493 ,9409 ,4916 ,0 ,0 ,0 ,4493 
United Republic of Tanzania,Jamhuri ya Muungano wa Tanzania,TZ,Mbeya,TZ12,Chunya,TZ1201,Matwiga,TZ1201031,8939 ,4688 ,4251 ,8939 ,4688 ,0 ,0 ,0 ,4251 
United Republic of Tanzania,Jamhuri ya Muungano wa Tanzania,TZ,Mbeya,TZ12,Chunya,TZ1201,Mtanila,TZ1201041,8711 ,4437 ,4274 ,8711 ,4437 ,0 ,0 ,0 ,4274 
United Republic of Tanzania,Jamhuri ya Muungano wa Tanzania,TZ,Mbeya,TZ12,Chunya,TZ1201,Lupatingatinga,TZ1201051,12835 ,6626 ,6209 ,12835 ,6626 ,0 ,0 ,0 ,6209 
United Republic of Tanzania,Jamhuri ya Muungano wa Tanzania,TZ,Mbeya,TZ12,Chunya,TZ1201,Luwalaje,TZ1201061,4305 ,2260 ,2045 ,4305 ,2260 ,0 ,0 ,0 ,2045 
United Republic of Tanzania,Jamhuri ya Muungano wa Tanzania,TZ,Mbeya,TZ12,Chunya,TZ1201,Sangambi,TZ1201071,9772 ,5082 ,4690 ,9772 ,5082 ,0 ,0 ,0 ,4690 
United Republic of Tanzania,Jamhuri ya Muungano wa Tanzania,TZ,Mbeya,TZ12,Chunya,TZ1201,Itewe,TZ1201083,8341 ,4136 ,4205 ,4932 ,2489 ,3409 ,1647 ,1762 ,2443 
United Republic of Tanzania,Jamhuri ya Muungano wa Tanzania,TZ,Mbeya,TZ12,Chunya,TZ1201,Chokaa,TZ1201093,15227 ,7538 ,7689 ,2389 ,1213 ,12838 ,6325 ,6513 ,1176 
United Republic of Tanzania,Jamhuri ya Muungano wa Tanzania,TZ,Mbeya,TZ12,Chunya,TZ1201,Mbugani,TZ1201101,8734 ,4270 ,4464 ,8734 ,4270 ,0 ,0 ,0 ,4464 
United Republic of Tanzania,Jamhuri ya Muungano wa Tanzania,TZ,Mbeya,TZ12,Chunya,TZ1201,Chalangwa,TZ1201111,8013 ,3982 ,4031 ,8013 ,3982 ,0 ,0 ,0 ,4031 
United Republic of Tanzania,Jamhuri ya Muungano wa Tanzania,TZ,Mbeya,TZ12,Chunya,TZ1201,Ifumbo,TZ1201121,6541 ,3206 ,3335 ,6541 ,3206 ,0 ,0 ,0 ,3335 
United Republic of Tanzania,Jamhuri ya Muungano wa Tanzania,TZ,Mbeya,TZ12,Chunya,TZ1201,Mamba,TZ1201231,15462 ,7764 ,7698 ,15462 ,7764 ,0 ,0 ,0 ,7698 
United Republic of Tanzania,Jamhuri ya Muungano wa Tanzania,TZ,Mbeya,TZ12,Chunya,TZ1201,Mkola,TZ1201282,5813 ,2978 ,2835 ,0 ,0 ,5813 ,2978 ,2835 ,0 
United Republic of Tanzania,Jamhuri ya Muungano wa Tanzania,TZ,Mbeya,TZ12,Chunya,TZ1201,Makongorosi,TZ1201292,18116 ,8975 ,9141 ,0 ,0 ,18116 ,8975 ,9141 ,0 
United Republic of Tanzania,Jamhuri ya Muungano wa Tanzania,TZ,Mbeya,TZ12,Chunya,TZ1201,Matundasi,TZ1201302,9477 ,4888 ,4589 ,0 ,0 ,9477 ,4888 ,4589 ,0 
United Republic of Tanzania,Jamhuri ya Muungano wa Tanzania,TZ,Mbeya,TZ12,Mbeya,TZ1202,Ihango,TZ1202011,8342 ,3903 ,4439 ,8342 ,3903 ,0 ,0 ,0 ,4439 
United Republic of Tanzania,Jamhuri ya Muungano wa Tanzania,TZ,Mbeya,TZ12,Mbeya,TZ1202,Ulenje,TZ1202021,6946 ,3273 ,3673 ,6946 ,3273 ,0 ,0 ,0 ,3673 
United Republic of Tanzania,Jamhuri ya Muungano wa Tanzania,TZ,Mbeya,TZ12,Mbeya,TZ1202,Tembela,TZ1202033,10710 ,4982 ,5728 ,8496 ,3995 ,2214 ,987 ,1227 ,4501 
United Republic of Tanzania,Jamhuri ya Muungano wa Tanzania,TZ,Mbeya,TZ12,Mbeya,TZ1202,Ijombe,TZ1202041,10185 ,4756 ,5429 ,10185 ,4756 ,0 ,0 ,0 ,5429 
United Republic of Tanzania,Jamhuri ya Muungano wa Tanzania,TZ,Mbeya,TZ12,Mbeya,TZ1202,Santilya,TZ1202051,17578 ,8099 ,9479 ,17578 ,8099 ,0 ,0 ,0 ,9479 
United Republic of Tanzania,Jamhuri ya Muungano wa Tanzania,TZ,Mbeya,TZ12,Mbeya,TZ1202,Ilembo,TZ1202061,17391 ,8113 ,9278 ,17391 ,8113 ,0 ,0 ,0 ,9278 
United Republic of Tanzania,Jamhuri ya Muungano wa Tanzania,TZ,Mbeya,TZ12,Mbeya,TZ1202,Iwiji,TZ1202071,15056 ,7167 ,7889 ,15056 ,7167 ,0 ,0 ,0 ,7889 
United Republic of Tanzania,Jamhuri ya Muungano wa Tanzania,TZ,Mbeya,TZ12,Mbeya,TZ1202,Isuto,TZ1202081,13958 ,6648 ,7310 ,13958 ,6648 ,0 ,0 ,0 ,7310 
United Republic of Tanzania,Jamhuri ya Muungano wa Tanzania,TZ,Mbeya,TZ12,Mbeya,TZ1202,Igale,TZ1202091,10864 ,5183 ,5681 ,10864 ,5183 ,0 ,0 ,0 ,5681 
United Republic of Tanzania,Jamhuri ya Muungano wa Tanzania,TZ,Mbeya,TZ12,Mbeya,TZ1202,Iwindi,TZ1202101,18397 ,8740 ,9657 ,18397 ,8740 ,0 ,0 ,0 ,9657 
United Republic of Tanzania,Jamhuri ya Muungano wa Tanzania,TZ,Mbeya,TZ12,Mbeya,TZ1202,Utengule Usongwe,TZ1202113,41952 ,19706 ,22246 ,10166 ,4898 ,31786 ,14808 ,16978 ,5268 
United Republic of Tanzania,Jamhuri ya Muungano wa Tanzania,TZ,Mbeya,TZ12,Mbeya,TZ1202,Mshewe,TZ1202121,11241 ,5506 ,5735 ,11241 ,5506 ,0 ,0 ,0 ,5735 
United Republic of Tanzania,Jamhuri ya Muungano wa Tanzania,TZ,Mbeya,TZ12,Mbeya,TZ1202,Ikukwa,TZ1202131,6024 ,2858 ,3166 ,6024 ,2858 ,0 ,0 ,0 ,3166 
United Republic of Tanzania,Jamhuri ya Muungano wa Tanzania,TZ,Mbeya,TZ12,Mbeya,TZ1202,Iyunga Mapinduzi,TZ1202141,7377 ,3466 ,3911 ,7377 ,3466 ,0 ,0 ,0 ,3911 
United Republic of Tanzania,Jamhuri ya Muungano wa Tanzania,TZ,Mbeya,TZ12,Mbeya,TZ1202,Bonde la Songwe,TZ1202153,18487 ,8733 ,9754 ,12174 ,5668 ,6313 ,3065 ,3248 ,6506 
United Republic of Tanzania,Jamhuri ya Muungano wa Tanzania,TZ,Mbeya,TZ12,Mbeya,TZ1202,Inyala,TZ1202161,10544 ,5041 ,5503 ,10544 ,5041 ,0 ,0 ,0 ,5503 
United Republic of Tanzania,Jamhuri ya Muungano wa Tanzania,TZ,Mbeya,TZ12,Mbeya,TZ1202,Ilungu,TZ1202171,12095 ,5791 ,6304 ,12095 ,5791 ,0 ,0 ,0 ,6304 
United Republic of Tanzania,Jamhuri ya Muungano wa Tanzania,TZ,Mbeya,TZ12,Mbeya,TZ1202,Maendeleo,TZ1202181,5223 ,2421 ,2802 ,5223 ,2421 ,0 ,0 ,0 ,2802 
United Republic of Tanzania,Jamhuri ya Muungano wa Tanzania,TZ,Mbeya,TZ12,Mbeya,TZ1202,Swaya,TZ1202191,9477 ,4434 ,5043 ,9477 ,4434 ,0 ,0 ,0 ,5043 
United Republic of Tanzania,Jamhuri ya Muungano wa Tanzania,TZ,Mbeya,TZ12,Mbeya,TZ1202,Masoko,TZ1202201,7682 ,3563 ,4119 ,7682 ,3563 ,0 ,0 ,0 ,4119 
United Republic of Tanzania,Jamhuri ya Muungano wa Tanzania,TZ,Mbeya,TZ12,Mbeya,TZ1202,Itawa,TZ1202211,11156 ,5002 ,6154 ,11156 ,5002 ,0 ,0 ,0 ,6154 
United Republic of Tanzania,Jamhuri ya Muungano wa Tanzania,TZ,Mbeya,TZ12,Mbeya,TZ1202,Nsalala,TZ1202223,19346 ,9143 ,10203 ,1529 ,698 ,17817 ,8445 ,9372 ,831 
United Republic of Tanzania,Jamhuri ya Muungano wa Tanzania,TZ,Mbeya,TZ12,Mbeya,TZ1202,Lwanjiro,TZ1202231,4323 ,2141 ,2182 ,4323 ,2141 ,0 ,0 ,0 ,2182 
United Republic of Tanzania,Jamhuri ya Muungano wa Tanzania,TZ,Mbeya,TZ12,Mbeya,TZ1202,Itewe,TZ1202241,4655 ,2183 ,2472 ,4655 ,2183 ,0 ,0 ,0 ,2472 
United Republic of Tanzania,Jamhuri ya Muungano wa Tanzania,TZ,Mbeya,TZ12,Mbeya,TZ1202,Igoma,TZ1202253,6310 ,2927 ,3383 ,2737 ,1252 ,3573 ,1675 ,1898 ,1485 
United Republic of Tanzania,Jamhuri ya Muungano wa Tanzania,TZ,Mbeya,TZ12,Kyela,TZ1203,Lusungo,TZ1203011,6354 ,3054 ,3300 ,6354 ,3054 ,0 ,0 ,0 ,3300 
United Republic of Tanzania,Jamhuri ya Muungano wa Tanzania,TZ,Mbeya,TZ12,Kyela,TZ1203,Makwale,TZ1203021,12654 ,6000 ,6654 ,12654 ,6000 ,0 ,0 ,0 ,6654 
United Republic of Tanzania,Jamhuri ya Muungano wa Tanzania,TZ,Mbeya,TZ12,Kyela,TZ1203,Matema,TZ1203031,17103 ,8145 ,8958 ,17103 ,8145 ,0 ,0 ,0 ,8958 
United Republic of Tanzania,Jamhuri ya Muungano wa Tanzania,TZ,Mbeya,TZ12,Kyela,TZ1203,Mwaya,TZ1203041,11651 ,5608 ,6043 ,11651 ,5608 ,0 ,0 ,0 ,6043 
United Republic of Tanzania,Jamhuri ya Muungano wa Tanzania,TZ,Mbeya,TZ12,Kyela,TZ1203,Ndobo,TZ1203051,6684 ,3137 ,3547 ,6684 ,3137 ,0 ,0 ,0 ,3547 
United Republic of Tanzania,Jamhuri ya Muungano wa Tanzania,TZ,Mbeya,TZ12,Kyela,TZ1203,Kajunjumele,TZ1203061,8240 ,4042 ,4198 ,8240 ,4042 ,0 ,0 ,0 ,4198 
United Republic of Tanzania,Jamhuri ya Muungano wa Tanzania,TZ,Mbeya,TZ12,Kyela,TZ1203,Bujonde,TZ1203071,7528 ,3614 ,3914 ,7528 ,3614 ,0 ,0 ,0 ,3914 
United Republic of Tanzania,Jamhuri ya Muungano wa Tanzania,TZ,Mbeya,TZ12,Kyela,TZ1203,Ikolo,TZ1203081,5140 ,2448 ,2692 ,5140 ,2448 ,0 ,0 ,0 ,2692 
United Republic of Tanzania,Jamhuri ya Muungano wa Tanzania,TZ,Mbeya,TZ12,Kyela,TZ1203,Katumbasongwe,TZ1203091,13895 ,6743 ,7152 ,13895 ,6743 ,0 ,0 ,0 ,7152 
United Republic of Tanzania,Jamhuri ya Muungano wa Tanzania,TZ,Mbeya,TZ12,Kyela,TZ1203,Ngana,TZ1203101,7944 ,3808 ,4136 ,7944 ,3808 ,0 ,0 ,0 ,4136 
United Republic of Tanzania,Jamhuri ya Muungano wa Tanzania,TZ,Mbeya,TZ12,Kyela,TZ1203,Busale,TZ1203111,9246 ,4381 ,4865 ,9246 ,4381 ,0 ,0 ,0 ,4865 
United Republic of Tanzania,Jamhuri ya Muungano wa Tanzania,TZ,Mbeya,TZ12,Kyela,TZ1203,Ipande,TZ1203121,8081 ,3945 ,4136 ,8081 ,3945 ,0 ,0 ,0 ,4136 
United Republic of Tanzania,Jamhuri ya Muungano wa Tanzania,TZ,Mbeya,TZ12,Kyela,TZ1203,Ikama,TZ1203131,4724 ,2259 ,2465 ,4724 ,2259 ,0 ,0 ,0 ,2465 
United Republic of Tanzania,Jamhuri ya Muungano wa Tanzania,TZ,Mbeya,TZ12,Kyela,TZ1203,Ipinda,TZ1203143,20847 ,9934 ,10913 ,13246 ,6331 ,7601 ,3603 ,3998 ,6915 
United Republic of Tanzania,Jamhuri ya Muungano wa Tanzania,TZ,Mbeya,TZ12,Kyela,TZ1203,Ngonga,TZ1203151,8310 ,4045 ,4265 ,8310 ,4045 ,0 ,0 ,0 ,4265 
United Republic of Tanzania,Jamhuri ya Muungano wa Tanzania,TZ,Mbeya,TZ12,Kyela,TZ1203,Ikimba,TZ1203161,10583 ,5010 ,5573 ,10583 ,5010 ,0 ,0 ,0 ,5573 
United Republic of Tanzania,Jamhuri ya Muungano wa Tanzania,TZ,Mbeya,TZ12,Kyela,TZ1203,Itope,TZ1203171,6717 ,3224 ,3493 ,6717 ,3224 ,0 ,0 ,0 ,3493 
United Republic of Tanzania,Jamhuri ya Muungano wa Tanzania,TZ,Mbeya,TZ12,Kyela,TZ1203,Muungano,TZ1203181,3278 ,1513 ,1765 ,3278 ,1513 ,0 ,0 ,0 ,1765 
United Republic of Tanzania,Jamhuri ya Muungano wa Tanzania,TZ,Mbeya,TZ12,Kyela,TZ1203,Talatala,TZ1203191,5122 ,2459 ,2663 ,5122 ,2459 ,0 ,0 ,0 ,2663 
United Republic of Tanzania,Jamhuri ya Muungano wa Tanzania,TZ,Mbeya,TZ12,Kyela,TZ1203,Kyela,TZ1203202,47389 ,22643 ,24746 ,0 ,0 ,47389 ,22643 ,24746 ,0 
United Republic of Tanzania,Jamhuri ya Muungano wa Tanzania,TZ,Mbeya,TZ12,Rungwe,TZ1204,Swaya,TZ1204011,7555 ,3482 ,4073 ,7555 ,3482 ,0 ,0 ,0 ,4073 
United Republic of Tanzania,Jamhuri ya Muungano wa Tanzania,TZ,Mbeya,TZ12,Rungwe,TZ1204,Masebe,TZ1204021,4967 ,2339 ,2628 ,4967 ,2339 ,0 ,0 ,0 ,2628 
United Republic of Tanzania,Jamhuri ya Muungano wa Tanzania,TZ,Mbeya,TZ12,Rungwe,TZ1204,Suma,TZ1204031,6256 ,3027 ,3229 ,6256 ,3027 ,0 ,0 ,0 ,3229 
United Republic of Tanzania,Jamhuri ya Muungano wa Tanzania,TZ,Mbeya,TZ12,Rungwe,TZ1204,Kandete,TZ1204043,10284 ,4811 ,5473 ,10284 ,4811 ,0 ,0 ,0 ,5473 
United Republic of Tanzania,Jamhuri ya Muungano wa Tanzania,TZ,Mbeya,TZ12,Rungwe,TZ1204,Luteba,TZ1204051,7111 ,3270 ,3841 ,7111 ,3270 ,0 ,0 ,0 ,3841 
United Republic of Tanzania,Jamhuri ya Muungano wa Tanzania,TZ,Mbeya,TZ12,Rungwe,TZ1204,Mpombo,TZ1204061,8787 ,4136 ,4651 ,8787 ,4136 ,0 ,0 ,0 ,4651 
United Republic of Tanzania,Jamhuri ya Muungano wa Tanzania,TZ,Mbeya,TZ12,Rungwe,TZ1204,Isange,TZ1204071,5790 ,2768 ,3022 ,5790 ,2768 ,0 ,0 ,0 ,3022 
United Republic of Tanzania,Jamhuri ya Muungano wa Tanzania,TZ,Mbeya,TZ12,Rungwe,TZ1204,Kabula,TZ1204081,10271 ,5036 ,5235 ,10271 ,5036 ,0 ,0 ,0 ,5235 
United Republic of Tanzania,Jamhuri ya Muungano wa Tanzania,TZ,Mbeya,TZ12,Rungwe,TZ1204,Lwangwa,TZ1204091,10668 ,5073 ,5595 ,10668 ,5073 ,0 ,0 ,0 ,5595 
United Republic of Tanzania,Jamhuri ya Muungano wa Tanzania,TZ,Mbeya,TZ12,Rungwe,TZ1204,Lufilyo,TZ1204101,6370 ,3015 ,3355 ,6370 ,3015 ,0 ,0 ,0 ,3355 
United Republic of Tanzania,Jamhuri ya Muungano wa Tanzania,TZ,Mbeya,TZ12,Rungwe,TZ1204,Itete,TZ1204111,9869 ,4670 ,5199 ,9869 ,4670 ,0 ,0 ,0 ,5199 
United Republic of Tanzania,Jamhuri ya Muungano wa Tanzania,TZ,Mbeya,TZ12,Rungwe,TZ1204,Kisegese,TZ1204121,5511 ,2670 ,2841 ,5511 ,2670 ,0 ,0 ,0 ,2841 
United Republic of Tanzania,Jamhuri ya Muungano wa Tanzania,TZ,Mbeya,TZ12,Rungwe,TZ1204,Lupata,TZ1204131,9090 ,4383 ,4707 ,9090 ,4383 ,0 ,0 ,0 ,4707 
United Republic of Tanzania,Jamhuri ya Muungano wa Tanzania,TZ,Mbeya,TZ12,Rungwe,TZ1204,Kambasegela,TZ1204141,12597 ,5907 ,6690 ,12597 ,5907 ,0 ,0 ,0 ,6690 
United Republic of Tanzania,Jamhuri ya Muungano wa Tanzania,TZ,Mbeya,TZ12,Rungwe,TZ1204,Masukulu,TZ1204151,5795 ,2722 ,3073 ,5795 ,2722 ,0 ,0 ,0 ,3073 
United Republic of Tanzania,Jamhuri ya Muungano wa Tanzania,TZ,Mbeya,TZ12,Rungwe,TZ1204,Kisiba,TZ1204161,6629 ,3198 ,3431 ,6629 ,3198 ,0 ,0 ,0 ,3431 
United Republic of Tanzania,Jamhuri ya Muungano wa Tanzania,TZ,Mbeya,TZ12,Rungwe,TZ1204,Masoko,TZ1204171,6136 ,2948 ,3188 ,6136 ,2948 ,0 ,0 ,0 ,3188 
United Republic of Tanzania,Jamhuri ya Muungano wa Tanzania,TZ,Mbeya,TZ12,Rungwe,TZ1204,Bujela,TZ1204181,5579 ,2606 ,2973 ,5579 ,2606 ,0 ,0 ,0 ,2973 
United Republic of Tanzania,Jamhuri ya Muungano wa Tanzania,TZ,Mbeya,TZ12,Rungwe,TZ1204,Ilima,TZ1204191,6737 ,3074 ,3663 ,6737 ,3074 ,0 ,0 ,0 ,3663 
United Republic of Tanzania,Jamhuri ya Muungano wa Tanzania,TZ,Mbeya,TZ12,Rungwe,TZ1204,Kisondela,TZ1204201,11070 ,5308 ,5762 ,11070 ,5308 ,0 ,0 ,0 ,5762 
United Republic of Tanzania,Jamhuri ya Muungano wa Tanzania,TZ,Mbeya,TZ12,Rungwe,TZ1204,Ikuti,TZ1204211,13035 ,6351 ,6684 ,13035 ,6351 ,0 ,0 ,0 ,6684 
United Republic of Tanzania,Jamhuri ya Muungano wa Tanzania,TZ,Mbeya,TZ12,Rungwe,TZ1204,Malindo,TZ1204221,5960 ,2927 ,3033 ,5960 ,2927 ,0 ,0 ,0 ,3033 
United Republic of Tanzania,Jamhuri ya Muungano wa Tanzania,TZ,Mbeya,TZ12,Rungwe,TZ1204,Mpuguso,TZ1204231,13969 ,6616 ,7353 ,13969 ,6616 ,0 ,0 ,0 ,7353 
United Republic of Tanzania,Jamhuri ya Muungano wa Tanzania,TZ,Mbeya,TZ12,Rungwe,TZ1204,Kikole,TZ1204241,3303 ,1591 ,1712 ,3303 ,1591 ,0 ,0 ,0 ,1712 
United Republic of Tanzania,Jamhuri ya Muungano wa Tanzania,TZ,Mbeya,TZ12,Rungwe,TZ1204,Lufingo,TZ1204251,17166 ,8145 ,9021 ,17166 ,8145 ,0 ,0 ,0 ,9021 
United Republic of Tanzania,Jamhuri ya Muungano wa Tanzania,TZ,Mbeya,TZ12,Rungwe,TZ1204,Nkunga,TZ1204261,16139 ,7987 ,8152 ,16139 ,7987 ,0 ,0 ,0 ,8152 
United Republic of Tanzania,Jamhuri ya Muungano wa Tanzania,TZ,Mbeya,TZ12,Rungwe,TZ1204,Kyimo,TZ1204271,14033 ,6712 ,7321 ,14033 ,6712 ,0 ,0 ,0 ,7321 
United Republic of Tanzania,Jamhuri ya Muungano wa Tanzania,TZ,Mbeya,TZ12,Rungwe,TZ1204,Kinyala,TZ1204281,12871 ,6186 ,6685 ,12871 ,6186 ,0 ,0 ,0 ,6685 
United Republic of Tanzania,Jamhuri ya Muungano wa Tanzania,TZ,Mbeya,TZ12,Rungwe,TZ1204,Kiwira,TZ1204293,25244 ,11936 ,13308 ,16699 ,7972 ,8545 ,3964 ,4581 ,8727 
United Republic of Tanzania,Jamhuri ya Muungano wa Tanzania,TZ,Mbeya,TZ12,Rungwe,TZ1204,Isongole,TZ1204301,18689 ,8642 ,10047 ,18689 ,8642 ,0 ,0 ,0 ,10047 
United Republic of Tanzania,Jamhuri ya Muungano wa Tanzania,TZ,Mbeya,TZ12,Rungwe,TZ1204,Ikama,TZ1204312,3766 ,1804 ,1962 ,0 ,0 ,3766 ,1804 ,1962 ,0 
United Republic of Tanzania,Jamhuri ya Muungano wa Tanzania,TZ,Mbeya,TZ12,Rungwe,TZ1204,Ibighi,TZ1204322,8899 ,4207 ,4692 ,0 ,0 ,8899 ,4207 ,4692 ,0 
United Republic of Tanzania,Jamhuri ya Muungano wa Tanzania,TZ,Mbeya,TZ12,Rungwe,TZ1204,Bagamoyo,TZ1204332,3207 ,1501 ,1706 ,0 ,0 ,3207 ,1501 ,1706 ,0 
United Republic of Tanzania,Jamhuri ya Muungano wa Tanzania,TZ,Mbeya,TZ12,Rungwe,TZ1204,Kawetele,TZ1204342,5506 ,2614 ,2892 ,0 ,0 ,5506 ,2614 ,2892 ,0 
United Republic of Tanzania,Jamhuri ya Muungano wa Tanzania,TZ,Mbeya,TZ12,Rungwe,TZ1204,Bulyaga,TZ1204352,6393 ,2996 ,3397 ,0 ,0 ,6393 ,2996 ,3397 ,0 
United Republic of Tanzania,Jamhuri ya Muungano wa Tanzania,TZ,Mbeya,TZ12,Rungwe,TZ1204,Msasani,TZ1204362,6292 ,3054 ,3238 ,0 ,0 ,6292 ,3054 ,3238 ,0 
United Republic of Tanzania,Jamhuri ya Muungano wa Tanzania,TZ,Mbeya,TZ12,Rungwe,TZ1204,Makandana,TZ1204372,7613 ,3537 ,4076 ,0 ,0 ,7613 ,3537 ,4076 ,0 
United Republic of Tanzania,Jamhuri ya Muungano wa Tanzania,TZ,Mbeya,TZ12,Mbarali,TZ1207,Luhanga,TZ1207011,11466 ,5612 ,5854 ,11466 ,5612 ,0 ,0 ,0 ,5854 
United Republic of Tanzania,Jamhuri ya Muungano wa Tanzania,TZ,Mbeya,TZ12,Mbarali,TZ1207,Madibira,TZ1207023,24742 ,12103 ,12639 ,17846 ,8656 ,6896 ,3447 ,3449 ,9190 
United Republic of Tanzania,Jamhuri ya Muungano wa Tanzania,TZ,Mbeya,TZ12,Mbarali,TZ1207,Mawindi,TZ1207031,9917 ,4825 ,5092 ,9917 ,4825 ,0 ,0 ,0 ,5092 
United Republic of Tanzania,Jamhuri ya Muungano wa Tanzania,TZ,Mbeya,TZ12,Mbarali,TZ1207,Ihahi,TZ1207043,8474 ,4124 ,4350 ,5655 ,2780 ,2819 ,1344 ,1475 ,2875 
United Republic of Tanzania,Jamhuri ya Muungano wa Tanzania,TZ,Mbeya,TZ12,Mbarali,TZ1207,Mapogoro,TZ1207051,24754 ,12059 ,12695 ,24754 ,12059 ,0 ,0 ,0 ,12695 
United Republic of Tanzania,Jamhuri ya Muungano wa Tanzania,TZ,Mbeya,TZ12,Mbarali,TZ1207,Chimala,TZ1207063,16633 ,7734 ,8899 ,11987 ,5524 ,4646 ,2210 ,2436 ,6463 
United Republic of Tanzania,Jamhuri ya Muungano wa Tanzania,TZ,Mbeya,TZ12,Mbarali,TZ1207,Utengule Usangu,TZ1207071,15407 ,7239 ,8168 ,15407 ,7239 ,0 ,0 ,0 ,8168 
United Republic of Tanzania,Jamhuri ya Muungano wa Tanzania,TZ,Mbeya,TZ12,Mbarali,TZ1207,Ruiwa,TZ1207081,15867 ,7765 ,8102 ,15867 ,7765 ,0 ,0 ,0 ,8102 
United Republic of Tanzania,Jamhuri ya Muungano wa Tanzania,TZ,Mbeya,TZ12,Mbarali,TZ1207,Mahongole,TZ1207091,11744 ,5676 ,6068 ,11744 ,5676 ,0 ,0 ,0 ,6068 
United Republic of Tanzania,Jamhuri ya Muungano wa Tanzania,TZ,Mbeya,TZ12,Mbarali,TZ1207,Ubaruku,TZ1207103,29197 ,14257 ,14940 ,949 ,505 ,28248 ,13752 ,14496 ,444 
United Republic of Tanzania,Jamhuri ya Muungano wa Tanzania,TZ,Mbeya,TZ12,Mbarali,TZ1207,Igurusi,TZ1207113,22296 ,10734 ,11562 ,18322 ,8860 ,3974 ,1874 ,2100 ,9462 
United Republic of Tanzania,Jamhuri ya Muungano wa Tanzania,TZ,Mbeya,TZ12,Mbarali,TZ1207,Kongolo,TZ1207121,10309 ,5058 ,5251 ,10309 ,5058 ,0 ,0 ,0 ,5251 
United Republic of Tanzania,Jamhuri ya Muungano wa Tanzania,TZ,Mbeya,TZ12,Mbarali,TZ1207,Mwatenga,TZ1207131,8416 ,4109 ,4307 ,8416 ,4109 ,0 ,0 ,0 ,4307 
United Republic of Tanzania,Jamhuri ya Muungano wa Tanzania,TZ,Mbeya,TZ12,Mbarali,TZ1207,Imalilosongwe,TZ1207141,11268 ,5545 ,5723 ,11268 ,5545 ,0 ,0 ,0 ,5723 
United Republic of Tanzania,Jamhuri ya Muungano wa Tanzania,TZ,Mbeya,TZ12,Mbarali,TZ1207,Igava,TZ1207151,14292 ,6879 ,7413 ,14292 ,6879 ,0 ,0 ,0 ,7413 
United Republic of Tanzania,Jamhuri ya Muungano wa Tanzania,TZ,Mbeya,TZ12,Mbarali,TZ1207,Ipwani,TZ1207161,8503 ,4143 ,4360 ,8503 ,4143 ,0 ,0 ,0 ,4360 
United Republic of Tanzania,Jamhuri ya Muungano wa Tanzania,TZ,Mbeya,TZ12,Mbarali,TZ1207,Itambaleo,TZ1207171,9313 ,4641 ,4672 ,9313 ,4641 ,0 ,0 ,0 ,4672 
United Republic of Tanzania,Jamhuri ya Muungano wa Tanzania,TZ,Mbeya,TZ12,Mbarali,TZ1207,Miyombweni,TZ1207181,9773 ,4861 ,4912 ,9773 ,4861 ,0 ,0 ,0 ,4912 
United Republic of Tanzania,Jamhuri ya Muungano wa Tanzania,TZ,Mbeya,TZ12,Mbarali,TZ1207,Rujewa,TZ1207192,29473 ,14241 ,15232 ,0 ,0 ,29473 ,14241 ,15232 ,0 
United Republic of Tanzania,Jamhuri ya Muungano wa Tanzania,TZ,Mbeya,TZ12,Mbarali,TZ1207,Lugelele,TZ1207202,8673 ,4262 ,4411 ,0 ,0 ,8673 ,4262 ,4411 ,0 
United Republic of Tanzania,Jamhuri ya Muungano wa Tanzania,TZ,Mbeya,TZ12,Mbeya Urban,TZ1208,Sisimba,TZ1208012,4112 ,2043 ,2069 ,0 ,0 ,4112 ,2043 ,2069 ,0 
United Republic of Tanzania,Jamhuri ya Muungano wa Tanzania,TZ,Mbeya,TZ12,Mbeya Urban,TZ1208,Isanga,TZ1208022,11307 ,5434 ,5873 ,0 ,0 ,11307 ,5434 ,5873 ,0 
United Republic of Tanzania,Jamhuri ya Muungano wa Tanzania,TZ,Mbeya,TZ12,Mbeya Urban,TZ1208,Iganzo,TZ1208032,14414 ,6896 ,7518 ,0 ,0 ,14414 ,6896 ,7518 ,0 
United Republic of Tanzania,Jamhuri ya Muungano wa Tanzania,TZ,Mbeya,TZ12,Mbeya Urban,TZ1208,Mwansekwa,TZ1208042,1803 ,878 ,925 ,0 ,0 ,1803 ,878 ,925 ,0 
United Republic of Tanzania,Jamhuri ya Muungano wa Tanzania,TZ,Mbeya,TZ12,Mbeya Urban,TZ1208,Itagano,TZ1208052,1751 ,790 ,961 ,0 ,0 ,1751 ,790 ,961 ,0 
United Republic of Tanzania,Jamhuri ya Muungano wa Tanzania,TZ,Mbeya,TZ12,Mbeya Urban,TZ1208,Itezi,TZ1208062,18445 ,8634 ,9811 ,0 ,0 ,18445 ,8634 ,9811 ,0 
United Republic of Tanzania,Jamhuri ya Muungano wa Tanzania,TZ,Mbeya,TZ12,Mbeya Urban,TZ1208,Nsalaga,TZ1208072,18993 ,8975 ,10018 ,0 ,0 ,18993 ,8975 ,10018 ,0 
United Republic of Tanzania,Jamhuri ya Muungano wa Tanzania,TZ,Mbeya,TZ12,Mbeya Urban,TZ1208,Igawilo,TZ1208082,17300 ,7931 ,9369 ,0 ,0 ,17300 ,7931 ,9369 ,0 
United Republic of Tanzania,Jamhuri ya Muungano wa Tanzania,TZ,Mbeya,TZ12,Mbeya Urban,TZ1208,Iganjo,TZ1208092,8697 ,4134 ,4563 ,0 ,0 ,8697 ,4134 ,4563 ,0 
United Republic of Tanzania,Jamhuri ya Muungano wa Tanzania,TZ,Mbeya,TZ12,Mbeya Urban,TZ1208,Uyole,TZ1208102,11543 ,5344 ,6199 ,0 ,0 ,11543 ,5344 ,6199 ,0 
United Republic of Tanzania,Jamhuri ya Muungano wa Tanzania,TZ,Mbeya,TZ12,Mbeya Urban,TZ1208,Iduda,TZ1208112,4157 ,1961 ,2196 ,0 ,0 ,4157 ,1961 ,2196 ,0 
United Republic of Tanzania,Jamhuri ya Muungano wa Tanzania,TZ,Mbeya,TZ12,Mbeya Urban,TZ1208,Mwasanga,TZ1208122,945 ,440 ,505 ,0 ,0 ,945 ,440 ,505 ,0 
United Republic of Tanzania,Jamhuri ya Muungano wa Tanzania,TZ,Mbeya,TZ12,Mbeya Urban,TZ1208,Tembela,TZ1208132,2334 ,1135 ,1199 ,0 ,0 ,2334 ,1135 ,1199 ,0 
United Republic of Tanzania,Jamhuri ya Muungano wa Tanzania,TZ,Mbeya,TZ12,Mbeya Urban,TZ1208,Ilomba,TZ1208142,34021 ,16001 ,18020 ,0 ,0 ,34021 ,16001 ,18020 ,0 
United Republic of Tanzania,Jamhuri ya Muungano wa Tanzania,TZ,Mbeya,TZ12,Mbeya Urban,TZ1208,Mwakibete,TZ1208152,23319 ,11094 ,12225 ,0 ,0 ,23319 ,11094 ,12225 ,0 
United Republic of Tanzania,Jamhuri ya Muungano wa Tanzania,TZ,Mbeya,TZ12,Mbeya Urban,TZ1208,Ilemi,TZ1208162,26841 ,12845 ,13996 ,0 ,0 ,26841 ,12845 ,13996 ,0 
United Republic of Tanzania,Jamhuri ya Muungano wa Tanzania,TZ,Mbeya,TZ12,Mbeya Urban,TZ1208,Isyesye,TZ1208172,7970 ,3662 ,4308 ,0 ,0 ,7970 ,3662 ,4308 ,0 
United Republic of Tanzania,Jamhuri ya Muungano wa Tanzania,TZ,Mbeya,TZ12,Mbeya Urban,TZ1208,Ruanda,TZ1208182,21927 ,10198 ,11729 ,0 ,0 ,21927 ,10198 ,11729 ,0 
United Republic of Tanzania,Jamhuri ya Muungano wa Tanzania,TZ,Mbeya,TZ12,Mbeya Urban,TZ1208,Iyela,TZ1208192,31634 ,15174 ,16460 ,0 ,0 ,31634 ,15174 ,16460 ,0 
United Republic of Tanzania,Jamhuri ya Muungano wa Tanzania,TZ,Mbeya,TZ12,Mbeya Urban,TZ1208,Sinde,TZ1208202,7014 ,3355 ,3659 ,0 ,0 ,7014 ,3355 ,3659 ,0 
United Republic of Tanzania,Jamhuri ya Muungano wa Tanzania,TZ,Mbeya,TZ12,Mbeya Urban,TZ1208,Maanga,TZ1208212,6881 ,3185 ,3696 ,0 ,0 ,6881 ,3185 ,3696 ,0 
United Republic of Tanzania,Jamhuri ya Muungano wa Tanzania,TZ,Mbeya,TZ12,Mbeya Urban,TZ1208,Mbalizi RD,TZ1208222,6045 ,3318 ,2727 ,0 ,0 ,6045 ,3318 ,2727 ,0 
United Republic of Tanzania,Jamhuri ya Muungano wa Tanzania,TZ,Mbeya,TZ12,Mbeya Urban,TZ1208,Forest,TZ1208232,6649 ,3036 ,3613 ,0 ,0 ,6649 ,3036 ,3613 ,0 
United Republic of Tanzania,Jamhuri ya Muungano wa Tanzania,TZ,Mbeya,TZ12,Mbeya Urban,TZ1208,Mabatini,TZ1208242,7415 ,3511 ,3904 ,0 ,0 ,7415 ,3511 ,3904 ,0 
United Republic of Tanzania,Jamhuri ya Muungano wa Tanzania,TZ,Mbeya,TZ12,Mbeya Urban,TZ1208,Nzovwe,TZ1208252,22898 ,10823 ,12075 ,0 ,0 ,22898 ,10823 ,12075 ,0 
United Republic of Tanzania,Jamhuri ya Muungano wa Tanzania,TZ,Mbeya,TZ12,Mbeya Urban,TZ1208,Kalobe,TZ1208262,13180 ,6185 ,6995 ,0 ,0 ,13180 ,6185 ,6995 ,0 
United Republic of Tanzania,Jamhuri ya Muungano wa Tanzania,TZ,Mbeya,TZ12,Mbeya Urban,TZ1208,Iyunga,TZ1208272,15026 ,7188 ,7838 ,0 ,0 ,15026 ,7188 ,7838 ,0 
United Republic of Tanzania,Jamhuri ya Muungano wa Tanzania,TZ,Mbeya,TZ12,Mbeya Urban,TZ1208,Iwambi,TZ1208282,12387 ,6005 ,6382 ,0 ,0 ,12387 ,6005 ,6382 ,0 
United Republic of Tanzania,Jamhuri ya Muungano wa Tanzania,TZ,Mbeya,TZ12,Mbeya Urban,TZ1208,Itende,TZ1208292,3490 ,1788 ,1702 ,0 ,0 ,3490 ,1788 ,1702 ,0 
United Republic of Tanzania,Jamhuri ya Muungano wa Tanzania,TZ,Mbeya,TZ12,Mbeya Urban,TZ1208,Iziwa,TZ1208302,3176 ,1442 ,1734 ,0 ,0 ,3176 ,1442 ,1734 ,0 
United Republic of Tanzania,Jamhuri ya Muungano wa Tanzania,TZ,Mbeya,TZ12,Mbeya Urban,TZ1208,Nsoho,TZ1208312,1819 ,876 ,943 ,0 ,0 ,1819 ,876 ,943 ,0 
United Republic of Tanzania,Jamhuri ya Muungano wa Tanzania,TZ,Mbeya,TZ12,Mbeya Urban,TZ1208,Majengo,TZ1208322,3314 ,1563 ,1751 ,0 ,0 ,3314 ,1563 ,1751 ,0 
United Republic of Tanzania,Jamhuri ya Muungano wa Tanzania,TZ,Mbeya,TZ12,Mbeya Urban,TZ1208,Ghana,TZ1208332,4885 ,2267 ,2618 ,0 ,0 ,4885 ,2267 ,2618 ,0 
United Republic of Tanzania,Jamhuri ya Muungano wa Tanzania,TZ,Mbeya,TZ12,Mbeya Urban,TZ1208,Nonde,TZ1208342,2488 ,1188 ,1300 ,0 ,0 ,2488 ,1188 ,1300 ,0 
United Republic of Tanzania,Jamhuri ya Muungano wa Tanzania,TZ,Mbeya,TZ12,Mbeya Urban,TZ1208,Itiji,TZ1208352,4231 ,1976 ,2255 ,0 ,0 ,4231 ,1976 ,2255 ,0 
United Republic of Tanzania,Jamhuri ya Muungano wa Tanzania,TZ,Mbeya,TZ12,Mbeya Urban,TZ1208,Maendeleo,TZ1208362,2868 ,1345 ,1523 ,0 ,0 ,2868 ,1345 ,1523 ,0 
United Republic of Tanzania,Jamhuri ya Muungano wa Tanzania,TZ,Singida,TZ13,Iramba,TZ1301,Urughu,TZ1301011,13380 ,6566 ,6814 ,13380 ,6566 ,0 ,0 ,0 ,6814 
United Republic of Tanzania,Jamhuri ya Muungano wa Tanzania,TZ,Singida,TZ13,Iramba,TZ1301,Mtekente,TZ1301021,16973 ,8396 ,8577 ,16973 ,8396 ,0 ,0 ,0 ,8577 
United Republic of Tanzania,Jamhuri ya Muungano wa Tanzania,TZ,Singida,TZ13,Iramba,TZ1301,Mtoa,TZ1301031,19724 ,9738 ,9986 ,19724 ,9738 ,0 ,0 ,0 ,9986 
United Republic of Tanzania,Jamhuri ya Muungano wa Tanzania,TZ,Singida,TZ13,Iramba,TZ1301,Mgongo,TZ1301041,13041 ,6377 ,6664 ,13041 ,6377 ,0 ,0 ,0 ,6664 
United Republic of Tanzania,Jamhuri ya Muungano wa Tanzania,TZ,Singida,TZ13,Iramba,TZ1301,Shelui,TZ1301053,14933 ,7417 ,7516 ,5190 ,2599 ,9743 ,4818 ,4925 ,2591 
United Republic of Tanzania,Jamhuri ya Muungano wa Tanzania,TZ,Singida,TZ13,Iramba,TZ1301,Ntwike,TZ1301061,16977 ,8461 ,8516 ,16977 ,8461 ,0 ,0 ,0 ,8516 
United Republic of Tanzania,Jamhuri ya Muungano wa Tanzania,TZ,Singida,TZ13,Iramba,TZ1301,Tulya,TZ1301071,8265 ,4370 ,3895 ,8265 ,4370 ,0 ,0 ,0 ,3895 
United Republic of Tanzania,Jamhuri ya Muungano wa Tanzania,TZ,Singida,TZ13,Iramba,TZ1301,Kidaru,TZ1301081,9727 ,4849 ,4878 ,9727 ,4849 ,0 ,0 ,0 ,4878 
United Republic of Tanzania,Jamhuri ya Muungano wa Tanzania,TZ,Singida,TZ13,Iramba,TZ1301,Kisiriri,TZ1301091,10686 ,5294 ,5392 ,10686 ,5294 ,0 ,0 ,0 ,5392 
United Republic of Tanzania,Jamhuri ya Muungano wa Tanzania,TZ,Singida,TZ13,Iramba,TZ1301,Kiomboi,TZ1301103,25375 ,12270 ,13105 ,19571 ,9618 ,5804 ,2652 ,3152 ,9953 
United Republic of Tanzania,Jamhuri ya Muungano wa Tanzania,TZ,Singida,TZ13,Iramba,TZ1301,Kinampanda,TZ1301111,14870 ,7308 ,7562 ,14870 ,7308 ,0 ,0 ,0 ,7562 
United Republic of Tanzania,Jamhuri ya Muungano wa Tanzania,TZ,Singida,TZ13,Iramba,TZ1301,Ulemo,TZ1301121,17174 ,8407 ,8767 ,17174 ,8407 ,0 ,0 ,0 ,8767 
United Republic of Tanzania,Jamhuri ya Muungano wa Tanzania,TZ,Singida,TZ13,Iramba,TZ1301,Kyengege,TZ1301131,7845 ,3902 ,3943 ,7845 ,3902 ,0 ,0 ,0 ,3943 
United Republic of Tanzania,Jamhuri ya Muungano wa Tanzania,TZ,Singida,TZ13,Iramba,TZ1301,Ndago,TZ1301143,14453 ,7195 ,7258 ,12363 ,6155 ,2090 ,1040 ,1050 ,6208 
United Republic of Tanzania,Jamhuri ya Muungano wa Tanzania,TZ,Singida,TZ13,Iramba,TZ1301,Mbelekese,TZ1301151,12678 ,6364 ,6314 ,12678 ,6364 ,0 ,0 ,0 ,6314 
United Republic of Tanzania,Jamhuri ya Muungano wa Tanzania,TZ,Singida,TZ13,Iramba,TZ1301,Kaselya,TZ1301161,9801 ,4849 ,4952 ,9801 ,4849 ,0 ,0 ,0 ,4952 
United Republic of Tanzania,Jamhuri ya Muungano wa Tanzania,TZ,Singida,TZ13,Iramba,TZ1301,Ndulungu,TZ1301171,10380 ,5234 ,5146 ,10380 ,5234 ,0 ,0 ,0 ,5146 
United Republic of Tanzania,Jamhuri ya Muungano wa Tanzania,TZ,Singida,TZ13,Singida,TZ1302,Mudida,TZ1302011,14629 ,7194 ,7435 ,14629 ,7194 ,0 ,0 ,0 ,7435 
United Republic of Tanzania,Jamhuri ya Muungano wa Tanzania,TZ,Singida,TZ13,Singida,TZ1302,Makuro,TZ1302021,17717 ,8845 ,8872 ,17717 ,8845 ,0 ,0 ,0 ,8872 
United Republic of Tanzania,Jamhuri ya Muungano wa Tanzania,TZ,Singida,TZ13,Singida,TZ1302,Ikhanoda,TZ1302031,10907 ,5468 ,5439 ,10907 ,5468 ,0 ,0 ,0 ,5439 
United Republic of Tanzania,Jamhuri ya Muungano wa Tanzania,TZ,Singida,TZ13,Singida,TZ1302,Mwasauya,TZ1302041,11032 ,5471 ,5561 ,11032 ,5471 ,0 ,0 ,0 ,5561 
United Republic of Tanzania,Jamhuri ya Muungano wa Tanzania,TZ,Singida,TZ13,Singida,TZ1302,Msange,TZ1302051,11981 ,5880 ,6101 ,11981 ,5880 ,0 ,0 ,0 ,6101 
United Republic of Tanzania,Jamhuri ya Muungano wa Tanzania,TZ,Singida,TZ13,Singida,TZ1302,Maghojoa,TZ1302061,8983 ,4475 ,4508 ,8983 ,4475 ,0 ,0 ,0 ,4508 
United Republic of Tanzania,Jamhuri ya Muungano wa Tanzania,TZ,Singida,TZ13,Singida,TZ1302,Itaja,TZ1302071,7116 ,3610 ,3506 ,7116 ,3610 ,0 ,0 ,0 ,3506 
United Republic of Tanzania,Jamhuri ya Muungano wa Tanzania,TZ,Singida,TZ13,Singida,TZ1302,Ngimu,TZ1302081,11296 ,5729 ,5567 ,11296 ,5729 ,0 ,0 ,0 ,5567 
United Republic of Tanzania,Jamhuri ya Muungano wa Tanzania,TZ,Singida,TZ13,Singida,TZ1302,Mughunga,TZ1302091,7469 ,3802 ,3667 ,7469 ,3802 ,0 ,0 ,0 ,3667 
United Republic of Tanzania,Jamhuri ya Muungano wa Tanzania,TZ,Singida,TZ13,Singida,TZ1302,Mgori,TZ1302101,8419 ,4218 ,4201 ,8419 ,4218 ,0 ,0 ,0 ,4201 
United Republic of Tanzania,Jamhuri ya Muungano wa Tanzania,TZ,Singida,TZ13,Singida,TZ1302,Mughamo,TZ1302111,7189 ,3501 ,3688 ,7189 ,3501 ,0 ,0 ,0 ,3688 
United Republic of Tanzania,Jamhuri ya Muungano wa Tanzania,TZ,Singida,TZ13,Singida,TZ1302,Kinyagigi,TZ1302121,9409 ,4717 ,4692 ,9409 ,4717 ,0 ,0 ,0 ,4692 
United Republic of Tanzania,Jamhuri ya Muungano wa Tanzania,TZ,Singida,TZ13,Singida,TZ1302,Merya,TZ1302131,8051 ,3921 ,4130 ,8051 ,3921 ,0 ,0 ,0 ,4130 
United Republic of Tanzania,Jamhuri ya Muungano wa Tanzania,TZ,Singida,TZ13,Singida,TZ1302,Kinyeto,TZ1302141,9055 ,4437 ,4618 ,9055 ,4437 ,0 ,0 ,0 ,4618 
United Republic of Tanzania,Jamhuri ya Muungano wa Tanzania,TZ,Singida,TZ13,Singida,TZ1302,Ntonge,TZ1302151,7907 ,3901 ,4006 ,7907 ,3901 ,0 ,0 ,0 ,4006 
United Republic of Tanzania,Jamhuri ya Muungano wa Tanzania,TZ,Singida,TZ13,Singida,TZ1302,Ilongero,TZ1302163,10635 ,5177 ,5458 ,7000 ,3495 ,3635 ,1682 ,1953 ,3505 
United Republic of Tanzania,Jamhuri ya Muungano wa Tanzania,TZ,Singida,TZ13,Singida,TZ1302,Mrama,TZ1302171,9347 ,4631 ,4716 ,9347 ,4631 ,0 ,0 ,0 ,4716 
United Republic of Tanzania,Jamhuri ya Muungano wa Tanzania,TZ,Singida,TZ13,Singida,TZ1302,Kijota,TZ1302181,9666 ,4793 ,4873 ,9666 ,4793 ,0 ,0 ,0 ,4873 
United Republic of Tanzania,Jamhuri ya Muungano wa Tanzania,TZ,Singida,TZ13,Singida,TZ1302,Mtinko,TZ1302191,19414 ,9596 ,9818 ,19414 ,9596 ,0 ,0 ,0 ,9818 
United Republic of Tanzania,Jamhuri ya Muungano wa Tanzania,TZ,Singida,TZ13,Singida,TZ1302,Ughandi,TZ1302201,15985 ,7820 ,8165 ,15985 ,7820 ,0 ,0 ,0 ,8165 
United Republic of Tanzania,Jamhuri ya Muungano wa Tanzania,TZ,Singida,TZ13,Singida,TZ1302,Msisi,TZ1302211,9314 ,4586 ,4728 ,9314 ,4586 ,0 ,0 ,0 ,4728 
United Republic of Tanzania,Jamhuri ya Muungano wa Tanzania,TZ,Singida,TZ13,Manyoni,TZ1303,Manyoni,TZ1303013,25505 ,12328 ,13177 ,1598 ,828 ,23907 ,11500 ,12407 ,770 
United Republic of Tanzania,Jamhuri ya Muungano wa Tanzania,TZ,Singida,TZ13,Manyoni,TZ1303,Solya,TZ1303023,4372 ,2109 ,2263 ,3106 ,1461 ,1266 ,648 ,618 ,1645 
United Republic of Tanzania,Jamhuri ya Muungano wa Tanzania,TZ,Singida,TZ13,Manyoni,TZ1303,Makuru,TZ1303031,11874 ,6080 ,5794 ,11874 ,6080 ,0 ,0 ,0 ,5794 
United Republic of Tanzania,Jamhuri ya Muungano wa Tanzania,TZ,Singida,TZ13,Manyoni,TZ1303,Chikuyu,TZ1303041,6487 ,3183 ,3304 ,6487 ,3183 ,0 ,0 ,0 ,3304 
United Republic of Tanzania,Jamhuri ya Muungano wa Tanzania,TZ,Singida,TZ13,Manyoni,TZ1303,Makanda,TZ1303051,9768 ,4634 ,5134 ,9768 ,4634 ,0 ,0 ,0 ,5134 
United Republic of Tanzania,Jamhuri ya Muungano wa Tanzania,TZ,Singida,TZ13,Manyoni,TZ1303,Kintinku,TZ1303063,8877 ,4269 ,4608 ,7088 ,3426 ,1789 ,843 ,946 ,3662 
United Republic of Tanzania,Jamhuri ya Muungano wa Tanzania,TZ,Singida,TZ13,Manyoni,TZ1303,Mvumi,TZ1303071,7873 ,3701 ,4172 ,7873 ,3701 ,0 ,0 ,0 ,4172 
United Republic of Tanzania,Jamhuri ya Muungano wa Tanzania,TZ,Singida,TZ13,Manyoni,TZ1303,Majiri,TZ1303081,11721 ,5589 ,6132 ,11721 ,5589 ,0 ,0 ,0 ,6132 
United Republic of Tanzania,Jamhuri ya Muungano wa Tanzania,TZ,Singida,TZ13,Manyoni,TZ1303,Sasajila,TZ1303091,7141 ,3470 ,3671 ,7141 ,3470 ,0 ,0 ,0 ,3671 
United Republic of Tanzania,Jamhuri ya Muungano wa Tanzania,TZ,Singida,TZ13,Manyoni,TZ1303,Idodyandole,TZ1303101,11201 ,5633 ,5568 ,11201 ,5633 ,0 ,0 ,0 ,5568 
United Republic of Tanzania,Jamhuri ya Muungano wa Tanzania,TZ,Singida,TZ13,Manyoni,TZ1303,Chikola,TZ1303111,12334 ,5933 ,6401 ,12334 ,5933 ,0 ,0 ,0 ,6401 
United Republic of Tanzania,Jamhuri ya Muungano wa Tanzania,TZ,Singida,TZ13,Manyoni,TZ1303,Heka,TZ1303121,7921 ,3820 ,4101 ,7921 ,3820 ,0 ,0 ,0 ,4101 
United Republic of Tanzania,Jamhuri ya Muungano wa Tanzania,TZ,Singida,TZ13,Manyoni,TZ1303,Nkonko,TZ1303131,11281 ,5414 ,5867 ,11281 ,5414 ,0 ,0 ,0 ,5867 
United Republic of Tanzania,Jamhuri ya Muungano wa Tanzania,TZ,Singida,TZ13,Manyoni,TZ1303,Sanza,TZ1303141,10387 ,4928 ,5459 ,10387 ,4928 ,0 ,0 ,0 ,5459 
United Republic of Tanzania,Jamhuri ya Muungano wa Tanzania,TZ,Singida,TZ13,Manyoni,TZ1303,Isseke,TZ1303151,12214 ,6023 ,6191 ,12214 ,6023 ,0 ,0 ,0 ,6191 
United Republic of Tanzania,Jamhuri ya Muungano wa Tanzania,TZ,Singida,TZ13,Manyoni,TZ1303,Rungwa,TZ1303161,2209 ,1109 ,1100 ,2209 ,1109 ,0 ,0 ,0 ,1100 
United Republic of Tanzania,Jamhuri ya Muungano wa Tanzania,TZ,Singida,TZ13,Manyoni,TZ1303,Mgandu,TZ1303171,13788 ,6963 ,6825 ,13788 ,6963 ,0 ,0 ,0 ,6825 
United Republic of Tanzania,Jamhuri ya Muungano wa Tanzania,TZ,Singida,TZ13,Manyoni,TZ1303,Itigi Mjini,TZ1303183,16187 ,7797 ,8390 ,8282 ,4029 ,7905 ,3768 ,4137 ,4253 
United Republic of Tanzania,Jamhuri ya Muungano wa Tanzania,TZ,Singida,TZ13,Manyoni,TZ1303,Ipande,TZ1303191,10040 ,5018 ,5022 ,10040 ,5018 ,0 ,0 ,0 ,5022 
United Republic of Tanzania,Jamhuri ya Muungano wa Tanzania,TZ,Singida,TZ13,Manyoni,TZ1303,Sanjaranda,TZ1303201,8828 ,4463 ,4365 ,8828 ,4463 ,0 ,0 ,0 ,4365 
United Republic of Tanzania,Jamhuri ya Muungano wa Tanzania,TZ,Singida,TZ13,Manyoni,TZ1303,Aghondi,TZ1303211,5468 ,2881 ,2587 ,5468 ,2881 ,0 ,0 ,0 ,2587 
United Republic of Tanzania,Jamhuri ya Muungano wa Tanzania,TZ,Singida,TZ13,Manyoni,TZ1303,Mkwese,TZ1303221,4726 ,2462 ,2264 ,4726 ,2462 ,0 ,0 ,0 ,2264 
United Republic of Tanzania,Jamhuri ya Muungano wa Tanzania,TZ,Singida,TZ13,Manyoni,TZ1303,Muhalala,TZ1303231,3980 ,1958 ,2022 ,3980 ,1958 ,0 ,0 ,0 ,2022 
United Republic of Tanzania,Jamhuri ya Muungano wa Tanzania,TZ,Singida,TZ13,Manyoni,TZ1303,Saranda,TZ1303241,9115 ,4546 ,4569 ,9115 ,4546 ,0 ,0 ,0 ,4569 
United Republic of Tanzania,Jamhuri ya Muungano wa Tanzania,TZ,Singida,TZ13,Manyoni,TZ1303,Makutupora,TZ1303251,6635 ,3282 ,3353 ,6635 ,3282 ,0 ,0 ,0 ,3353 
United Republic of Tanzania,Jamhuri ya Muungano wa Tanzania,TZ,Singida,TZ13,Manyoni,TZ1303,Sasilo,TZ1303261,11987 ,5867 ,6120 ,11987 ,5867 ,0 ,0 ,0 ,6120 
United Republic of Tanzania,Jamhuri ya Muungano wa Tanzania,TZ,Singida,TZ13,Manyoni,TZ1303,Mwamagembe,TZ1303271,6462 ,3226 ,3236 ,6462 ,3226 ,0 ,0 ,0 ,3236 
United Republic of Tanzania,Jamhuri ya Muungano wa Tanzania,TZ,Singida,TZ13,Manyoni,TZ1303,Mitundu,TZ1303283,23081 ,11555 ,11526 ,19877 ,9959 ,3204 ,1596 ,1608 ,9918 
United Republic of Tanzania,Jamhuri ya Muungano wa Tanzania,TZ,Singida,TZ13,Manyoni,TZ1303,Kitaraka,TZ1303291,9711 ,5070 ,4641 ,9711 ,5070 ,0 ,0 ,0 ,4641 
United Republic of Tanzania,Jamhuri ya Muungano wa Tanzania,TZ,Singida,TZ13,Manyoni,TZ1303,Itigi Majengo,TZ1303303,5590 ,2719 ,2871 ,1171 ,582 ,4419 ,2137 ,2282 ,589 
United Republic of Tanzania,Jamhuri ya Muungano wa Tanzania,TZ,Singida,TZ13,Singida Urban,TZ1304,Mtipa,TZ1304011,8351 ,4136 ,4215 ,8351 ,4136 ,0 ,0 ,0 ,4215 
United Republic of Tanzania,Jamhuri ya Muungano wa Tanzania,TZ,Singida,TZ13,Singida Urban,TZ1304,Mughanga,TZ1304022,2046 ,975 ,1071 ,0 ,0 ,2046 ,975 ,1071 ,0 
United Republic of Tanzania,Jamhuri ya Muungano wa Tanzania,TZ,Singida,TZ13,Singida Urban,TZ1304,Mitunduru,TZ1304032,10503 ,4976 ,5527 ,0 ,0 ,10503 ,4976 ,5527 ,0 
United Republic of Tanzania,Jamhuri ya Muungano wa Tanzania,TZ,Singida,TZ13,Singida Urban,TZ1304,Majengo,TZ1304042,9370 ,4469 ,4901 ,0 ,0 ,9370 ,4469 ,4901 ,0 
United Republic of Tanzania,Jamhuri ya Muungano wa Tanzania,TZ,Singida,TZ13,Singida Urban,TZ1304,Umyambwa,TZ1304051,9710 ,4870 ,4840 ,9710 ,4870 ,0 ,0 ,0 ,4840 
United Republic of Tanzania,Jamhuri ya Muungano wa Tanzania,TZ,Singida,TZ13,Singida Urban,TZ1304,Mungu maji,TZ1304061,4320 ,2276 ,2044 ,4320 ,2276 ,0 ,0 ,0 ,2044 
United Republic of Tanzania,Jamhuri ya Muungano wa Tanzania,TZ,Singida,TZ13,Singida Urban,TZ1304,Unyamikumbi,TZ1304071,12616 ,6201 ,6415 ,12616 ,6201 ,0 ,0 ,0 ,6415 
United Republic of Tanzania,Jamhuri ya Muungano wa Tanzania,TZ,Singida,TZ13,Singida Urban,TZ1304,Mtamaa,TZ1304081,6981 ,3417 ,3564 ,6981 ,3417 ,0 ,0 ,0 ,3564 
United Republic of Tanzania,Jamhuri ya Muungano wa Tanzania,TZ,Singida,TZ13,Singida Urban,TZ1304,Kindai,TZ1304092,12658 ,6050 ,6608 ,0 ,0 ,12658 ,6050 ,6608 ,0 
United Republic of Tanzania,Jamhuri ya Muungano wa Tanzania,TZ,Singida,TZ13,Singida Urban,TZ1304,Ipembe,TZ1304102,1858 ,914 ,944 ,0 ,0 ,1858 ,914 ,944 ,0 
United Republic of Tanzania,Jamhuri ya Muungano wa Tanzania,TZ,Singida,TZ13,Singida Urban,TZ1304,Utemini,TZ1304112,11269 ,5556 ,5713 ,0 ,0 ,11269 ,5556 ,5713 ,0 
United Republic of Tanzania,Jamhuri ya Muungano wa Tanzania,TZ,Singida,TZ13,Singida Urban,TZ1304,Mwankoko,TZ1304121,10548 ,5293 ,5255 ,10548 ,5293 ,0 ,0 ,0 ,5255 
United Republic of Tanzania,Jamhuri ya Muungano wa Tanzania,TZ,Singida,TZ13,Singida Urban,TZ1304,Mandewa,TZ1304131,17932 ,8833 ,9099 ,6791 ,3476 ,11141 ,5357 ,5784 ,3315 
United Republic of Tanzania,Jamhuri ya Muungano wa Tanzania,TZ,Singida,TZ13,Singida Urban,TZ1304,Minga,TZ1304142,13336 ,6351 ,6985 ,0 ,0 ,13336 ,6351 ,6985 ,0 
United Republic of Tanzania,Jamhuri ya Muungano wa Tanzania,TZ,Singida,TZ13,Singida Urban,TZ1304,Misuna,TZ1304152,13061 ,6186 ,6875 ,0 ,0 ,13061 ,6186 ,6875 ,0 
United Republic of Tanzania,Jamhuri ya Muungano wa Tanzania,TZ,Singida,TZ13,Singida Urban,TZ1304,Uhamaka,TZ1304161,6229 ,3148 ,3081 ,6229 ,3148 ,0 ,0 ,0 ,3081 
United Republic of Tanzania,Jamhuri ya Muungano wa Tanzania,TZ,Singida,TZ13,Ikungi,TZ1305,Puma,TZ1305013,9945 ,4795 ,5150 ,6771 ,3393 ,3174 ,1402 ,1772 ,3378 
United Republic of Tanzania,Jamhuri ya Muungano wa Tanzania,TZ,Singida,TZ13,Ikungi,TZ1305,Kituntu,TZ1305021,8444 ,4219 ,4225 ,8444 ,4219 ,0 ,0 ,0 ,4225 
United Republic of Tanzania,Jamhuri ya Muungano wa Tanzania,TZ,Singida,TZ13,Ikungi,TZ1305,Mungaa,TZ1305033,18276 ,8903 ,9373 ,13881 ,6919 ,4395 ,1984 ,2411 ,6962 
United Republic of Tanzania,Jamhuri ya Muungano wa Tanzania,TZ,Singida,TZ13,Ikungi,TZ1305,Siuyu,TZ1305041,7952 ,3987 ,3965 ,7952 ,3987 ,0 ,0 ,0 ,3965 
United Republic of Tanzania,Jamhuri ya Muungano wa Tanzania,TZ,Singida,TZ13,Ikungi,TZ1305,Kikio,TZ1305051,7887 ,3937 ,3950 ,7887 ,3937 ,0 ,0 ,0 ,3950 
United Republic of Tanzania,Jamhuri ya Muungano wa Tanzania,TZ,Singida,TZ13,Ikungi,TZ1305,Lighwa,TZ1305061,7245 ,3575 ,3670 ,7245 ,3575 ,0 ,0 ,0 ,3670 
United Republic of Tanzania,Jamhuri ya Muungano wa Tanzania,TZ,Singida,TZ13,Ikungi,TZ1305,Misughaa,TZ1305071,6679 ,3376 ,3303 ,6679 ,3376 ,0 ,0 ,0 ,3303 
United Republic of Tanzania,Jamhuri ya Muungano wa Tanzania,TZ,Singida,TZ13,Ikungi,TZ1305,Ntuntu,TZ1305081,11360 ,5738 ,5622 ,11360 ,5738 ,0 ,0 ,0 ,5622 
United Republic of Tanzania,Jamhuri ya Muungano wa Tanzania,TZ,Singida,TZ13,Ikungi,TZ1305,Dung'unyi,TZ1305091,10158 ,5111 ,5047 ,10158 ,5111 ,0 ,0 ,0 ,5047 
United Republic of Tanzania,Jamhuri ya Muungano wa Tanzania,TZ,Singida,TZ13,Ikungi,TZ1305,Mang'onyi,TZ1305101,14962 ,7903 ,7059 ,14962 ,7903 ,0 ,0 ,0 ,7059 
United Republic of Tanzania,Jamhuri ya Muungano wa Tanzania,TZ,Singida,TZ13,Ikungi,TZ1305,Mkiwa,TZ1305111,5152 ,2625 ,2527 ,5152 ,2625 ,0 ,0 ,0 ,2527 
United Republic of Tanzania,Jamhuri ya Muungano wa Tanzania,TZ,Singida,TZ13,Ikungi,TZ1305,Issuna,TZ1305121,12158 ,6212 ,5946 ,12158 ,6212 ,0 ,0 ,0 ,5946 
United Republic of Tanzania,Jamhuri ya Muungano wa Tanzania,TZ,Singida,TZ13,Ikungi,TZ1305,Unyahati,TZ1305131,9301 ,4703 ,4598 ,9301 ,4703 ,0 ,0 ,0 ,4598 
United Republic of Tanzania,Jamhuri ya Muungano wa Tanzania,TZ,Singida,TZ13,Ikungi,TZ1305,Ikungi,TZ1305143,12661 ,6331 ,6330 ,9207 ,4683 ,3454 ,1648 ,1806 ,4524 
United Republic of Tanzania,Jamhuri ya Muungano wa Tanzania,TZ,Singida,TZ13,Ikungi,TZ1305,Iglansoni,TZ1305151,11256 ,5432 ,5824 ,11256 ,5432 ,0 ,0 ,0 ,5824 
United Republic of Tanzania,Jamhuri ya Muungano wa Tanzania,TZ,Singida,TZ13,Ikungi,TZ1305,Iseke,TZ1305161,6933 ,3444 ,3489 ,6933 ,3444 ,0 ,0 ,0 ,3489 
United Republic of Tanzania,Jamhuri ya Muungano wa Tanzania,TZ,Singida,TZ13,Ikungi,TZ1305,Ihanja,TZ1305171,8269 ,4169 ,4100 ,8269 ,4169 ,0 ,0 ,0 ,4100 
United Republic of Tanzania,Jamhuri ya Muungano wa Tanzania,TZ,Singida,TZ13,Ikungi,TZ1305,Minyughe,TZ1305181,18440 ,9239 ,9201 ,18440 ,9239 ,0 ,0 ,0 ,9201 
United Republic of Tanzania,Jamhuri ya Muungano wa Tanzania,TZ,Singida,TZ13,Ikungi,TZ1305,Muhintiri,TZ1305191,8896 ,4420 ,4476 ,8896 ,4420 ,0 ,0 ,0 ,4476 
United Republic of Tanzania,Jamhuri ya Muungano wa Tanzania,TZ,Singida,TZ13,Ikungi,TZ1305,Iyumbu,TZ1305201,9377 ,4590 ,4787 ,9377 ,4590 ,0 ,0 ,0 ,4787 
United Republic of Tanzania,Jamhuri ya Muungano wa Tanzania,TZ,Singida,TZ13,Ikungi,TZ1305,Mgungira,TZ1305211,6548 ,3198 ,3350 ,6548 ,3198 ,0 ,0 ,0 ,3350 
United Republic of Tanzania,Jamhuri ya Muungano wa Tanzania,TZ,Singida,TZ13,Ikungi,TZ1305,Mwaru,TZ1305221,11784 ,5752 ,6032 ,11784 ,5752 ,0 ,0 ,0 ,6032 
United Republic of Tanzania,Jamhuri ya Muungano wa Tanzania,TZ,Singida,TZ13,Ikungi,TZ1305,Ighombwe,TZ1305231,13344 ,6692 ,6652 ,13344 ,6692 ,0 ,0 ,0 ,6652 
United Republic of Tanzania,Jamhuri ya Muungano wa Tanzania,TZ,Singida,TZ13,Ikungi,TZ1305,Mtunduru,TZ1305241,17056 ,8589 ,8467 ,17056 ,8589 ,0 ,0 ,0 ,8467 
United Republic of Tanzania,Jamhuri ya Muungano wa Tanzania,TZ,Singida,TZ13,Ikungi,TZ1305,Sepuka,TZ1305251,12446 ,6092 ,6354 ,12446 ,6092 ,0 ,0 ,0 ,6354 
United Republic of Tanzania,Jamhuri ya Muungano wa Tanzania,TZ,Singida,TZ13,Ikungi,TZ1305,Irisya,TZ1305261,6021 ,2979 ,3042 ,6021 ,2979 ,0 ,0 ,0 ,3042 
United Republic of Tanzania,Jamhuri ya Muungano wa Tanzania,TZ,Singida,TZ13,Mkalama,TZ1306,Mpambala,TZ1306011,11192 ,5512 ,5680 ,11192 ,5512 ,0 ,0 ,0 ,5680 
United Republic of Tanzania,Jamhuri ya Muungano wa Tanzania,TZ,Singida,TZ13,Mkalama,TZ1306,Mwangeza,TZ1306021,19258 ,9677 ,9581 ,19258 ,9677 ,0 ,0 ,0 ,9581 
United Republic of Tanzania,Jamhuri ya Muungano wa Tanzania,TZ,Singida,TZ13,Mkalama,TZ1306,Mwanga,TZ1306031,26024 ,13009 ,13015 ,26024 ,13009 ,0 ,0 ,0 ,13015 
United Republic of Tanzania,Jamhuri ya Muungano wa Tanzania,TZ,Singida,TZ13,Mkalama,TZ1306,Nkinto,TZ1306041,10372 ,5182 ,5190 ,10372 ,5182 ,0 ,0 ,0 ,5190 
United Republic of Tanzania,Jamhuri ya Muungano wa Tanzania,TZ,Singida,TZ13,Mkalama,TZ1306,Ibaga,TZ1306053,11712 ,5760 ,5952 ,8053 ,3967 ,3659 ,1793 ,1866 ,4086 
United Republic of Tanzania,Jamhuri ya Muungano wa Tanzania,TZ,Singida,TZ13,Mkalama,TZ1306,Gumanga,TZ1306061,10948 ,5365 ,5583 ,10948 ,5365 ,0 ,0 ,0 ,5583 
United Republic of Tanzania,Jamhuri ya Muungano wa Tanzania,TZ,Singida,TZ13,Mkalama,TZ1306,Msingi,TZ1306071,7289 ,3625 ,3664 ,7289 ,3625 ,0 ,0 ,0 ,3664 
United Republic of Tanzania,Jamhuri ya Muungano wa Tanzania,TZ,Singida,TZ13,Mkalama,TZ1306,Nduguti,TZ1306081,8638 ,4193 ,4445 ,8638 ,4193 ,0 ,0 ,0 ,4445 
United Republic of Tanzania,Jamhuri ya Muungano wa Tanzania,TZ,Singida,TZ13,Mkalama,TZ1306,Ilunda,TZ1306091,21622 ,10815 ,10807 ,21622 ,10815 ,0 ,0 ,0 ,10807 
United Republic of Tanzania,Jamhuri ya Muungano wa Tanzania,TZ,Singida,TZ13,Mkalama,TZ1306,Kinyangiri,TZ1306101,13475 ,6685 ,6790 ,13475 ,6685 ,0 ,0 ,0 ,6790 
United Republic of Tanzania,Jamhuri ya Muungano wa Tanzania,TZ,Singida,TZ13,Mkalama,TZ1306,Iguguno,TZ1306113,25860 ,12643 ,13217 ,18845 ,9304 ,7015 ,3339 ,3676 ,9541 
United Republic of Tanzania,Jamhuri ya Muungano wa Tanzania,TZ,Singida,TZ13,Mkalama,TZ1306,Miganga,TZ1306121,8486 ,4155 ,4331 ,8486 ,4155 ,0 ,0 ,0 ,4331 
United Republic of Tanzania,Jamhuri ya Muungano wa Tanzania,TZ,Singida,TZ13,Mkalama,TZ1306,Matongo,TZ1306131,6338 ,3166 ,3172 ,6338 ,3166 ,0 ,0 ,0 ,3172 
United Republic of Tanzania,Jamhuri ya Muungano wa Tanzania,TZ,Singida,TZ13,Mkalama,TZ1306,Kikhonda,TZ1306141,7519 ,3747 ,3772 ,7519 ,3747 ,0 ,0 ,0 ,3772 
United Republic of Tanzania,Jamhuri ya Muungano wa Tanzania,TZ,Tabora,TZ14,Nzega,TZ1401,Puge,TZ1401011,12985 ,6370 ,6615 ,12985 ,6370 ,0 ,0 ,0 ,6615 
United Republic of Tanzania,Jamhuri ya Muungano wa Tanzania,TZ,Tabora,TZ14,Nzega,TZ1401,Nkiniziwa,TZ1401021,19898 ,9704 ,10194 ,19898 ,9704 ,0 ,0 ,0 ,10194 
United Republic of Tanzania,Jamhuri ya Muungano wa Tanzania,TZ,Tabora,TZ14,Nzega,TZ1401,Budushi,TZ1401031,6940 ,3375 ,3565 ,6940 ,3375 ,0 ,0 ,0 ,3565 
United Republic of Tanzania,Jamhuri ya Muungano wa Tanzania,TZ,Tabora,TZ14,Nzega,TZ1401,Mwakashanhala,TZ1401041,19857 ,9818 ,10039 ,19857 ,9818 ,0 ,0 ,0 ,10039 
United Republic of Tanzania,Jamhuri ya Muungano wa Tanzania,TZ,Tabora,TZ14,Nzega,TZ1401,Tongi,TZ1401051,17151 ,8354 ,8797 ,17151 ,8354 ,0 ,0 ,0 ,8797 
United Republic of Tanzania,Jamhuri ya Muungano wa Tanzania,TZ,Tabora,TZ14,Nzega,TZ1401,Mizibaziba,TZ1401061,11606 ,5668 ,5938 ,11606 ,5668 ,0 ,0 ,0 ,5938 
United Republic of Tanzania,Jamhuri ya Muungano wa Tanzania,TZ,Tabora,TZ14,Nzega,TZ1401,Milambo Itobo,TZ1401071,12566 ,6301 ,6265 ,12566 ,6301 ,0 ,0 ,0 ,6265 
United Republic of Tanzania,Jamhuri ya Muungano wa Tanzania,TZ,Tabora,TZ14,Nzega,TZ1401,Magengati,TZ1401081,12430 ,6145 ,6285 ,12430 ,6145 ,0 ,0 ,0 ,6285 
United Republic of Tanzania,Jamhuri ya Muungano wa Tanzania,TZ,Tabora,TZ14,Nzega,TZ1401,Ndala,TZ1401091,17567 ,8550 ,9017 ,17567 ,8550 ,0 ,0 ,0 ,9017 
United Republic of Tanzania,Jamhuri ya Muungano wa Tanzania,TZ,Tabora,TZ14,Nzega,TZ1401,Nzega Mjini,TZ1401102,34744 ,16466 ,18278 ,0 ,0 ,34744 ,16466 ,18278 ,0 
United Republic of Tanzania,Jamhuri ya Muungano wa Tanzania,TZ,Tabora,TZ14,Nzega,TZ1401,Wela,TZ1401111,7031 ,3396 ,3635 ,7031 ,3396 ,0 ,0 ,0 ,3635 
United Republic of Tanzania,Jamhuri ya Muungano wa Tanzania,TZ,Tabora,TZ14,Nzega,TZ1401,Mbogwe,TZ1401121,6535 ,3210 ,3325 ,6535 ,3210 ,0 ,0 ,0 ,3325 
United Republic of Tanzania,Jamhuri ya Muungano wa Tanzania,TZ,Tabora,TZ14,Nzega,TZ1401,Miguwa,TZ1401131,13314 ,6447 ,6867 ,13314 ,6447 ,0 ,0 ,0 ,6867 
United Republic of Tanzania,Jamhuri ya Muungano wa Tanzania,TZ,Tabora,TZ14,Nzega,TZ1401,Itilo,TZ1401141,14668 ,7171 ,7497 ,14668 ,7171 ,0 ,0 ,0 ,7497 
United Republic of Tanzania,Jamhuri ya Muungano wa Tanzania,TZ,Tabora,TZ14,Nzega,TZ1401,Muhugi,TZ1401151,12336 ,6134 ,6202 ,12336 ,6134 ,0 ,0 ,0 ,6202 
United Republic of Tanzania,Jamhuri ya Muungano wa Tanzania,TZ,Tabora,TZ14,Nzega,TZ1401,Utwigu,TZ1401161,22743 ,11135 ,11608 ,22743 ,11135 ,0 ,0 ,0 ,11608 
United Republic of Tanzania,Jamhuri ya Muungano wa Tanzania,TZ,Tabora,TZ14,Nzega,TZ1401,Ijanija,TZ1401171,9873 ,4852 ,5021 ,9873 ,4852 ,0 ,0 ,0 ,5021 
United Republic of Tanzania,Jamhuri ya Muungano wa Tanzania,TZ,Tabora,TZ14,Nzega,TZ1401,Nzegandogo,TZ1401181,8726 ,4294 ,4432 ,8726 ,4294 ,0 ,0 ,0 ,4432 
United Republic of Tanzania,Jamhuri ya Muungano wa Tanzania,TZ,Tabora,TZ14,Nzega,TZ1401,Lusu,TZ1401191,18957 ,9249 ,9708 ,18957 ,9249 ,0 ,0 ,0 ,9708 
United Republic of Tanzania,Jamhuri ya Muungano wa Tanzania,TZ,Tabora,TZ14,Nzega,TZ1401,Nata,TZ1401201,14428 ,7130 ,7298 ,14428 ,7130 ,0 ,0 ,0 ,7298 
United Republic of Tanzania,Jamhuri ya Muungano wa Tanzania,TZ,Tabora,TZ14,Nzega,TZ1401,Isanzu,TZ1401211,12508 ,6052 ,6456 ,12508 ,6052 ,0 ,0 ,0 ,6456 
United Republic of Tanzania,Jamhuri ya Muungano wa Tanzania,TZ,Tabora,TZ14,Nzega,TZ1401,Itobo,TZ1401221,9411 ,4517 ,4894 ,9411 ,4517 ,0 ,0 ,0 ,4894 
United Republic of Tanzania,Jamhuri ya Muungano wa Tanzania,TZ,Tabora,TZ14,Nzega,TZ1401,Mwangoye,TZ1401231,13149 ,6366 ,6783 ,13149 ,6366 ,0 ,0 ,0 ,6783 
United Republic of Tanzania,Jamhuri ya Muungano wa Tanzania,TZ,Tabora,TZ14,Nzega,TZ1401,Sigili,TZ1401241,9754 ,4804 ,4950 ,9754 ,4804 ,0 ,0 ,0 ,4950 
United Republic of Tanzania,Jamhuri ya Muungano wa Tanzania,TZ,Tabora,TZ14,Nzega,TZ1401,Mwamala,TZ1401251,15620 ,7536 ,8084 ,15620 ,7536 ,0 ,0 ,0 ,8084 
United Republic of Tanzania,Jamhuri ya Muungano wa Tanzania,TZ,Tabora,TZ14,Nzega,TZ1401,Igusule,TZ1401261,16690 ,8162 ,8528 ,16690 ,8162 ,0 ,0 ,0 ,8528 
United Republic of Tanzania,Jamhuri ya Muungano wa Tanzania,TZ,Tabora,TZ14,Nzega,TZ1401,Shigamba,TZ1401271,4600 ,2206 ,2394 ,4600 ,2206 ,0 ,0 ,0 ,2394 
United Republic of Tanzania,Jamhuri ya Muungano wa Tanzania,TZ,Tabora,TZ14,Nzega,TZ1401,Kasela,TZ1401281,9259 ,4440 ,4819 ,9259 ,4440 ,0 ,0 ,0 ,4819 
United Republic of Tanzania,Jamhuri ya Muungano wa Tanzania,TZ,Tabora,TZ14,Nzega,TZ1401,Karitu,TZ1401291,8344 ,4035 ,4309 ,8344 ,4035 ,0 ,0 ,0 ,4309 
United Republic of Tanzania,Jamhuri ya Muungano wa Tanzania,TZ,Tabora,TZ14,Nzega,TZ1401,Bukene,TZ1401303,7641 ,3623 ,4018 ,553 ,286 ,7088 ,3337 ,3751 ,267 
United Republic of Tanzania,Jamhuri ya Muungano wa Tanzania,TZ,Tabora,TZ14,Nzega,TZ1401,Mogwa,TZ1401311,12140 ,5931 ,6209 ,12140 ,5931 ,0 ,0 ,0 ,6209 
United Republic of Tanzania,Jamhuri ya Muungano wa Tanzania,TZ,Tabora,TZ14,Nzega,TZ1401,Mambali,TZ1401321,33377 ,16466 ,16911 ,33377 ,16466 ,0 ,0 ,0 ,16911 
United Republic of Tanzania,Jamhuri ya Muungano wa Tanzania,TZ,Tabora,TZ14,Nzega,TZ1401,Kahamanhalanga,TZ1401331,5778 ,2939 ,2839 ,5778 ,2939 ,0 ,0 ,0 ,2839 
United Republic of Tanzania,Jamhuri ya Muungano wa Tanzania,TZ,Tabora,TZ14,Nzega,TZ1401,Uduka,TZ1401341,4832 ,2463 ,2369 ,4832 ,2463 ,0 ,0 ,0 ,2369 
United Republic of Tanzania,Jamhuri ya Muungano wa Tanzania,TZ,Tabora,TZ14,Nzega,TZ1401,Semembela,TZ1401351,17114 ,8302 ,8812 ,17114 ,8302 ,0 ,0 ,0 ,8812 
United Republic of Tanzania,Jamhuri ya Muungano wa Tanzania,TZ,Tabora,TZ14,Nzega,TZ1401,Isagenhe,TZ1401361,10059 ,4893 ,5166 ,10059 ,4893 ,0 ,0 ,0 ,5166 
United Republic of Tanzania,Jamhuri ya Muungano wa Tanzania,TZ,Tabora,TZ14,Nzega,TZ1401,Ikindwa,TZ1401371,9698 ,4784 ,4914 ,9698 ,4784 ,0 ,0 ,0 ,4914 
United Republic of Tanzania,Jamhuri ya Muungano wa Tanzania,TZ,Tabora,TZ14,Igunga,TZ1402,Igunga,TZ1402013,51172 ,24874 ,26298 ,22977 ,11429 ,28195 ,13445 ,14750 ,11548 
United Republic of Tanzania,Jamhuri ya Muungano wa Tanzania,TZ,Tabora,TZ14,Igunga,TZ1402,Itumba,TZ1402021,20464 ,10112 ,10352 ,20464 ,10112 ,0 ,0 ,0 ,10352 
United Republic of Tanzania,Jamhuri ya Muungano wa Tanzania,TZ,Tabora,TZ14,Igunga,TZ1402,Bukoko,TZ1402031,15985 ,7752 ,8233 ,15985 ,7752 ,0 ,0 ,0 ,8233 
United Republic of Tanzania,Jamhuri ya Muungano wa Tanzania,TZ,Tabora,TZ14,Igunga,TZ1402,Isakamaliwa,TZ1402041,8861 ,4412 ,4449 ,8861 ,4412 ,0 ,0 ,0 ,4449 
United Republic of Tanzania,Jamhuri ya Muungano wa Tanzania,TZ,Tabora,TZ14,Igunga,TZ1402,Nyandekwa,TZ1402051,9553 ,4668 ,4885 ,9553 ,4668 ,0 ,0 ,0 ,4885 
United Republic of Tanzania,Jamhuri ya Muungano wa Tanzania,TZ,Tabora,TZ14,Igunga,TZ1402,Nanga,TZ1402061,14835 ,7252 ,7583 ,14835 ,7252 ,0 ,0 ,0 ,7583 
United Republic of Tanzania,Jamhuri ya Muungano wa Tanzania,TZ,Tabora,TZ14,Igunga,TZ1402,Nguvumoja,TZ1402071,11588 ,5778 ,5810 ,11588 ,5778 ,0 ,0 ,0 ,5810 
United Republic of Tanzania,Jamhuri ya Muungano wa Tanzania,TZ,Tabora,TZ14,Igunga,TZ1402,Mbutu,TZ1402081,17468 ,8721 ,8747 ,17468 ,8721 ,0 ,0 ,0 ,8747 
United Republic of Tanzania,Jamhuri ya Muungano wa Tanzania,TZ,Tabora,TZ14,Igunga,TZ1402,Kining'inila,TZ1402091,10881 ,5289 ,5592 ,10881 ,5289 ,0 ,0 ,0 ,5592 
United Republic of Tanzania,Jamhuri ya Muungano wa Tanzania,TZ,Tabora,TZ14,Igunga,TZ1402,Igurubi,TZ1402103,11664 ,5779 ,5885 ,7836 ,3837 ,3828 ,1942 ,1886 ,3999 
United Republic of Tanzania,Jamhuri ya Muungano wa Tanzania,TZ,Tabora,TZ14,Igunga,TZ1402,Mwamashimba,TZ1402111,14730 ,7241 ,7489 ,14730 ,7241 ,0 ,0 ,0 ,7489 
United Republic of Tanzania,Jamhuri ya Muungano wa Tanzania,TZ,Tabora,TZ14,Igunga,TZ1402,Kinungu,TZ1402121,11565 ,5670 ,5895 ,11565 ,5670 ,0 ,0 ,0 ,5895 
United Republic of Tanzania,Jamhuri ya Muungano wa Tanzania,TZ,Tabora,TZ14,Igunga,TZ1402,Ntobo,TZ1402131,9715 ,4626 ,5089 ,9715 ,4626 ,0 ,0 ,0 ,5089 
United Republic of Tanzania,Jamhuri ya Muungano wa Tanzania,TZ,Tabora,TZ14,Igunga,TZ1402,Itunduru,TZ1402141,6891 ,3347 ,3544 ,6891 ,3347 ,0 ,0 ,0 ,3544 
United Republic of Tanzania,Jamhuri ya Muungano wa Tanzania,TZ,Tabora,TZ14,Igunga,TZ1402,Mwamashiga,TZ1402151,10041 ,4961 ,5080 ,10041 ,4961 ,0 ,0 ,0 ,5080 
United Republic of Tanzania,Jamhuri ya Muungano wa Tanzania,TZ,Tabora,TZ14,Igunga,TZ1402,Choma,TZ1402163,17323 ,8614 ,8709 ,13475 ,6839 ,3848 ,1775 ,2073 ,6636 
United Republic of Tanzania,Jamhuri ya Muungano wa Tanzania,TZ,Tabora,TZ14,Igunga,TZ1402,Mwashiku,TZ1402171,16234 ,8105 ,8129 ,16234 ,8105 ,0 ,0 ,0 ,8129 
United Republic of Tanzania,Jamhuri ya Muungano wa Tanzania,TZ,Tabora,TZ14,Igunga,TZ1402,Ziba,TZ1402181,18893 ,9141 ,9752 ,18893 ,9141 ,0 ,0 ,0 ,9752 
United Republic of Tanzania,Jamhuri ya Muungano wa Tanzania,TZ,Tabora,TZ14,Igunga,TZ1402,Ndembezi,TZ1402191,12724 ,6252 ,6472 ,12724 ,6252 ,0 ,0 ,0 ,6472 
United Republic of Tanzania,Jamhuri ya Muungano wa Tanzania,TZ,Tabora,TZ14,Igunga,TZ1402,Nkinga,TZ1402201,21608 ,10358 ,11250 ,21608 ,10358 ,0 ,0 ,0 ,11250 
United Republic of Tanzania,Jamhuri ya Muungano wa Tanzania,TZ,Tabora,TZ14,Igunga,TZ1402,Ngulu,TZ1402211,8470 ,4125 ,4345 ,8470 ,4125 ,0 ,0 ,0 ,4345 
United Republic of Tanzania,Jamhuri ya Muungano wa Tanzania,TZ,Tabora,TZ14,Igunga,TZ1402,Simbo,TZ1402221,14803 ,7276 ,7527 ,14803 ,7276 ,0 ,0 ,0 ,7527 
United Republic of Tanzania,Jamhuri ya Muungano wa Tanzania,TZ,Tabora,TZ14,Igunga,TZ1402,Igowero,TZ1402231,27317 ,13328 ,13989 ,27317 ,13328 ,0 ,0 ,0 ,13989 
United Republic of Tanzania,Jamhuri ya Muungano wa Tanzania,TZ,Tabora,TZ14,Igunga,TZ1402,Mwisi,TZ1402241,10872 ,5303 ,5569 ,10872 ,5303 ,0 ,0 ,0 ,5569 
United Republic of Tanzania,Jamhuri ya Muungano wa Tanzania,TZ,Tabora,TZ14,Igunga,TZ1402,Chabutwa,TZ1402251,6264 ,3034 ,3230 ,6264 ,3034 ,0 ,0 ,0 ,3230 
United Republic of Tanzania,Jamhuri ya Muungano wa Tanzania,TZ,Tabora,TZ14,Igunga,TZ1402,Sungwizi,TZ1402261,15065 ,7269 ,7796 ,15065 ,7269 ,0 ,0 ,0 ,7796 
United Republic of Tanzania,Jamhuri ya Muungano wa Tanzania,TZ,Tabora,TZ14,Uyui,TZ1403,Lutende,TZ1403011,25103 ,12275 ,12828 ,25103 ,12275 ,0 ,0 ,0 ,12828 
United Republic of Tanzania,Jamhuri ya Muungano wa Tanzania,TZ,Tabora,TZ14,Uyui,TZ1403,Kizengi,TZ1403021,21356 ,10498 ,10858 ,21356 ,10498 ,0 ,0 ,0 ,10858 
United Republic of Tanzania,Jamhuri ya Muungano wa Tanzania,TZ,Tabora,TZ14,Uyui,TZ1403,Goweko,TZ1403031,13808 ,6791 ,7017 ,13808 ,6791 ,0 ,0 ,0 ,7017 
United Republic of Tanzania,Jamhuri ya Muungano wa Tanzania,TZ,Tabora,TZ14,Uyui,TZ1403,Igalula,TZ1403041,14571 ,7150 ,7421 ,14571 ,7150 ,0 ,0 ,0 ,7421 
United Republic of Tanzania,Jamhuri ya Muungano wa Tanzania,TZ,Tabora,TZ14,Uyui,TZ1403,Ilolanguru,TZ1403053,16110 ,8052 ,8058 ,12214 ,6157 ,3896 ,1895 ,2001 ,6057 
United Republic of Tanzania,Jamhuri ya Muungano wa Tanzania,TZ,Tabora,TZ14,Uyui,TZ1403,Mabama,TZ1403063,20384 ,10358 ,10026 ,16010 ,8175 ,4374 ,2183 ,2191 ,7835 
United Republic of Tanzania,Jamhuri ya Muungano wa Tanzania,TZ,Tabora,TZ14,Uyui,TZ1403,Ndono,TZ1403071,9382 ,4688 ,4694 ,9382 ,4688 ,0 ,0 ,0 ,4694 
United Republic of Tanzania,Jamhuri ya Muungano wa Tanzania,TZ,Tabora,TZ14,Uyui,TZ1403,Ufuluma,TZ1403081,26969 ,13556 ,13413 ,26969 ,13556 ,0 ,0 ,0 ,13413 
United Republic of Tanzania,Jamhuri ya Muungano wa Tanzania,TZ,Tabora,TZ14,Uyui,TZ1403,Usagari,TZ1403091,11703 ,5716 ,5987 ,11703 ,5716 ,0 ,0 ,0 ,5987 
United Republic of Tanzania,Jamhuri ya Muungano wa Tanzania,TZ,Tabora,TZ14,Uyui,TZ1403,Ibiri,TZ1403101,17323 ,8659 ,8664 ,17323 ,8659 ,0 ,0 ,0 ,8664 
United Republic of Tanzania,Jamhuri ya Muungano wa Tanzania,TZ,Tabora,TZ14,Uyui,TZ1403,Bukumbi,TZ1403111,26368 ,12798 ,13570 ,26368 ,12798 ,0 ,0 ,0 ,13570 
United Republic of Tanzania,Jamhuri ya Muungano wa Tanzania,TZ,Tabora,TZ14,Uyui,TZ1403,Ikongolo,TZ1403121,13644 ,6682 ,6962 ,13644 ,6682 ,0 ,0 ,0 ,6962 
United Republic of Tanzania,Jamhuri ya Muungano wa Tanzania,TZ,Tabora,TZ14,Uyui,TZ1403,Upuge,TZ1403131,6463 ,3182 ,3281 ,6463 ,3182 ,0 ,0 ,0 ,3281 
United Republic of Tanzania,Jamhuri ya Muungano wa Tanzania,TZ,Tabora,TZ14,Uyui,TZ1403,Magiri,TZ1403141,13705 ,6971 ,6734 ,13705 ,6971 ,0 ,0 ,0 ,6734 
United Republic of Tanzania,Jamhuri ya Muungano wa Tanzania,TZ,Tabora,TZ14,Uyui,TZ1403,Isikizya,TZ1403151,11129 ,5637 ,5492 ,11129 ,5637 ,0 ,0 ,0 ,5492 
United Republic of Tanzania,Jamhuri ya Muungano wa Tanzania,TZ,Tabora,TZ14,Uyui,TZ1403,Shitage,TZ1403161,10221 ,5084 ,5137 ,10221 ,5084 ,0 ,0 ,0 ,5137 
United Republic of Tanzania,Jamhuri ya Muungano wa Tanzania,TZ,Tabora,TZ14,Uyui,TZ1403,Loya,TZ1403171,24925 ,12301 ,12624 ,24925 ,12301 ,0 ,0 ,0 ,12624 
United Republic of Tanzania,Jamhuri ya Muungano wa Tanzania,TZ,Tabora,TZ14,Uyui,TZ1403,Miswaki,TZ1403181,11883 ,5746 ,6137 ,11883 ,5746 ,0 ,0 ,0 ,6137 
United Republic of Tanzania,Jamhuri ya Muungano wa Tanzania,TZ,Tabora,TZ14,Uyui,TZ1403,Tura,TZ1403191,19433 ,9791 ,9642 ,19433 ,9791 ,0 ,0 ,0 ,9642 
United Republic of Tanzania,Jamhuri ya Muungano wa Tanzania,TZ,Tabora,TZ14,Uyui,TZ1403,Nsololo,TZ1403201,15784 ,7773 ,8011 ,15784 ,7773 ,0 ,0 ,0 ,8011 
United Republic of Tanzania,Jamhuri ya Muungano wa Tanzania,TZ,Tabora,TZ14,Uyui,TZ1403,Kigwa,TZ1403211,22931 ,11211 ,11720 ,22931 ,11211 ,0 ,0 ,0 ,11720 
United Republic of Tanzania,Jamhuri ya Muungano wa Tanzania,TZ,Tabora,TZ14,Uyui,TZ1403,Miyenze,TZ1403221,19327 ,9457 ,9870 ,19327 ,9457 ,0 ,0 ,0 ,9870 
United Republic of Tanzania,Jamhuri ya Muungano wa Tanzania,TZ,Tabora,TZ14,Uyui,TZ1403,Nsimbo,TZ1403231,9009 ,4502 ,4507 ,9009 ,4502 ,0 ,0 ,0 ,4507 
United Republic of Tanzania,Jamhuri ya Muungano wa Tanzania,TZ,Tabora,TZ14,Uyui,TZ1403,Ibelamilundi,TZ1403241,15092 ,7568 ,7524 ,15092 ,7568 ,0 ,0 ,0 ,7524 
United Republic of Tanzania,Jamhuri ya Muungano wa Tanzania,TZ,Tabora,TZ14,Urambo,TZ1404,Kapilula,TZ1404011,4385 ,2106 ,2279 ,4385 ,2106 ,0 ,0 ,0 ,2279 
United Republic of Tanzania,Jamhuri ya Muungano wa Tanzania,TZ,Tabora,TZ14,Urambo,TZ1404,Urambo,TZ1404023,34176 ,16727 ,17449 ,4809 ,2413 ,29367 ,14314 ,15053 ,2396 
United Republic of Tanzania,Jamhuri ya Muungano wa Tanzania,TZ,Tabora,TZ14,Urambo,TZ1404,Vumilia,TZ1404031,10258 ,5158 ,5100 ,10258 ,5158 ,0 ,0 ,0 ,5100 
United Republic of Tanzania,Jamhuri ya Muungano wa Tanzania,TZ,Tabora,TZ14,Urambo,TZ1404,Muungano,TZ1404041,13025 ,6606 ,6419 ,13025 ,6606 ,0 ,0 ,0 ,6419 
United Republic of Tanzania,Jamhuri ya Muungano wa Tanzania,TZ,Tabora,TZ14,Urambo,TZ1404,Songambele,TZ1404051,12909 ,6474 ,6435 ,12909 ,6474 ,0 ,0 ,0 ,6435 
United Republic of Tanzania,Jamhuri ya Muungano wa Tanzania,TZ,Tabora,TZ14,Urambo,TZ1404,Uyogo,TZ1404061,18897 ,9485 ,9412 ,18897 ,9485 ,0 ,0 ,0 ,9412 
United Republic of Tanzania,Jamhuri ya Muungano wa Tanzania,TZ,Tabora,TZ14,Urambo,TZ1404,Kiloleni,TZ1404071,8372 ,4167 ,4205 ,8372 ,4167 ,0 ,0 ,0 ,4205 
United Republic of Tanzania,Jamhuri ya Muungano wa Tanzania,TZ,Tabora,TZ14,Urambo,TZ1404,Ussoke,TZ1404081,8797 ,4252 ,4545 ,8797 ,4252 ,0 ,0 ,0 ,4545 
United Republic of Tanzania,Jamhuri ya Muungano wa Tanzania,TZ,Tabora,TZ14,Urambo,TZ1404,Uyumbu,TZ1404091,12217 ,6136 ,6081 ,12217 ,6136 ,0 ,0 ,0 ,6081 
United Republic of Tanzania,Jamhuri ya Muungano wa Tanzania,TZ,Tabora,TZ14,Urambo,TZ1404,Ugalla,TZ1404101,8732 ,4331 ,4401 ,8732 ,4331 ,0 ,0 ,0 ,4401 
United Republic of Tanzania,Jamhuri ya Muungano wa Tanzania,TZ,Tabora,TZ14,Urambo,TZ1404,Usisya,TZ1404111,13901 ,6794 ,7107 ,13901 ,6794 ,0 ,0 ,0 ,7107 
United Republic of Tanzania,Jamhuri ya Muungano wa Tanzania,TZ,Tabora,TZ14,Urambo,TZ1404,Utundu,TZ1404121,7525 ,3747 ,3778 ,7525 ,3747 ,0 ,0 ,0 ,3778 
United Republic of Tanzania,Jamhuri ya Muungano wa Tanzania,TZ,Tabora,TZ14,Urambo,TZ1404,Kasisi,TZ1404131,9393 ,4662 ,4731 ,9393 ,4662 ,0 ,0 ,0 ,4731 
United Republic of Tanzania,Jamhuri ya Muungano wa Tanzania,TZ,Tabora,TZ14,Urambo,TZ1404,Imalamakoye,TZ1404141,2984 ,1502 ,1482 ,2984 ,1502 ,0 ,0 ,0 ,1482 
United Republic of Tanzania,Jamhuri ya Muungano wa Tanzania,TZ,Tabora,TZ14,Urambo,TZ1404,Nsenda,TZ1404151,14382 ,7321 ,7061 ,14382 ,7321 ,0 ,0 ,0 ,7061 
United Republic of Tanzania,Jamhuri ya Muungano wa Tanzania,TZ,Tabora,TZ14,Urambo,TZ1404,Ukondamoyo,TZ1404161,13462 ,6929 ,6533 ,13462 ,6929 ,0 ,0 ,0 ,6533 
United Republic of Tanzania,Jamhuri ya Muungano wa Tanzania,TZ,Tabora,TZ14,Sikonge,TZ1405,Tutuo,TZ1405011,14641 ,7135 ,7506 ,14641 ,7135 ,0 ,0 ,0 ,7506 
United Republic of Tanzania,Jamhuri ya Muungano wa Tanzania,TZ,Tabora,TZ14,Sikonge,TZ1405,Chabutwa,TZ1405021,7837 ,3852 ,3985 ,7837 ,3852 ,0 ,0 ,0 ,3985 
United Republic of Tanzania,Jamhuri ya Muungano wa Tanzania,TZ,Tabora,TZ14,Sikonge,TZ1405,Kaloleli,TZ1405031,17073 ,8393 ,8680 ,14843 ,7298 ,2230 ,1095 ,1135 ,7545 
United Republic of Tanzania,Jamhuri ya Muungano wa Tanzania,TZ,Tabora,TZ14,Sikonge,TZ1405,Kipanga,TZ1405041,9067 ,4642 ,4425 ,9067 ,4642 ,0 ,0 ,0 ,4425 
United Republic of Tanzania,Jamhuri ya Muungano wa Tanzania,TZ,Tabora,TZ14,Sikonge,TZ1405,Sikonge,TZ1405053,17140 ,8187 ,8953 ,7809 ,3822 ,9331 ,4365 ,4966 ,3987 
United Republic of Tanzania,Jamhuri ya Muungano wa Tanzania,TZ,Tabora,TZ14,Sikonge,TZ1405,Igigwa,TZ1405061,28881 ,14184 ,14697 ,28881 ,14184 ,0 ,0 ,0 ,14697 
United Republic of Tanzania,Jamhuri ya Muungano wa Tanzania,TZ,Tabora,TZ14,Sikonge,TZ1405,Kitunda,TZ1405071,9710 ,5062 ,4648 ,9710 ,5062 ,0 ,0 ,0 ,4648 
United Republic of Tanzania,Jamhuri ya Muungano wa Tanzania,TZ,Tabora,TZ14,Sikonge,TZ1405,Kiloli,TZ1405081,4689 ,2396 ,2293 ,4689 ,2396 ,0 ,0 ,0 ,2293 
United Republic of Tanzania,Jamhuri ya Muungano wa Tanzania,TZ,Tabora,TZ14,Sikonge,TZ1405,Kipili,TZ1405091,20197 ,10022 ,10175 ,20197 ,10022 ,0 ,0 ,0 ,10175 
United Republic of Tanzania,Jamhuri ya Muungano wa Tanzania,TZ,Tabora,TZ14,Sikonge,TZ1405,Pangale,TZ1405101,6983 ,3564 ,3419 ,6983 ,3564 ,0 ,0 ,0 ,3419 
United Republic of Tanzania,Jamhuri ya Muungano wa Tanzania,TZ,Tabora,TZ14,Sikonge,TZ1405,Ipole,TZ1405111,5838 ,2884 ,2954 ,5838 ,2884 ,0 ,0 ,0 ,2954 
United Republic of Tanzania,Jamhuri ya Muungano wa Tanzania,TZ,Tabora,TZ14,Sikonge,TZ1405,Ngoywa,TZ1405121,5984 ,2930 ,3054 ,5984 ,2930 ,0 ,0 ,0 ,3054 
United Republic of Tanzania,Jamhuri ya Muungano wa Tanzania,TZ,Tabora,TZ14,Sikonge,TZ1405,Kisanga,TZ1405131,10373 ,5184 ,5189 ,10373 ,5184 ,0 ,0 ,0 ,5189 
United Republic of Tanzania,Jamhuri ya Muungano wa Tanzania,TZ,Tabora,TZ14,Sikonge,TZ1405,Misheni,TZ1405141,5594 ,2580 ,3014 ,5594 ,2580 ,0 ,0 ,0 ,3014 
United Republic of Tanzania,Jamhuri ya Muungano wa Tanzania,TZ,Tabora,TZ14,Sikonge,TZ1405,Mole,TZ1405151,12169 ,6108 ,6061 ,12169 ,6108 ,0 ,0 ,0 ,6061 
United Republic of Tanzania,Jamhuri ya Muungano wa Tanzania,TZ,Tabora,TZ14,Sikonge,TZ1405,Mpombwe,TZ1405161,6115 ,2950 ,3165 ,6115 ,2950 ,0 ,0 ,0 ,3165 
United Republic of Tanzania,Jamhuri ya Muungano wa Tanzania,TZ,Tabora,TZ14,Sikonge,TZ1405,Usunga,TZ1405171,7140 ,3520 ,3620 ,7140 ,3520 ,0 ,0 ,0 ,3620 
United Republic of Tanzania,Jamhuri ya Muungano wa Tanzania,TZ,Tabora,TZ14,Tabora Urban,TZ1406,Kanyenye,TZ1406012,10063 ,4614 ,5449 ,0 ,0 ,10063 ,4614 ,5449 ,0 
United Republic of Tanzania,Jamhuri ya Muungano wa Tanzania,TZ,Tabora,TZ14,Tabora Urban,TZ1406,Gongoni,TZ1406022,8064 ,3918 ,4146 ,0 ,0 ,8064 ,3918 ,4146 ,0 
United Republic of Tanzania,Jamhuri ya Muungano wa Tanzania,TZ,Tabora,TZ14,Tabora Urban,TZ1406,Mbugani,TZ1406032,15301 ,7221 ,8080 ,0 ,0 ,15301 ,7221 ,8080 ,0 
United Republic of Tanzania,Jamhuri ya Muungano wa Tanzania,TZ,Tabora,TZ14,Tabora Urban,TZ1406,Chemchem,TZ1406042,19980 ,9630 ,10350 ,0 ,0 ,19980 ,9630 ,10350 ,0 
United Republic of Tanzania,Jamhuri ya Muungano wa Tanzania,TZ,Tabora,TZ14,Tabora Urban,TZ1406,Tambukareli,TZ1406052,6783 ,3345 ,3438 ,0 ,0 ,6783 ,3345 ,3438 ,0 
United Republic of Tanzania,Jamhuri ya Muungano wa Tanzania,TZ,Tabora,TZ14,Tabora Urban,TZ1406,Kiloleni,TZ1406062,14213 ,6943 ,7270 ,0 ,0 ,14213 ,6943 ,7270 ,0 
United Republic of Tanzania,Jamhuri ya Muungano wa Tanzania,TZ,Tabora,TZ14,Tabora Urban,TZ1406,Mtendeni,TZ1406072,5536 ,3390 ,2146 ,0 ,0 ,5536 ,3390 ,2146 ,0 
United Republic of Tanzania,Jamhuri ya Muungano wa Tanzania,TZ,Tabora,TZ14,Tabora Urban,TZ1406,Isevya,TZ1406082,13507 ,6360 ,7147 ,0 ,0 ,13507 ,6360 ,7147 ,0 
United Republic of Tanzania,Jamhuri ya Muungano wa Tanzania,TZ,Tabora,TZ14,Tabora Urban,TZ1406,Ipuli,TZ1406092,23444 ,11258 ,12186 ,0 ,0 ,23444 ,11258 ,12186 ,0 
United Republic of Tanzania,Jamhuri ya Muungano wa Tanzania,TZ,Tabora,TZ14,Tabora Urban,TZ1406,Cheyo,TZ1406102,11399 ,5648 ,5751 ,0 ,0 ,11399 ,5648 ,5751 ,0 
United Republic of Tanzania,Jamhuri ya Muungano wa Tanzania,TZ,Tabora,TZ14,Tabora Urban,TZ1406,Kitete,TZ1406112,9192 ,4233 ,4959 ,0 ,0 ,9192 ,4233 ,4959 ,0 
United Republic of Tanzania,Jamhuri ya Muungano wa Tanzania,TZ,Tabora,TZ14,Tabora Urban,TZ1406,Ng`ambo,TZ1406122,19702 ,9429 ,10273 ,0 ,0 ,19702 ,9429 ,10273 ,0 
United Republic of Tanzania,Jamhuri ya Muungano wa Tanzania,TZ,Tabora,TZ14,Tabora Urban,TZ1406,Malolo,TZ1406132,3424 ,1669 ,1755 ,0 ,0 ,3424 ,1669 ,1755 ,0 
United Republic of Tanzania,Jamhuri ya Muungano wa Tanzania,TZ,Tabora,TZ14,Tabora Urban,TZ1406,Kakola,TZ1406141,13701 ,6654 ,7047 ,13701 ,6654 ,0 ,0 ,0 ,7047 
United Republic of Tanzania,Jamhuri ya Muungano wa Tanzania,TZ,Tabora,TZ14,Tabora Urban,TZ1406,Uyui,TZ1406151,6262 ,3162 ,3100 ,6262 ,3162 ,0 ,0 ,0 ,3100 
United Republic of Tanzania,Jamhuri ya Muungano wa Tanzania,TZ,Tabora,TZ14,Tabora Urban,TZ1406,Itonjanda,TZ1406161,2714 ,1326 ,1388 ,2714 ,1326 ,0 ,0 ,0 ,1388 
United Republic of Tanzania,Jamhuri ya Muungano wa Tanzania,TZ,Tabora,TZ14,Tabora Urban,TZ1406,Ndevelwa,TZ1406171,8112 ,4111 ,4001 ,8112 ,4111 ,0 ,0 ,0 ,4001 
United Republic of Tanzania,Jamhuri ya Muungano wa Tanzania,TZ,Tabora,TZ14,Tabora Urban,TZ1406,Itetemia,TZ1406181,4549 ,2247 ,2302 ,4549 ,2247 ,0 ,0 ,0 ,2302 
United Republic of Tanzania,Jamhuri ya Muungano wa Tanzania,TZ,Tabora,TZ14,Tabora Urban,TZ1406,Tumbi,TZ1406191,6205 ,3087 ,3118 ,6205 ,3087 ,0 ,0 ,0 ,3118 
United Republic of Tanzania,Jamhuri ya Muungano wa Tanzania,TZ,Tabora,TZ14,Tabora Urban,TZ1406,Kalunde,TZ1406201,8113 ,4307 ,3806 ,8113 ,4307 ,0 ,0 ,0 ,3806 
United Republic of Tanzania,Jamhuri ya Muungano wa Tanzania,TZ,Tabora,TZ14,Tabora Urban,TZ1406,Misha,TZ1406211,6234 ,3202 ,3032 ,6234 ,3202 ,0 ,0 ,0 ,3032 
United Republic of Tanzania,Jamhuri ya Muungano wa Tanzania,TZ,Tabora,TZ14,Tabora Urban,TZ1406,Kabila,TZ1406221,11632 ,5667 ,5965 ,11632 ,5667 ,0 ,0 ,0 ,5965 
United Republic of Tanzania,Jamhuri ya Muungano wa Tanzania,TZ,Tabora,TZ14,Tabora Urban,TZ1406,Ikomwa,TZ1406231,7152 ,3581 ,3571 ,7152 ,3581 ,0 ,0 ,0 ,3571 
United Republic of Tanzania,Jamhuri ya Muungano wa Tanzania,TZ,Tabora,TZ14,Tabora Urban,TZ1406,Ifucha,TZ1406241,3219 ,1650 ,1569 ,3219 ,1650 ,0 ,0 ,0 ,1569 
United Republic of Tanzania,Jamhuri ya Muungano wa Tanzania,TZ,Tabora,TZ14,Tabora Urban,TZ1406,Ntalikwa,TZ1406251,4583 ,2327 ,2256 ,4583 ,2327 ,0 ,0 ,0 ,2256 
United Republic of Tanzania,Jamhuri ya Muungano wa Tanzania,TZ,Tabora,TZ14,Kaliua,TZ1407,Ukumbi Siganga,TZ1407011,8837 ,4552 ,4285 ,8837 ,4552 ,0 ,0 ,0 ,4285 
United Republic of Tanzania,Jamhuri ya Muungano wa Tanzania,TZ,Tabora,TZ14,Kaliua,TZ1407,Zugimlole,TZ1407021,23241 ,11610 ,11631 ,23241 ,11610 ,0 ,0 ,0 ,11631 
United Republic of Tanzania,Jamhuri ya Muungano wa Tanzania,TZ,Tabora,TZ14,Kaliua,TZ1407,Ushokola,TZ1407031,14950 ,7247 ,7703 ,14950 ,7247 ,0 ,0 ,0 ,7703 
United Republic of Tanzania,Jamhuri ya Muungano wa Tanzania,TZ,Tabora,TZ14,Kaliua,TZ1407,Ugunga,TZ1407041,13551 ,6575 ,6976 ,13551 ,6575 ,0 ,0 ,0 ,6976 
United Republic of Tanzania,Jamhuri ya Muungano wa Tanzania,TZ,Tabora,TZ14,Kaliua,TZ1407,Kaliua,TZ1407053,3470 ,1764 ,1706 ,3470 ,1764 ,0 ,0 ,0 ,1706 
United Republic of Tanzania,Jamhuri ya Muungano wa Tanzania,TZ,Tabora,TZ14,Kaliua,TZ1407,Usinge,TZ1407061,42323 ,21275 ,21048 ,42323 ,21275 ,0 ,0 ,0 ,21048 
United Republic of Tanzania,Jamhuri ya Muungano wa Tanzania,TZ,Tabora,TZ14,Kaliua,TZ1407,Igagala,TZ1407071,23841 ,12182 ,11659 ,23841 ,12182 ,0 ,0 ,0 ,11659 
United Republic of Tanzania,Jamhuri ya Muungano wa Tanzania,TZ,Tabora,TZ14,Kaliua,TZ1407,Kamsekwa,TZ1407081,11246 ,5709 ,5537 ,11246 ,5709 ,0 ,0 ,0 ,5537 
United Republic of Tanzania,Jamhuri ya Muungano wa Tanzania,TZ,Tabora,TZ14,Kaliua,TZ1407,Kazaroho,TZ1407091,14499 ,7415 ,7084 ,14499 ,7415 ,0 ,0 ,0 ,7084 
United Republic of Tanzania,Jamhuri ya Muungano wa Tanzania,TZ,Tabora,TZ14,Kaliua,TZ1407,Igwisi,TZ1407101,30047 ,15216 ,14831 ,30047 ,15216 ,0 ,0 ,0 ,14831 
United Republic of Tanzania,Jamhuri ya Muungano wa Tanzania,TZ,Tabora,TZ14,Kaliua,TZ1407,Uyowa,TZ1407111,16475 ,8163 ,8312 ,16475 ,8163 ,0 ,0 ,0 ,8312 
United Republic of Tanzania,Jamhuri ya Muungano wa Tanzania,TZ,Tabora,TZ14,Kaliua,TZ1407,Silambo,TZ1407121,17305 ,8781 ,8524 ,17305 ,8781 ,0 ,0 ,0 ,8524 
United Republic of Tanzania,Jamhuri ya Muungano wa Tanzania,TZ,Tabora,TZ14,Kaliua,TZ1407,Kashishi,TZ1407131,16805 ,8225 ,8580 ,16805 ,8225 ,0 ,0 ,0 ,8580 
United Republic of Tanzania,Jamhuri ya Muungano wa Tanzania,TZ,Tabora,TZ14,Kaliua,TZ1407,Sasu,TZ1407141,32031 ,15783 ,16248 ,32031 ,15783 ,0 ,0 ,0 ,16248 
United Republic of Tanzania,Jamhuri ya Muungano wa Tanzania,TZ,Tabora,TZ14,Kaliua,TZ1407,Seleli,TZ1407151,13647 ,6765 ,6882 ,13647 ,6765 ,0 ,0 ,0 ,6882 
United Republic of Tanzania,Jamhuri ya Muungano wa Tanzania,TZ,Tabora,TZ14,Kaliua,TZ1407,Ichemba,TZ1407161,17750 ,8851 ,8899 ,17750 ,8851 ,0 ,0 ,0 ,8899 
United Republic of Tanzania,Jamhuri ya Muungano wa Tanzania,TZ,Tabora,TZ14,Kaliua,TZ1407,Mwongozo,TZ1407171,9431 ,4715 ,4716 ,9431 ,4715 ,0 ,0 ,0 ,4716 
United Republic of Tanzania,Jamhuri ya Muungano wa Tanzania,TZ,Tabora,TZ14,Kaliua,TZ1407,Kanoge,TZ1407181,4504 ,2338 ,2166 ,4504 ,2338 ,0 ,0 ,0 ,2166 
United Republic of Tanzania,Jamhuri ya Muungano wa Tanzania,TZ,Tabora,TZ14,Kaliua,TZ1407,Kanindo,TZ1407191,22561 ,11155 ,11406 ,22561 ,11155 ,0 ,0 ,0 ,11406 
United Republic of Tanzania,Jamhuri ya Muungano wa Tanzania,TZ,Tabora,TZ14,Kaliua,TZ1407,Milambo,TZ1407201,25933 ,12908 ,13025 ,25933 ,12908 ,0 ,0 ,0 ,13025 
United Republic of Tanzania,Jamhuri ya Muungano wa Tanzania,TZ,Tabora,TZ14,Kaliua,TZ1407,Igombe Mkulu,TZ1407211,17308 ,8511 ,8797 ,17308 ,8511 ,0 ,0 ,0 ,8797 
United Republic of Tanzania,Jamhuri ya Muungano wa Tanzania,TZ,Rukwa,TZ15,Kalambo,TZ1501,Kasanga,TZ1501011,18527 ,9115 ,9412 ,18527 ,9115 ,0 ,0 ,0 ,9412 
United Republic of Tanzania,Jamhuri ya Muungano wa Tanzania,TZ,Rukwa,TZ15,Kalambo,TZ1501,Mkowe,TZ1501021,12454 ,6091 ,6363 ,12454 ,6091 ,0 ,0 ,0 ,6363 
United Republic of Tanzania,Jamhuri ya Muungano wa Tanzania,TZ,Rukwa,TZ15,Kalambo,TZ1501,Msanzi,TZ1501031,16507 ,8023 ,8484 ,16507 ,8023 ,0 ,0 ,0 ,8484 
United Republic of Tanzania,Jamhuri ya Muungano wa Tanzania,TZ,Rukwa,TZ15,Kalambo,TZ1501,Matai,TZ1501043,16335 ,7811 ,8524 ,13403 ,6417 ,2932 ,1394 ,1538 ,6986 
United Republic of Tanzania,Jamhuri ya Muungano wa Tanzania,TZ,Rukwa,TZ15,Kalambo,TZ1501,Sopa,TZ1501051,13230 ,6463 ,6767 ,13230 ,6463 ,0 ,0 ,0 ,6767 
United Republic of Tanzania,Jamhuri ya Muungano wa Tanzania,TZ,Rukwa,TZ15,Kalambo,TZ1501,Mwazye,TZ1501061,8883 ,4384 ,4499 ,8883 ,4384 ,0 ,0 ,0 ,4499 
United Republic of Tanzania,Jamhuri ya Muungano wa Tanzania,TZ,Rukwa,TZ15,Kalambo,TZ1501,Katazi,TZ1501071,16088 ,7738 ,8350 ,16088 ,7738 ,0 ,0 ,0 ,8350 
United Republic of Tanzania,Jamhuri ya Muungano wa Tanzania,TZ,Rukwa,TZ15,Kalambo,TZ1501,Mwimbi,TZ1501081,10230 ,4952 ,5278 ,10230 ,4952 ,0 ,0 ,0 ,5278 
United Republic of Tanzania,Jamhuri ya Muungano wa Tanzania,TZ,Rukwa,TZ15,Kalambo,TZ1501,Mabwekenya,TZ1501091,10487 ,5005 ,5482 ,10487 ,5005 ,0 ,0 ,0 ,5482 
United Republic of Tanzania,Jamhuri ya Muungano wa Tanzania,TZ,Rukwa,TZ15,Kalambo,TZ1501,Mwembenkoswe,TZ1501101,8494 ,3991 ,4503 ,8494 ,3991 ,0 ,0 ,0 ,4503 
United Republic of Tanzania,Jamhuri ya Muungano wa Tanzania,TZ,Rukwa,TZ15,Kalambo,TZ1501,Legeza Mwendo,TZ1501111,9039 ,4260 ,4779 ,9039 ,4260 ,0 ,0 ,0 ,4779 
United Republic of Tanzania,Jamhuri ya Muungano wa Tanzania,TZ,Rukwa,TZ15,Kalambo,TZ1501,Ulumi,TZ1501121,11780 ,5790 ,5990 ,11780 ,5790 ,0 ,0 ,0 ,5990 
United Republic of Tanzania,Jamhuri ya Muungano wa Tanzania,TZ,Rukwa,TZ15,Kalambo,TZ1501,Mnamba,TZ1501131,9945 ,4789 ,5156 ,9945 ,4789 ,0 ,0 ,0 ,5156 
United Republic of Tanzania,Jamhuri ya Muungano wa Tanzania,TZ,Rukwa,TZ15,Kalambo,TZ1501,Katete,TZ1501141,8669 ,4238 ,4431 ,8669 ,4238 ,0 ,0 ,0 ,4431 
United Republic of Tanzania,Jamhuri ya Muungano wa Tanzania,TZ,Rukwa,TZ15,Kalambo,TZ1501,Kisumba,TZ1501151,17292 ,8314 ,8978 ,17292 ,8314 ,0 ,0 ,0 ,8978 
United Republic of Tanzania,Jamhuri ya Muungano wa Tanzania,TZ,Rukwa,TZ15,Kalambo,TZ1501,Mkali,TZ1501161,11845 ,5696 ,6149 ,11845 ,5696 ,0 ,0 ,0 ,6149 
United Republic of Tanzania,Jamhuri ya Muungano wa Tanzania,TZ,Rukwa,TZ15,Kalambo,TZ1501,Kilesha,TZ1501171,7895 ,3814 ,4081 ,7895 ,3814 ,0 ,0 ,0 ,4081 
United Republic of Tanzania,Jamhuri ya Muungano wa Tanzania,TZ,Rukwa,TZ15,Sumbawanga,TZ1502,Mfinga,TZ1502011,15072 ,7494 ,7578 ,15072 ,7494 ,0 ,0 ,0 ,7578 
United Republic of Tanzania,Jamhuri ya Muungano wa Tanzania,TZ,Rukwa,TZ15,Sumbawanga,TZ1502,Muze,TZ1502023,27441 ,13505 ,13936 ,22901 ,11290 ,4540 ,2215 ,2325 ,11611 
United Republic of Tanzania,Jamhuri ya Muungano wa Tanzania,TZ,Rukwa,TZ15,Sumbawanga,TZ1502,Mtowisa,TZ1502033,26143 ,12949 ,13194 ,22354 ,11064 ,3789 ,1885 ,1904 ,11290 
United Republic of Tanzania,Jamhuri ya Muungano wa Tanzania,TZ,Rukwa,TZ15,Sumbawanga,TZ1502,Milepa,TZ1502041,15762 ,7792 ,7970 ,15762 ,7792 ,0 ,0 ,0 ,7970 
United Republic of Tanzania,Jamhuri ya Muungano wa Tanzania,TZ,Rukwa,TZ15,Sumbawanga,TZ1502,Sandulula,TZ1502051,18755 ,9133 ,9622 ,18755 ,9133 ,0 ,0 ,0 ,9622 
United Republic of Tanzania,Jamhuri ya Muungano wa Tanzania,TZ,Rukwa,TZ15,Sumbawanga,TZ1502,Kaengesa,TZ1502061,28917 ,14117 ,14800 ,28917 ,14117 ,0 ,0 ,0 ,14800 
United Republic of Tanzania,Jamhuri ya Muungano wa Tanzania,TZ,Rukwa,TZ15,Sumbawanga,TZ1502,Mpui,TZ1502071,14831 ,7216 ,7615 ,14831 ,7216 ,0 ,0 ,0 ,7615 
United Republic of Tanzania,Jamhuri ya Muungano wa Tanzania,TZ,Rukwa,TZ15,Sumbawanga,TZ1502,Msanda Muungano,TZ1502081,7986 ,3881 ,4105 ,7986 ,3881 ,0 ,0 ,0 ,4105 
United Republic of Tanzania,Jamhuri ya Muungano wa Tanzania,TZ,Rukwa,TZ15,Sumbawanga,TZ1502,Ilemba,TZ1502091,26078 ,12877 ,13201 ,26078 ,12877 ,0 ,0 ,0 ,13201 
United Republic of Tanzania,Jamhuri ya Muungano wa Tanzania,TZ,Rukwa,TZ15,Sumbawanga,TZ1502,Kipeta,TZ1502101,25755 ,12639 ,13116 ,25755 ,12639 ,0 ,0 ,0 ,13116 
United Republic of Tanzania,Jamhuri ya Muungano wa Tanzania,TZ,Rukwa,TZ15,Sumbawanga,TZ1502,Kaoze,TZ1502111,26306 ,12723 ,13583 ,26306 ,12723 ,0 ,0 ,0 ,13583 
United Republic of Tanzania,Jamhuri ya Muungano wa Tanzania,TZ,Rukwa,TZ15,Sumbawanga,TZ1502,Miangalua,TZ1502121,14419 ,6923 ,7496 ,14419 ,6923 ,0 ,0 ,0 ,7496 
United Republic of Tanzania,Jamhuri ya Muungano wa Tanzania,TZ,Rukwa,TZ15,Sumbawanga,TZ1502,Kalambanzite,TZ1502131,20786 ,9949 ,10837 ,20786 ,9949 ,0 ,0 ,0 ,10837 
United Republic of Tanzania,Jamhuri ya Muungano wa Tanzania,TZ,Rukwa,TZ15,Sumbawanga,TZ1502,Lusaka,TZ1502141,13866 ,6620 ,7246 ,13866 ,6620 ,0 ,0 ,0 ,7246 
United Republic of Tanzania,Jamhuri ya Muungano wa Tanzania,TZ,Rukwa,TZ15,Sumbawanga,TZ1502,Laela,TZ1502151,23729 ,11244 ,12485 ,0 ,0 ,23729 ,11244 ,12485 ,0 
United Republic of Tanzania,Jamhuri ya Muungano wa Tanzania,TZ,Rukwa,TZ15,Nkasi,TZ1503,Korongwe,TZ1503013,17617 ,8478 ,9139 ,7578 ,3594 ,10039 ,4884 ,5155 ,3984 
United Republic of Tanzania,Jamhuri ya Muungano wa Tanzania,TZ,Rukwa,TZ15,Nkasi,TZ1503,Mtenga,TZ1503021,29860 ,14557 ,15303 ,29860 ,14557 ,0 ,0 ,0 ,15303 
United Republic of Tanzania,Jamhuri ya Muungano wa Tanzania,TZ,Rukwa,TZ15,Nkasi,TZ1503,Mkwamba,TZ1503031,11324 ,5579 ,5745 ,11324 ,5579 ,0 ,0 ,0 ,5745 
United Republic of Tanzania,Jamhuri ya Muungano wa Tanzania,TZ,Rukwa,TZ15,Nkasi,TZ1503,Chala,TZ1503043,13499 ,6484 ,7015 ,7766 ,3797 ,5733 ,2687 ,3046 ,3969 
United Republic of Tanzania,Jamhuri ya Muungano wa Tanzania,TZ,Rukwa,TZ15,Nkasi,TZ1503,Kipande,TZ1503051,16915 ,8302 ,8613 ,16915 ,8302 ,0 ,0 ,0 ,8613 
United Republic of Tanzania,Jamhuri ya Muungano wa Tanzania,TZ,Rukwa,TZ15,Nkasi,TZ1503,Isale,TZ1503061,14502 ,7138 ,7364 ,14502 ,7138 ,0 ,0 ,0 ,7364 
United Republic of Tanzania,Jamhuri ya Muungano wa Tanzania,TZ,Rukwa,TZ15,Nkasi,TZ1503,Kate,TZ1503071,23678 ,11537 ,12141 ,23678 ,11537 ,0 ,0 ,0 ,12141 
United Republic of Tanzania,Jamhuri ya Muungano wa Tanzania,TZ,Rukwa,TZ15,Nkasi,TZ1503,Sintali,TZ1503081,8923 ,4354 ,4569 ,8923 ,4354 ,0 ,0 ,0 ,4569 
United Republic of Tanzania,Jamhuri ya Muungano wa Tanzania,TZ,Rukwa,TZ15,Nkasi,TZ1503,Kala,TZ1503091,13344 ,6422 ,6922 ,13344 ,6422 ,0 ,0 ,0 ,6922 
United Republic of Tanzania,Jamhuri ya Muungano wa Tanzania,TZ,Rukwa,TZ15,Nkasi,TZ1503,Wampembe,TZ1503101,14611 ,7212 ,7399 ,14611 ,7212 ,0 ,0 ,0 ,7399 
United Republic of Tanzania,Jamhuri ya Muungano wa Tanzania,TZ,Rukwa,TZ15,Nkasi,TZ1503,Ninde,TZ1503111,12291 ,6152 ,6139 ,12291 ,6152 ,0 ,0 ,0 ,6139 
United Republic of Tanzania,Jamhuri ya Muungano wa Tanzania,TZ,Rukwa,TZ15,Nkasi,TZ1503,Kirando,TZ1503123,21169 ,10177 ,10992 ,6193 ,2993 ,14976 ,7184 ,7792 ,3200 
United Republic of Tanzania,Jamhuri ya Muungano wa Tanzania,TZ,Rukwa,TZ15,Nkasi,TZ1503,Kabwe,TZ1503133,13087 ,6454 ,6633 ,4854 ,2496 ,8233 ,3958 ,4275 ,2358 
United Republic of Tanzania,Jamhuri ya Muungano wa Tanzania,TZ,Rukwa,TZ15,Nkasi,TZ1503,Kipili,TZ1503141,16525 ,8297 ,8228 ,16525 ,8297 ,0 ,0 ,0 ,8228 
United Republic of Tanzania,Jamhuri ya Muungano wa Tanzania,TZ,Rukwa,TZ15,Nkasi,TZ1503,Nkandasi,TZ1503151,15493 ,7554 ,7939 ,15493 ,7554 ,0 ,0 ,0 ,7939 
United Republic of Tanzania,Jamhuri ya Muungano wa Tanzania,TZ,Rukwa,TZ15,Nkasi,TZ1503,Namanyere,TZ1503162,18877 ,9001 ,9876 ,0 ,0 ,18877 ,9001 ,9876 ,0 
United Republic of Tanzania,Jamhuri ya Muungano wa Tanzania,TZ,Rukwa,TZ15,Nkasi,TZ1503,Nkomolo,TZ1503172,19485 ,9343 ,10142 ,0 ,0 ,19485 ,9343 ,10142 ,0 
United Republic of Tanzania,Jamhuri ya Muungano wa Tanzania,TZ,Rukwa,TZ15,Sumbawanga Urban,TZ1504,Malangali,TZ1504012,6743 ,3270 ,3473 ,0 ,0 ,6743 ,3270 ,3473 ,0 
United Republic of Tanzania,Jamhuri ya Muungano wa Tanzania,TZ,Rukwa,TZ15,Sumbawanga Urban,TZ1504,Mazwi,TZ1504022,6197 ,2907 ,3290 ,0 ,0 ,6197 ,2907 ,3290 ,0 
United Republic of Tanzania,Jamhuri ya Muungano wa Tanzania,TZ,Rukwa,TZ15,Sumbawanga Urban,TZ1504,Izia,TZ1504032,19463 ,9064 ,10399 ,0 ,0 ,19463 ,9064 ,10399 ,0 
United Republic of Tanzania,Jamhuri ya Muungano wa Tanzania,TZ,Rukwa,TZ15,Sumbawanga Urban,TZ1504,Katandala,TZ1504042,12685 ,5937 ,6748 ,0 ,0 ,12685 ,5937 ,6748 ,0 
United Republic of Tanzania,Jamhuri ya Muungano wa Tanzania,TZ,Rukwa,TZ15,Sumbawanga Urban,TZ1504,Old Sumbawanga,TZ1504052,23298 ,11128 ,12170 ,0 ,0 ,23298 ,11128 ,12170 ,0 
United Republic of Tanzania,Jamhuri ya Muungano wa Tanzania,TZ,Rukwa,TZ15,Sumbawanga Urban,TZ1504,Kizwite,TZ1504062,16187 ,7662 ,8525 ,0 ,0 ,16187 ,7662 ,8525 ,0 
United Republic of Tanzania,Jamhuri ya Muungano wa Tanzania,TZ,Rukwa,TZ15,Sumbawanga Urban,TZ1504,Ntendo,TZ1504071,13324 ,6525 ,6799 ,13324 ,6525 ,0 ,0 ,0 ,6799 
United Republic of Tanzania,Jamhuri ya Muungano wa Tanzania,TZ,Rukwa,TZ15,Sumbawanga Urban,TZ1504,Senga,TZ1504081,6793 ,3430 ,3363 ,6793 ,3430 ,0 ,0 ,0 ,3363 
United Republic of Tanzania,Jamhuri ya Muungano wa Tanzania,TZ,Rukwa,TZ15,Sumbawanga Urban,TZ1504,Mollo,TZ1504091,15707 ,7640 ,8067 ,15707 ,7640 ,0 ,0 ,0 ,8067 
United Republic of Tanzania,Jamhuri ya Muungano wa Tanzania,TZ,Rukwa,TZ15,Sumbawanga Urban,TZ1504,Pito,TZ1504101,15561 ,7495 ,8066 ,15561 ,7495 ,0 ,0 ,0 ,8066 
United Republic of Tanzania,Jamhuri ya Muungano wa Tanzania,TZ,Rukwa,TZ15,Sumbawanga Urban,TZ1504,Milanzi,TZ1504111,13482 ,6588 ,6894 ,13482 ,6588 ,0 ,0 ,0 ,6894 
United Republic of Tanzania,Jamhuri ya Muungano wa Tanzania,TZ,Rukwa,TZ15,Sumbawanga Urban,TZ1504,Matanga,TZ1504121,9521 ,4701 ,4820 ,9521 ,4701 ,0 ,0 ,0 ,4820 
United Republic of Tanzania,Jamhuri ya Muungano wa Tanzania,TZ,Rukwa,TZ15,Sumbawanga Urban,TZ1504,Kasense,TZ1504131,11201 ,5411 ,5790 ,11201 ,5411 ,0 ,0 ,0 ,5790 
United Republic of Tanzania,Jamhuri ya Muungano wa Tanzania,TZ,Rukwa,TZ15,Sumbawanga Urban,TZ1504,Majengo,TZ1504142,15447 ,7394 ,8053 ,0 ,0 ,15447 ,7394 ,8053 ,0 
United Republic of Tanzania,Jamhuri ya Muungano wa Tanzania,TZ,Rukwa,TZ15,Sumbawanga Urban,TZ1504,Chanji,TZ1504152,24184 ,11582 ,12602 ,0 ,0 ,24184 ,11582 ,12602 ,0 
United Republic of Tanzania,Jamhuri ya Muungano wa Tanzania,TZ,Kigoma,TZ16,Kibondo,TZ1601,Misezero,TZ1601011,8221 ,3912 ,4309 ,8221 ,3912 ,0 ,0 ,0 ,4309 
United Republic of Tanzania,Jamhuri ya Muungano wa Tanzania,TZ,Kigoma,TZ16,Kibondo,TZ1601,Bitare,TZ1601021,10496 ,5032 ,5464 ,10496 ,5032 ,0 ,0 ,0 ,5464 
United Republic of Tanzania,Jamhuri ya Muungano wa Tanzania,TZ,Kigoma,TZ16,Kibondo,TZ1601,Kibondo,TZ1601033,39300 ,19215 ,20085 ,15089 ,7314 ,24211 ,11901 ,12310 ,7775 
United Republic of Tanzania,Jamhuri ya Muungano wa Tanzania,TZ,Kigoma,TZ16,Kibondo,TZ1601,Murungu,TZ1601041,7338 ,3552 ,3786 ,7338 ,3552 ,0 ,0 ,0 ,3786 
United Republic of Tanzania,Jamhuri ya Muungano wa Tanzania,TZ,Kigoma,TZ16,Kibondo,TZ1601,Busagara,TZ1601051,30722 ,14515 ,16207 ,30722 ,14515 ,0 ,0 ,0 ,16207 
United Republic of Tanzania,Jamhuri ya Muungano wa Tanzania,TZ,Kigoma,TZ16,Kibondo,TZ1601,Rugongwe,TZ1601061,27246 ,13017 ,14229 ,27246 ,13017 ,0 ,0 ,0 ,14229 
United Republic of Tanzania,Jamhuri ya Muungano wa Tanzania,TZ,Kigoma,TZ16,Kibondo,TZ1601,Busunzu,TZ1601071,23932 ,11519 ,12413 ,23932 ,11519 ,0 ,0 ,0 ,12413 
United Republic of Tanzania,Jamhuri ya Muungano wa Tanzania,TZ,Kigoma,TZ16,Kibondo,TZ1601,Kumsenga,TZ1601081,22641 ,10894 ,11747 ,22641 ,10894 ,0 ,0 ,0 ,11747 
United Republic of Tanzania,Jamhuri ya Muungano wa Tanzania,TZ,Kigoma,TZ16,Kibondo,TZ1601,Kizazi,TZ1601091,17734 ,8528 ,9206 ,17734 ,8528 ,0 ,0 ,0 ,9206 
United Republic of Tanzania,Jamhuri ya Muungano wa Tanzania,TZ,Kigoma,TZ16,Kibondo,TZ1601,Mabamba,TZ1601103,17580 ,8356 ,9224 ,11943 ,5648 ,5637 ,2708 ,2929 ,6295 
United Republic of Tanzania,Jamhuri ya Muungano wa Tanzania,TZ,Kigoma,TZ16,Kibondo,TZ1601,Bunyambo,TZ1601111,13563 ,6450 ,7113 ,13563 ,6450 ,0 ,0 ,0 ,7113 
United Republic of Tanzania,Jamhuri ya Muungano wa Tanzania,TZ,Kigoma,TZ16,Kibondo,TZ1601,Itaba,TZ1601121,18127 ,8701 ,9426 ,18127 ,8701 ,0 ,0 ,0 ,9426 
United Republic of Tanzania,Jamhuri ya Muungano wa Tanzania,TZ,Kigoma,TZ16,Kibondo,TZ1601,Kitahana,TZ1601131,24431 ,11593 ,12838 ,24431 ,11593 ,0 ,0 ,0 ,12838 
United Republic of Tanzania,Jamhuri ya Muungano wa Tanzania,TZ,Kigoma,TZ16,Kasulu,TZ1602,Kitanga,TZ1602011,20932 ,10266 ,10666 ,20932 ,10266 ,0 ,0 ,0 ,10666 
United Republic of Tanzania,Jamhuri ya Muungano wa Tanzania,TZ,Kigoma,TZ16,Kasulu,TZ1602,Heru Shingo,TZ1602021,18215 ,8809 ,9406 ,18215 ,8809 ,0 ,0 ,0 ,9406 
United Republic of Tanzania,Jamhuri ya Muungano wa Tanzania,TZ,Kigoma,TZ16,Kasulu,TZ1602,Nyamidaho,TZ1602031,18201 ,8929 ,9272 ,18201 ,8929 ,0 ,0 ,0 ,9272 
United Republic of Tanzania,Jamhuri ya Muungano wa Tanzania,TZ,Kigoma,TZ16,Kasulu,TZ1602,Kitagata,TZ1602041,105204 ,51264 ,53940 ,105204 ,51264 ,0 ,0 ,0 ,53940 
United Republic of Tanzania,Jamhuri ya Muungano wa Tanzania,TZ,Kigoma,TZ16,Kasulu,TZ1602,Nyachenda,TZ1602051,14304 ,6975 ,7329 ,14304 ,6975 ,0 ,0 ,0 ,7329 
United Republic of Tanzania,Jamhuri ya Muungano wa Tanzania,TZ,Kigoma,TZ16,Kasulu,TZ1602,Buhoro,TZ1602061,60120 ,29991 ,30129 ,60120 ,29991 ,0 ,0 ,0 ,30129 
United Republic of Tanzania,Jamhuri ya Muungano wa Tanzania,TZ,Kigoma,TZ16,Kasulu,TZ1602,Nyamnyusi,TZ1602071,16516 ,7835 ,8681 ,16516 ,7835 ,0 ,0 ,0 ,8681 
United Republic of Tanzania,Jamhuri ya Muungano wa Tanzania,TZ,Kigoma,TZ16,Kasulu,TZ1602,Nyakitonto,TZ1602081,19486 ,9551 ,9935 ,19486 ,9551 ,0 ,0 ,0 ,9935 
United Republic of Tanzania,Jamhuri ya Muungano wa Tanzania,TZ,Kigoma,TZ16,Kasulu,TZ1602,Kagerankanda,TZ1602091,13864 ,6919 ,6945 ,13864 ,6919 ,0 ,0 ,0 ,6945 
United Republic of Tanzania,Jamhuri ya Muungano wa Tanzania,TZ,Kigoma,TZ16,Kasulu,TZ1602,Kurugongo,TZ1602101,21817 ,10632 ,11185 ,21817 ,10632 ,0 ,0 ,0 ,11185 
United Republic of Tanzania,Jamhuri ya Muungano wa Tanzania,TZ,Kigoma,TZ16,Kasulu,TZ1602,Rungwe Mpya,TZ1602111,15206 ,7431 ,7775 ,15206 ,7431 ,0 ,0 ,0 ,7775 
United Republic of Tanzania,Jamhuri ya Muungano wa Tanzania,TZ,Kigoma,TZ16,Kasulu,TZ1602,Asante Nyerere,TZ1602121,7223 ,3658 ,3565 ,7223 ,3658 ,0 ,0 ,0 ,3565 
United Republic of Tanzania,Jamhuri ya Muungano wa Tanzania,TZ,Kigoma,TZ16,Kasulu,TZ1602,Titye,TZ1602131,11436 ,5440 ,5996 ,11436 ,5440 ,0 ,0 ,0 ,5996 
United Republic of Tanzania,Jamhuri ya Muungano wa Tanzania,TZ,Kigoma,TZ16,Kasulu,TZ1602,Shunguliba,TZ1602141,4462 ,2183 ,2279 ,4462 ,2183 ,0 ,0 ,0 ,2279 
United Republic of Tanzania,Jamhuri ya Muungano wa Tanzania,TZ,Kigoma,TZ16,Kasulu,TZ1602,Muzye,TZ1602151,12563 ,5928 ,6635 ,12563 ,5928 ,0 ,0 ,0 ,6635 
United Republic of Tanzania,Jamhuri ya Muungano wa Tanzania,TZ,Kigoma,TZ16,Kasulu,TZ1602,Bugaga,TZ1602161,14402 ,6757 ,7645 ,14402 ,6757 ,0 ,0 ,0 ,7645 
United Republic of Tanzania,Jamhuri ya Muungano wa Tanzania,TZ,Kigoma,TZ16,Kasulu,TZ1602,Kigembe,TZ1602171,13264 ,6408 ,6856 ,13264 ,6408 ,0 ,0 ,0 ,6856 
United Republic of Tanzania,Jamhuri ya Muungano wa Tanzania,TZ,Kigoma,TZ16,Kasulu,TZ1602,Rusesa,TZ1602183,19398 ,9281 ,10117 ,12115 ,5896 ,7283 ,3385 ,3898 ,6219 
United Republic of Tanzania,Jamhuri ya Muungano wa Tanzania,TZ,Kigoma,TZ16,Kasulu,TZ1602,Kwaga,TZ1602191,19181 ,9164 ,10017 ,19181 ,9164 ,0 ,0 ,0 ,10017 
United Republic of Tanzania,Jamhuri ya Muungano wa Tanzania,TZ,Kigoma,TZ16,Kigoma,TZ1603,Kagunga,TZ1603011,16972 ,8311 ,8661 ,16972 ,8311 ,0 ,0 ,0 ,8661 
United Republic of Tanzania,Jamhuri ya Muungano wa Tanzania,TZ,Kigoma,TZ16,Kigoma,TZ1603,Mkigo,TZ1603021,16252 ,7830 ,8422 ,16252 ,7830 ,0 ,0 ,0 ,8422 
United Republic of Tanzania,Jamhuri ya Muungano wa Tanzania,TZ,Kigoma,TZ16,Kigoma,TZ1603,Mwamgongo,TZ1603031,15657 ,7633 ,8024 ,15657 ,7633 ,0 ,0 ,0 ,8024 
United Republic of Tanzania,Jamhuri ya Muungano wa Tanzania,TZ,Kigoma,TZ16,Kigoma,TZ1603,Kalinzi,TZ1603041,27426 ,13134 ,14292 ,27426 ,13134 ,0 ,0 ,0 ,14292 
United Republic of Tanzania,Jamhuri ya Muungano wa Tanzania,TZ,Kigoma,TZ16,Kigoma,TZ1603,Bitale,TZ1603051,20425 ,9629 ,10796 ,20425 ,9629 ,0 ,0 ,0 ,10796 
United Republic of Tanzania,Jamhuri ya Muungano wa Tanzania,TZ,Kigoma,TZ16,Kigoma,TZ1603,Mkongoro,TZ1603061,18656 ,8859 ,9797 ,18656 ,8859 ,0 ,0 ,0 ,9797 
United Republic of Tanzania,Jamhuri ya Muungano wa Tanzania,TZ,Kigoma,TZ16,Kigoma,TZ1603,Mahembe,TZ1603071,22763 ,10952 ,11811 ,22763 ,10952 ,0 ,0 ,0 ,11811 
United Republic of Tanzania,Jamhuri ya Muungano wa Tanzania,TZ,Kigoma,TZ16,Kigoma,TZ1603,Matendo,TZ1603081,22458 ,10749 ,11709 ,22458 ,10749 ,0 ,0 ,0 ,11709 
United Republic of Tanzania,Jamhuri ya Muungano wa Tanzania,TZ,Kigoma,TZ16,Kigoma,TZ1603,Mungonya,TZ1603091,12644 ,6087 ,6557 ,12644 ,6087 ,0 ,0 ,0 ,6557 
United Republic of Tanzania,Jamhuri ya Muungano wa Tanzania,TZ,Kigoma,TZ16,Kigoma,TZ1603,Kagongo,TZ1603101,19407 ,9398 ,10009 ,19407 ,9398 ,0 ,0 ,0 ,10009 
United Republic of Tanzania,Jamhuri ya Muungano wa Tanzania,TZ,Kigoma,TZ16,Kigoma,TZ1603,Mwandiga,TZ1603113,18906 ,8917 ,9989 ,10959 ,5206 ,7947 ,3711 ,4236 ,5753 
United Republic of Tanzania,Jamhuri ya Muungano wa Tanzania,TZ,Kigoma,TZ16,Kigoma  Urban,TZ1604,Gungu,TZ1604012,25224 ,12194 ,13030 ,0 ,0 ,25224 ,12194 ,13030 ,0 
United Republic of Tanzania,Jamhuri ya Muungano wa Tanzania,TZ,Kigoma,TZ16,Kigoma  Urban,TZ1604,Kibirizi,TZ1604022,25143 ,12292 ,12851 ,0 ,0 ,25143 ,12292 ,12851 ,0 
United Republic of Tanzania,Jamhuri ya Muungano wa Tanzania,TZ,Kigoma,TZ16,Kigoma  Urban,TZ1604,Buhanda,TZ1604032,7629 ,3658 ,3971 ,0 ,0 ,7629 ,3658 ,3971 ,0 
United Republic of Tanzania,Jamhuri ya Muungano wa Tanzania,TZ,Kigoma,TZ16,Kigoma  Urban,TZ1604,Businde,TZ1604042,2436 ,1217 ,1219 ,0 ,0 ,2436 ,1217 ,1219 ,0 
United Republic of Tanzania,Jamhuri ya Muungano wa Tanzania,TZ,Kigoma,TZ16,Kigoma  Urban,TZ1604,Machinjioni,TZ1604052,3465 ,1675 ,1790 ,0 ,0 ,3465 ,1675 ,1790 ,0 
United Republic of Tanzania,Jamhuri ya Muungano wa Tanzania,TZ,Kigoma,TZ16,Kigoma  Urban,TZ1604,Kagera,TZ1604062,9040 ,4521 ,4519 ,0 ,0 ,9040 ,4521 ,4519 ,0 
United Republic of Tanzania,Jamhuri ya Muungano wa Tanzania,TZ,Kigoma,TZ16,Kigoma  Urban,TZ1604,Kasimbu,TZ1604072,4910 ,2360 ,2550 ,0 ,0 ,4910 ,2360 ,2550 ,0 
United Republic of Tanzania,Jamhuri ya Muungano wa Tanzania,TZ,Kigoma,TZ16,Kigoma  Urban,TZ1604,Rubuga,TZ1604082,2634 ,1290 ,1344 ,0 ,0 ,2634 ,1290 ,1344 ,0 
United Republic of Tanzania,Jamhuri ya Muungano wa Tanzania,TZ,Kigoma,TZ16,Kigoma  Urban,TZ1604,Kasingirima,TZ1604092,2867 ,1391 ,1476 ,0 ,0 ,2867 ,1391 ,1476 ,0 
United Republic of Tanzania,Jamhuri ya Muungano wa Tanzania,TZ,Kigoma,TZ16,Kigoma  Urban,TZ1604,Majengo,TZ1604102,4329 ,2049 ,2280 ,0 ,0 ,4329 ,2049 ,2280 ,0 
United Republic of Tanzania,Jamhuri ya Muungano wa Tanzania,TZ,Kigoma,TZ16,Kigoma  Urban,TZ1604,Kitongoni,TZ1604112,6973 ,3413 ,3560 ,0 ,0 ,6973 ,3413 ,3560 ,0 
United Republic of Tanzania,Jamhuri ya Muungano wa Tanzania,TZ,Kigoma,TZ16,Kigoma  Urban,TZ1604,Kipampa,TZ1604122,7917 ,3734 ,4183 ,0 ,0 ,7917 ,3734 ,4183 ,0 
United Republic of Tanzania,Jamhuri ya Muungano wa Tanzania,TZ,Kigoma,TZ16,Kigoma  Urban,TZ1604,Rusimbi,TZ1604132,6779 ,3220 ,3559 ,0 ,0 ,6779 ,3220 ,3559 ,0 
United Republic of Tanzania,Jamhuri ya Muungano wa Tanzania,TZ,Kigoma,TZ16,Kigoma  Urban,TZ1604,Buzebazeba,TZ1604142,18446 ,8743 ,9703 ,0 ,0 ,18446 ,8743 ,9703 ,0 
United Republic of Tanzania,Jamhuri ya Muungano wa Tanzania,TZ,Kigoma,TZ16,Kigoma  Urban,TZ1604,Mwanga Kusini,TZ1604152,16331 ,7774 ,8557 ,0 ,0 ,16331 ,7774 ,8557 ,0 
United Republic of Tanzania,Jamhuri ya Muungano wa Tanzania,TZ,Kigoma,TZ16,Kigoma  Urban,TZ1604,Kigoma,TZ1604162,6908 ,3419 ,3489 ,0 ,0 ,6908 ,3419 ,3489 ,0 
United Republic of Tanzania,Jamhuri ya Muungano wa Tanzania,TZ,Kigoma,TZ16,Kigoma  Urban,TZ1604,Bangwe,TZ1604172,15453 ,7782 ,7671 ,0 ,0 ,15453 ,7782 ,7671 ,0 
United Republic of Tanzania,Jamhuri ya Muungano wa Tanzania,TZ,Kigoma,TZ16,Kigoma  Urban,TZ1604,Mwanga Kaskazini,TZ1604182,24184 ,11555 ,12629 ,0 ,0 ,24184 ,11555 ,12629 ,0 
United Republic of Tanzania,Jamhuri ya Muungano wa Tanzania,TZ,Kigoma,TZ16,Kigoma  Urban,TZ1604,Katubuka,TZ1604192,24790 ,11898 ,12892 ,0 ,0 ,24790 ,11898 ,12892 ,0 
United Republic of Tanzania,Jamhuri ya Muungano wa Tanzania,TZ,Kigoma,TZ16,Uvinza,TZ1605,Kalya,TZ1605011,22486 ,11238 ,11248 ,22486 ,11238 ,0 ,0 ,0 ,11248 
United Republic of Tanzania,Jamhuri ya Muungano wa Tanzania,TZ,Kigoma,TZ16,Uvinza,TZ1605,Buhingu,TZ1605021,16973 ,8456 ,8517 ,16973 ,8456 ,0 ,0 ,0 ,8517 
United Republic of Tanzania,Jamhuri ya Muungano wa Tanzania,TZ,Kigoma,TZ16,Uvinza,TZ1605,Igalula,TZ1605031,23868 ,11839 ,12029 ,23868 ,11839 ,0 ,0 ,0 ,12029 
United Republic of Tanzania,Jamhuri ya Muungano wa Tanzania,TZ,Kigoma,TZ16,Uvinza,TZ1605,Sigunga,TZ1605041,20455 ,10154 ,10301 ,20455 ,10154 ,0 ,0 ,0 ,10301 
United Republic of Tanzania,Jamhuri ya Muungano wa Tanzania,TZ,Kigoma,TZ16,Uvinza,TZ1605,Sunuka,TZ1605051,36023 ,17572 ,18451 ,36023 ,17572 ,0 ,0 ,0 ,18451 
United Republic of Tanzania,Jamhuri ya Muungano wa Tanzania,TZ,Kigoma,TZ16,Uvinza,TZ1605,Ilagala,TZ1605061,47026 ,23360 ,23666 ,47026 ,23360 ,0 ,0 ,0 ,23666 
United Republic of Tanzania,Jamhuri ya Muungano wa Tanzania,TZ,Kigoma,TZ16,Uvinza,TZ1605,Simbo,TZ1605071,31650 ,15495 ,16155 ,31650 ,15495 ,0 ,0 ,0 ,16155 
United Republic of Tanzania,Jamhuri ya Muungano wa Tanzania,TZ,Kigoma,TZ16,Uvinza,TZ1605,Kandaga,TZ1605081,23696 ,11223 ,12473 ,23696 ,11223 ,0 ,0 ,0 ,12473 
United Republic of Tanzania,Jamhuri ya Muungano wa Tanzania,TZ,Kigoma,TZ16,Uvinza,TZ1605,Kazuramimba,TZ1605091,34115 ,16656 ,17459 ,34115 ,16656 ,0 ,0 ,0 ,17459 
United Republic of Tanzania,Jamhuri ya Muungano wa Tanzania,TZ,Kigoma,TZ16,Uvinza,TZ1605,Uvinza,TZ1605103,35231 ,17637 ,17594 ,25803 ,13060 ,9428 ,4577 ,4851 ,12743 
United Republic of Tanzania,Jamhuri ya Muungano wa Tanzania,TZ,Kigoma,TZ16,Uvinza,TZ1605,Mganza,TZ1605111,24823 ,12403 ,12420 ,24823 ,12403 ,0 ,0 ,0 ,12420 
United Republic of Tanzania,Jamhuri ya Muungano wa Tanzania,TZ,Kigoma,TZ16,Uvinza,TZ1605,Mtego wa Noti,TZ1605121,15308 ,7685 ,7623 ,15308 ,7685 ,0 ,0 ,0 ,7623 
United Republic of Tanzania,Jamhuri ya Muungano wa Tanzania,TZ,Kigoma,TZ16,Uvinza,TZ1605,Nguruka,TZ1605133,27179 ,13128 ,14051 ,4961 ,2411 ,22218 ,10717 ,11501 ,2550 
United Republic of Tanzania,Jamhuri ya Muungano wa Tanzania,TZ,Kigoma,TZ16,Uvinza,TZ1605,Itebula,TZ1605141,24807 ,12284 ,12523 ,24807 ,12284 ,0 ,0 ,0 ,12523 
United Republic of Tanzania,Jamhuri ya Muungano wa Tanzania,TZ,Kigoma,TZ16,Buhigwe,TZ1606,Nyamugali,TZ1606011,10705 ,4970 ,5735 ,10705 ,4970 ,0 ,0 ,0 ,5735 
United Republic of Tanzania,Jamhuri ya Muungano wa Tanzania,TZ,Kigoma,TZ16,Buhigwe,TZ1606,Biharu,TZ1606021,8880 ,4099 ,4781 ,8880 ,4099 ,0 ,0 ,0 ,4781 
United Republic of Tanzania,Jamhuri ya Muungano wa Tanzania,TZ,Kigoma,TZ16,Buhigwe,TZ1606,Muyama,TZ1606031,10436 ,5011 ,5425 ,10436 ,5011 ,0 ,0 ,0 ,5425 
United Republic of Tanzania,Jamhuri ya Muungano wa Tanzania,TZ,Kigoma,TZ16,Buhigwe,TZ1606,Kajana,TZ1606041,13383 ,6427 ,6956 ,13383 ,6427 ,0 ,0 ,0 ,6956 
United Republic of Tanzania,Jamhuri ya Muungano wa Tanzania,TZ,Kigoma,TZ16,Buhigwe,TZ1606,Mugera,TZ1606051,15698 ,7579 ,8119 ,15698 ,7579 ,0 ,0 ,0 ,8119 
United Republic of Tanzania,Jamhuri ya Muungano wa Tanzania,TZ,Kigoma,TZ16,Buhigwe,TZ1606,Kilelema,TZ1606061,15523 ,7435 ,8088 ,15523 ,7435 ,0 ,0 ,0 ,8088 
United Republic of Tanzania,Jamhuri ya Muungano wa Tanzania,TZ,Kigoma,TZ16,Buhigwe,TZ1606,Munyegera,TZ1606071,13447 ,6272 ,7175 ,13447 ,6272 ,0 ,0 ,0 ,7175 
United Republic of Tanzania,Jamhuri ya Muungano wa Tanzania,TZ,Kigoma,TZ16,Buhigwe,TZ1606,Buhigwe,TZ1606081,15224 ,7230 ,7994 ,15224 ,7230 ,0 ,0 ,0 ,7994 
United Republic of Tanzania,Jamhuri ya Muungano wa Tanzania,TZ,Kigoma,TZ16,Buhigwe,TZ1606,Kibande,TZ1606091,9852 ,4523 ,5329 ,9852 ,4523 ,0 ,0 ,0 ,5329 
United Republic of Tanzania,Jamhuri ya Muungano wa Tanzania,TZ,Kigoma,TZ16,Buhigwe,TZ1606,Janda,TZ1606101,28854 ,13694 ,15160 ,28854 ,13694 ,0 ,0 ,0 ,15160 
United Republic of Tanzania,Jamhuri ya Muungano wa Tanzania,TZ,Kigoma,TZ16,Buhigwe,TZ1606,Munzeze,TZ1606111,18934 ,9077 ,9857 ,18934 ,9077 ,0 ,0 ,0 ,9857 
United Republic of Tanzania,Jamhuri ya Muungano wa Tanzania,TZ,Kigoma,TZ16,Buhigwe,TZ1606,Rusaba,TZ1606121,20997 ,9817 ,11180 ,20997 ,9817 ,0 ,0 ,0 ,11180 
United Republic of Tanzania,Jamhuri ya Muungano wa Tanzania,TZ,Kigoma,TZ16,Buhigwe,TZ1606,Muhinda,TZ1606131,18211 ,8623 ,9588 ,18211 ,8623 ,0 ,0 ,0 ,9588 
United Republic of Tanzania,Jamhuri ya Muungano wa Tanzania,TZ,Kigoma,TZ16,Buhigwe,TZ1606,Munanila,TZ1606141,33782 ,16308 ,17474 ,33782 ,16308 ,0 ,0 ,0 ,17474 
United Republic of Tanzania,Jamhuri ya Muungano wa Tanzania,TZ,Kigoma,TZ16,Buhigwe,TZ1606,Mwayaya,TZ1606151,20416 ,9625 ,10791 ,20416 ,9625 ,0 ,0 ,0 ,10791 
United Republic of Tanzania,Jamhuri ya Muungano wa Tanzania,TZ,Kigoma,TZ16,Kakonko,TZ1607,Nyabibuye,TZ1607011,10046 ,4840 ,5206 ,10046 ,4840 ,0 ,0 ,0 ,5206 
United Republic of Tanzania,Jamhuri ya Muungano wa Tanzania,TZ,Kigoma,TZ16,Kakonko,TZ1607,Nyamtukuza,TZ1607021,15102 ,7677 ,7425 ,15102 ,7677 ,0 ,0 ,0 ,7425 
United Republic of Tanzania,Jamhuri ya Muungano wa Tanzania,TZ,Kigoma,TZ16,Kakonko,TZ1607,Muhange,TZ1607031,24195 ,11867 ,12328 ,24195 ,11867 ,0 ,0 ,0 ,12328 
United Republic of Tanzania,Jamhuri ya Muungano wa Tanzania,TZ,Kigoma,TZ16,Kakonko,TZ1607,Kasunga,TZ1607041,67704 ,32464 ,35240 ,0 ,0 ,67704 ,32464 ,35240 ,0 
United Republic of Tanzania,Jamhuri ya Muungano wa Tanzania,TZ,Kigoma,TZ16,Kakonko,TZ1607,Kakonko,TZ1607053,21827 ,10657 ,11170 ,16452 ,8064 ,5375 ,2593 ,2782 ,8388 
United Republic of Tanzania,Jamhuri ya Muungano wa Tanzania,TZ,Kigoma,TZ16,Kakonko,TZ1607,Kiziguzigu,TZ1607061,12900 ,6381 ,6519 ,12900 ,6381 ,0 ,0 ,0 ,6519 
United Republic of Tanzania,Jamhuri ya Muungano wa Tanzania,TZ,Kigoma,TZ16,Kakonko,TZ1607,Rugenge,TZ1607071,10871 ,5139 ,5732 ,10871 ,5139 ,0 ,0 ,0 ,5732 
United Republic of Tanzania,Jamhuri ya Muungano wa Tanzania,TZ,Kigoma,TZ16,Kakonko,TZ1607,Kasanda,TZ1607081,18717 ,9275 ,9442 ,18717 ,9275 ,0 ,0 ,0 ,9442 
United Republic of Tanzania,Jamhuri ya Muungano wa Tanzania,TZ,Kigoma,TZ16,Kakonko,TZ1607,Gwamumpu,TZ1607091,14756 ,6856 ,7900 ,14756 ,6856 ,0 ,0 ,0 ,7900 
United Republic of Tanzania,Jamhuri ya Muungano wa Tanzania,TZ,Kigoma,TZ16,Kakonko,TZ1607,Katanga,TZ1607101,10668 ,5055 ,5613 ,10668 ,5055 ,0 ,0 ,0 ,5613 
United Republic of Tanzania,Jamhuri ya Muungano wa Tanzania,TZ,Kigoma,TZ16,Kakonko,TZ1607,Mugunzu,TZ1607111,11920 ,5634 ,6286 ,11920 ,5634 ,0 ,0 ,0 ,6286 
United Republic of Tanzania,Jamhuri ya Muungano wa Tanzania,TZ,Kigoma,TZ16,Kasulu Township Authority,TZ1608,Muganza,TZ1608011,17940 ,8451 ,9489 ,17940 ,8451 ,0 ,0 ,0 ,9489 
United Republic of Tanzania,Jamhuri ya Muungano wa Tanzania,TZ,Kigoma,TZ16,Kasulu Township Authority,TZ1608,Kigondo,TZ1608021,16489 ,8031 ,8458 ,16489 ,8031 ,0 ,0 ,0 ,8458 
United Republic of Tanzania,Jamhuri ya Muungano wa Tanzania,TZ,Kigoma,TZ16,Kasulu Township Authority,TZ1608,Msambara,TZ1608031,22391 ,10621 ,11770 ,22391 ,10621 ,0 ,0 ,0 ,11770 
United Republic of Tanzania,Jamhuri ya Muungano wa Tanzania,TZ,Kigoma,TZ16,Kasulu Township Authority,TZ1608,Ruhita,TZ1608041,16345 ,7802 ,8543 ,16345 ,7802 ,0 ,0 ,0 ,8543 
United Republic of Tanzania,Jamhuri ya Muungano wa Tanzania,TZ,Kigoma,TZ16,Kasulu Township Authority,TZ1608,Nyumbigwa,TZ1608051,11639 ,5505 ,6134 ,11639 ,5505 ,0 ,0 ,0 ,6134 
United Republic of Tanzania,Jamhuri ya Muungano wa Tanzania,TZ,Kigoma,TZ16,Kasulu Township Authority,TZ1608,Murufiti,TZ1608061,9495 ,4615 ,4880 ,9495 ,4615 ,0 ,0 ,0 ,4880 
United Republic of Tanzania,Jamhuri ya Muungano wa Tanzania,TZ,Kigoma,TZ16,Kasulu Township Authority,TZ1608,Nyansha,TZ1608071,13406 ,6379 ,7027 ,13406 ,6379 ,0 ,0 ,0 ,7027 
United Republic of Tanzania,Jamhuri ya Muungano wa Tanzania,TZ,Kigoma,TZ16,Kasulu Township Authority,TZ1608,Kasulu Mjini,TZ1608082,16553 ,8036 ,8517 ,16553 ,8036 ,0 ,0 ,0 ,8517 
United Republic of Tanzania,Jamhuri ya Muungano wa Tanzania,TZ,Kigoma,TZ16,Kasulu Township Authority,TZ1608,Muhunga,TZ1608091,32835 ,15500 ,17335 ,32835 ,15500 ,0 ,0 ,0 ,17335 
United Republic of Tanzania,Jamhuri ya Muungano wa Tanzania,TZ,Shinyanga,TZ17,Shinyanga Urban,TZ1701,Mwamalili,TZ1701011,7100 ,3583 ,3517 ,7100 ,3583 ,0 ,0 ,0 ,3517 
United Republic of Tanzania,Jamhuri ya Muungano wa Tanzania,TZ,Shinyanga,TZ17,Shinyanga Urban,TZ1701,Kolandoto,TZ1701021,11301 ,5462 ,5839 ,11301 ,5462 ,0 ,0 ,0 ,5839 
United Republic of Tanzania,Jamhuri ya Muungano wa Tanzania,TZ,Shinyanga,TZ17,Shinyanga Urban,TZ1701,Ngokolo,TZ1701032,19658 ,9314 ,10344 ,0 ,0 ,19658 ,9314 ,10344 ,0 
United Republic of Tanzania,Jamhuri ya Muungano wa Tanzania,TZ,Shinyanga,TZ17,Shinyanga Urban,TZ1701,Ibadakuli,TZ1701043,12537 ,6290 ,6247 ,10696 ,5391 ,1841 ,899 ,942 ,5305 
United Republic of Tanzania,Jamhuri ya Muungano wa Tanzania,TZ,Shinyanga,TZ17,Shinyanga Urban,TZ1701,Shinyanga Mjini,TZ1701052,5402 ,2632 ,2770 ,0 ,0 ,5402 ,2632 ,2770 ,0 
United Republic of Tanzania,Jamhuri ya Muungano wa Tanzania,TZ,Shinyanga,TZ17,Shinyanga Urban,TZ1701,Chamaguha,TZ1701062,5218 ,2669 ,2549 ,0 ,0 ,5218 ,2669 ,2549 ,0 
United Republic of Tanzania,Jamhuri ya Muungano wa Tanzania,TZ,Shinyanga,TZ17,Shinyanga Urban,TZ1701,Ibinzamata,TZ1701072,5061 ,2462 ,2599 ,0 ,0 ,5061 ,2462 ,2599 ,0 
United Republic of Tanzania,Jamhuri ya Muungano wa Tanzania,TZ,Shinyanga,TZ17,Shinyanga Urban,TZ1701,Kitangili,TZ1701082,8338 ,4063 ,4275 ,0 ,0 ,8338 ,4063 ,4275 ,0 
United Republic of Tanzania,Jamhuri ya Muungano wa Tanzania,TZ,Shinyanga,TZ17,Shinyanga Urban,TZ1701,Kizumbi,TZ1701091,11264 ,5619 ,5645 ,11264 ,5619 ,0 ,0 ,0 ,5645 
United Republic of Tanzania,Jamhuri ya Muungano wa Tanzania,TZ,Shinyanga,TZ17,Shinyanga Urban,TZ1701,Mwawaza,TZ1701101,5665 ,2766 ,2899 ,5665 ,2766 ,0 ,0 ,0 ,2899 
United Republic of Tanzania,Jamhuri ya Muungano wa Tanzania,TZ,Shinyanga,TZ17,Shinyanga Urban,TZ1701,Ndala,TZ1701112,9432 ,4555 ,4877 ,0 ,0 ,9432 ,4555 ,4877 ,0 
United Republic of Tanzania,Jamhuri ya Muungano wa Tanzania,TZ,Shinyanga,TZ17,Shinyanga Urban,TZ1701,Kambarage,TZ1701122,13796 ,6649 ,7147 ,0 ,0 ,13796 ,6649 ,7147 ,0 
United Republic of Tanzania,Jamhuri ya Muungano wa Tanzania,TZ,Shinyanga,TZ17,Shinyanga Urban,TZ1701,Chibe,TZ1701133,5840 ,2917 ,2923 ,5840 ,2917 ,0 ,0 ,0 ,2923 
United Republic of Tanzania,Jamhuri ya Muungano wa Tanzania,TZ,Shinyanga,TZ17,Shinyanga Urban,TZ1701,Lubaga,TZ1701142,7042 ,3402 ,3640 ,0 ,0 ,7042 ,3402 ,3640 ,0 
United Republic of Tanzania,Jamhuri ya Muungano wa Tanzania,TZ,Shinyanga,TZ17,Shinyanga Urban,TZ1701,Ndembezi,TZ1701152,14837 ,7111 ,7726 ,0 ,0 ,14837 ,7111 ,7726 ,0 
United Republic of Tanzania,Jamhuri ya Muungano wa Tanzania,TZ,Shinyanga,TZ17,Shinyanga Urban,TZ1701,Masekelo,TZ1701162,8787 ,4252 ,4535 ,0 ,0 ,8787 ,4252 ,4535 ,0 
United Republic of Tanzania,Jamhuri ya Muungano wa Tanzania,TZ,Shinyanga,TZ17,Shinyanga Urban,TZ1701,Old Shinyanga,TZ1701173,10113 ,4909 ,5204 ,5730 ,2804 ,4383 ,2105 ,2278 ,2926 
United Republic of Tanzania,Jamhuri ya Muungano wa Tanzania,TZ,Shinyanga,TZ17,Kishapu,TZ1702,Bunambiyu,TZ1702011,12226 ,5920 ,6306 ,12226 ,5920 ,0 ,0 ,0 ,6306 
United Republic of Tanzania,Jamhuri ya Muungano wa Tanzania,TZ,Shinyanga,TZ17,Kishapu,TZ1702,Bubiki,TZ1702021,20038 ,9922 ,10116 ,20038 ,9922 ,0 ,0 ,0 ,10116 
United Republic of Tanzania,Jamhuri ya Muungano wa Tanzania,TZ,Shinyanga,TZ17,Kishapu,TZ1702,Songwa,TZ1702033,19257 ,9788 ,9469 ,10919 ,5461 ,8338 ,4327 ,4011 ,5458 
United Republic of Tanzania,Jamhuri ya Muungano wa Tanzania,TZ,Shinyanga,TZ17,Kishapu,TZ1702,Seke Bugoro,TZ1702041,16616 ,8011 ,8605 ,16616 ,8011 ,0 ,0 ,0 ,8605 
United Republic of Tanzania,Jamhuri ya Muungano wa Tanzania,TZ,Shinyanga,TZ17,Kishapu,TZ1702,Mondo,TZ1702051,15302 ,7547 ,7755 ,15302 ,7547 ,0 ,0 ,0 ,7755 
United Republic of Tanzania,Jamhuri ya Muungano wa Tanzania,TZ,Shinyanga,TZ17,Kishapu,TZ1702,Mwadui Lohumbo,TZ1702063,22785 ,11470 ,11315 ,17680 ,8927 ,5105 ,2543 ,2562 ,8753 
United Republic of Tanzania,Jamhuri ya Muungano wa Tanzania,TZ,Shinyanga,TZ17,Kishapu,TZ1702,Uchunga,TZ1702071,16406 ,8123 ,8283 ,16406 ,8123 ,0 ,0 ,0 ,8283 
United Republic of Tanzania,Jamhuri ya Muungano wa Tanzania,TZ,Shinyanga,TZ17,Kishapu,TZ1702,Kishapu,TZ1702083,19347 ,9472 ,9875 ,13919 ,6916 ,5428 ,2556 ,2872 ,7003 
United Republic of Tanzania,Jamhuri ya Muungano wa Tanzania,TZ,Shinyanga,TZ17,Kishapu,TZ1702,Mwakipoya,TZ1702091,10040 ,4971 ,5069 ,10040 ,4971 ,0 ,0 ,0 ,5069 
United Republic of Tanzania,Jamhuri ya Muungano wa Tanzania,TZ,Shinyanga,TZ17,Kishapu,TZ1702,Shagihilu,TZ1702101,13126 ,6522 ,6604 ,13126 ,6522 ,0 ,0 ,0 ,6604 
United Republic of Tanzania,Jamhuri ya Muungano wa Tanzania,TZ,Shinyanga,TZ17,Kishapu,TZ1702,Somagedi,TZ1702111,7428 ,3697 ,3731 ,7428 ,3697 ,0 ,0 ,0 ,3731 
United Republic of Tanzania,Jamhuri ya Muungano wa Tanzania,TZ,Shinyanga,TZ17,Kishapu,TZ1702,Mwamalasa,TZ1702121,13195 ,6518 ,6677 ,13195 ,6518 ,0 ,0 ,0 ,6677 
United Republic of Tanzania,Jamhuri ya Muungano wa Tanzania,TZ,Shinyanga,TZ17,Kishapu,TZ1702,Masanga,TZ1702131,14444 ,7163 ,7281 ,14444 ,7163 ,0 ,0 ,0 ,7281 
United Republic of Tanzania,Jamhuri ya Muungano wa Tanzania,TZ,Shinyanga,TZ17,Kishapu,TZ1702,Lagana,TZ1702141,10020 ,5037 ,4983 ,10020 ,5037 ,0 ,0 ,0 ,4983 
United Republic of Tanzania,Jamhuri ya Muungano wa Tanzania,TZ,Shinyanga,TZ17,Kishapu,TZ1702,Mwamashele,TZ1702151,8812 ,4317 ,4495 ,8812 ,4317 ,0 ,0 ,0 ,4495 
United Republic of Tanzania,Jamhuri ya Muungano wa Tanzania,TZ,Shinyanga,TZ17,Kishapu,TZ1702,Ngofila,TZ1702161,10598 ,5239 ,5359 ,10598 ,5239 ,0 ,0 ,0 ,5359 
United Republic of Tanzania,Jamhuri ya Muungano wa Tanzania,TZ,Shinyanga,TZ17,Kishapu,TZ1702,Kiloleli,TZ1702171,6059 ,2981 ,3078 ,6059 ,2981 ,0 ,0 ,0 ,3078 
United Republic of Tanzania,Jamhuri ya Muungano wa Tanzania,TZ,Shinyanga,TZ17,Kishapu,TZ1702,Ukenyenge,TZ1702181,15304 ,7723 ,7581 ,15304 ,7723 ,0 ,0 ,0 ,7581 
United Republic of Tanzania,Jamhuri ya Muungano wa Tanzania,TZ,Shinyanga,TZ17,Kishapu,TZ1702,Talaga,TZ1702191,9773 ,4815 ,4958 ,9773 ,4815 ,0 ,0 ,0 ,4958 
United Republic of Tanzania,Jamhuri ya Muungano wa Tanzania,TZ,Shinyanga,TZ17,Kishapu,TZ1702,Itilima,TZ1702201,12214 ,6033 ,6181 ,12214 ,6033 ,0 ,0 ,0 ,6181 
United Republic of Tanzania,Jamhuri ya Muungano wa Tanzania,TZ,Shinyanga,TZ17,Shinyanga,TZ1703,Imesela,TZ1703011,9052 ,4489 ,4563 ,9052 ,4489 ,0 ,0 ,0 ,4563 
United Republic of Tanzania,Jamhuri ya Muungano wa Tanzania,TZ,Shinyanga,TZ17,Shinyanga,TZ1703,Usule,TZ1703021,5945 ,2929 ,3016 ,5945 ,2929 ,0 ,0 ,0 ,3016 
United Republic of Tanzania,Jamhuri ya Muungano wa Tanzania,TZ,Shinyanga,TZ17,Shinyanga,TZ1703,Ilola,TZ1703031,10068 ,4864 ,5204 ,10068 ,4864 ,0 ,0 ,0 ,5204 
United Republic of Tanzania,Jamhuri ya Muungano wa Tanzania,TZ,Shinyanga,TZ17,Shinyanga,TZ1703,Didia,TZ1703041,10666 ,5169 ,5497 ,10666 ,5169 ,0 ,0 ,0 ,5497 
United Republic of Tanzania,Jamhuri ya Muungano wa Tanzania,TZ,Shinyanga,TZ17,Shinyanga,TZ1703,Itwangi,TZ1703051,10037 ,4963 ,5074 ,10037 ,4963 ,0 ,0 ,0 ,5074 
United Republic of Tanzania,Jamhuri ya Muungano wa Tanzania,TZ,Shinyanga,TZ17,Shinyanga,TZ1703,Tinde,TZ1703063,14978 ,7377 ,7601 ,12118 ,6028 ,2860 ,1349 ,1511 ,6090 
United Republic of Tanzania,Jamhuri ya Muungano wa Tanzania,TZ,Shinyanga,TZ17,Shinyanga,TZ1703,Mwakitolyoo,TZ1703071,20191 ,10217 ,9974 ,20191 ,10217 ,0 ,0 ,0 ,9974 
United Republic of Tanzania,Jamhuri ya Muungano wa Tanzania,TZ,Shinyanga,TZ17,Shinyanga,TZ1703,Salawe,TZ1703081,17247 ,8370 ,8877 ,17247 ,8370 ,0 ,0 ,0 ,8877 
United Republic of Tanzania,Jamhuri ya Muungano wa Tanzania,TZ,Shinyanga,TZ17,Shinyanga,TZ1703,Solwa,TZ1703091,22218 ,10855 ,11363 ,22218 ,10855 ,0 ,0 ,0 ,11363 
United Republic of Tanzania,Jamhuri ya Muungano wa Tanzania,TZ,Shinyanga,TZ17,Shinyanga,TZ1703,Iselamagazi,TZ1703101,18465 ,8748 ,9717 ,18465 ,8748 ,0 ,0 ,0 ,9717 
United Republic of Tanzania,Jamhuri ya Muungano wa Tanzania,TZ,Shinyanga,TZ17,Shinyanga,TZ1703,Lyabukande,TZ1703111,19492 ,9368 ,10124 ,19492 ,9368 ,0 ,0 ,0 ,10124 
United Republic of Tanzania,Jamhuri ya Muungano wa Tanzania,TZ,Shinyanga,TZ17,Shinyanga,TZ1703,Mwantini,TZ1703121,6693 ,3227 ,3466 ,6693 ,3227 ,0 ,0 ,0 ,3466 
United Republic of Tanzania,Jamhuri ya Muungano wa Tanzania,TZ,Shinyanga,TZ17,Shinyanga,TZ1703,Pandagichiza,TZ1703131,11082 ,5321 ,5761 ,11082 ,5321 ,0 ,0 ,0 ,5761 
United Republic of Tanzania,Jamhuri ya Muungano wa Tanzania,TZ,Shinyanga,TZ17,Shinyanga,TZ1703,Mwamala,TZ1703141,10021 ,4879 ,5142 ,10021 ,4879 ,0 ,0 ,0 ,5142 
United Republic of Tanzania,Jamhuri ya Muungano wa Tanzania,TZ,Shinyanga,TZ17,Shinyanga,TZ1703,Samuye,TZ1703151,11080 ,5409 ,5671 ,11080 ,5409 ,0 ,0 ,0 ,5671 
United Republic of Tanzania,Jamhuri ya Muungano wa Tanzania,TZ,Shinyanga,TZ17,Shinyanga,TZ1703,Usanda,TZ1703161,13715 ,6765 ,6950 ,13715 ,6765 ,0 ,0 ,0 ,6950 
United Republic of Tanzania,Jamhuri ya Muungano wa Tanzania,TZ,Shinyanga,TZ17,Shinyanga,TZ1703,Puni,TZ1703171,4492 ,2212 ,2280 ,4492 ,2212 ,0 ,0 ,0 ,2280 
United Republic of Tanzania,Jamhuri ya Muungano wa Tanzania,TZ,Shinyanga,TZ17,Shinyanga,TZ1703,Nyida,TZ1703181,6221 ,3053 ,3168 ,6221 ,3053 ,0 ,0 ,0 ,3168 
United Republic of Tanzania,Jamhuri ya Muungano wa Tanzania,TZ,Shinyanga,TZ17,Shinyanga,TZ1703,Nsalala,TZ1703191,8313 ,4069 ,4244 ,8313 ,4069 ,0 ,0 ,0 ,4244 
United Republic of Tanzania,Jamhuri ya Muungano wa Tanzania,TZ,Shinyanga,TZ17,Shinyanga,TZ1703,Bukene,TZ1703201,7723 ,3872 ,3851 ,7723 ,3872 ,0 ,0 ,0 ,3851 
United Republic of Tanzania,Jamhuri ya Muungano wa Tanzania,TZ,Shinyanga,TZ17,Shinyanga,TZ1703,Masengwa,TZ1703211,10539 ,5190 ,5349 ,10539 ,5190 ,0 ,0 ,0 ,5349 
United Republic of Tanzania,Jamhuri ya Muungano wa Tanzania,TZ,Shinyanga,TZ17,Shinyanga,TZ1703,Mwenge,TZ1703221,16530 ,8163 ,8367 ,16530 ,8163 ,0 ,0 ,0 ,8367 
United Republic of Tanzania,Jamhuri ya Muungano wa Tanzania,TZ,Shinyanga,TZ17,Shinyanga,TZ1703,Lyabusalu,TZ1703231,24785 ,11815 ,12970 ,24785 ,11815 ,0 ,0 ,0 ,12970 
United Republic of Tanzania,Jamhuri ya Muungano wa Tanzania,TZ,Shinyanga,TZ17,Shinyanga,TZ1703,Mwalukwa,TZ1703241,8008 ,3878 ,4130 ,8008 ,3878 ,0 ,0 ,0 ,4130 
United Republic of Tanzania,Jamhuri ya Muungano wa Tanzania,TZ,Shinyanga,TZ17,Shinyanga,TZ1703,Nyamalogo,TZ1703251,15361 ,7355 ,8006 ,15361 ,7355 ,0 ,0 ,0 ,8006 
United Republic of Tanzania,Jamhuri ya Muungano wa Tanzania,TZ,Shinyanga,TZ17,Shinyanga,TZ1703,Lyamidati,TZ1703261,21495 ,10399 ,11096 ,21495 ,10399 ,0 ,0 ,0 ,11096 
United Republic of Tanzania,Jamhuri ya Muungano wa Tanzania,TZ,Shinyanga,TZ17,Kahama,TZ1704,Bulyanhulu,TZ1704013,25330 ,12761 ,12569 ,9269 ,4802 ,16061 ,7959 ,8102 ,4467 
United Republic of Tanzania,Jamhuri ya Muungano wa Tanzania,TZ,Shinyanga,TZ17,Kahama,TZ1704,Bugarama,TZ1704023,18271 ,8968 ,9303 ,15876 ,7825 ,2395 ,1143 ,1252 ,8051 
United Republic of Tanzania,Jamhuri ya Muungano wa Tanzania,TZ,Shinyanga,TZ17,Kahama,TZ1704,Lunguya,TZ1704031,19307 ,9488 ,9819 ,19307 ,9488 ,0 ,0 ,0 ,9819 
United Republic of Tanzania,Jamhuri ya Muungano wa Tanzania,TZ,Shinyanga,TZ17,Kahama,TZ1704,Shilela,TZ1704041,9795 ,4788 ,5007 ,9795 ,4788 ,0 ,0 ,0 ,5007 
United Republic of Tanzania,Jamhuri ya Muungano wa Tanzania,TZ,Shinyanga,TZ17,Kahama,TZ1704,Segese,TZ1704053,18364 ,8930 ,9434 ,11736 ,5803 ,6628 ,3127 ,3501 ,5933 
United Republic of Tanzania,Jamhuri ya Muungano wa Tanzania,TZ,Shinyanga,TZ17,Kahama,TZ1704,Mega,TZ1704061,9967 ,4739 ,5228 ,9967 ,4739 ,0 ,0 ,0 ,5228 
United Republic of Tanzania,Jamhuri ya Muungano wa Tanzania,TZ,Shinyanga,TZ17,Kahama,TZ1704,Chela,TZ1704071,20760 ,10121 ,10639 ,20760 ,10121 ,0 ,0 ,0 ,10639 
United Republic of Tanzania,Jamhuri ya Muungano wa Tanzania,TZ,Shinyanga,TZ17,Kahama,TZ1704,Busangi,TZ1704081,11507 ,5712 ,5795 ,11507 ,5712 ,0 ,0 ,0 ,5795 
United Republic of Tanzania,Jamhuri ya Muungano wa Tanzania,TZ,Shinyanga,TZ17,Kahama,TZ1704,Ntobo,TZ1704091,10089 ,4889 ,5200 ,10089 ,4889 ,0 ,0 ,0 ,5200 
United Republic of Tanzania,Jamhuri ya Muungano wa Tanzania,TZ,Shinyanga,TZ17,Kahama,TZ1704,Ngaya,TZ1704101,12681 ,6283 ,6398 ,12681 ,6283 ,0 ,0 ,0 ,6398 
United Republic of Tanzania,Jamhuri ya Muungano wa Tanzania,TZ,Shinyanga,TZ17,Kahama,TZ1704,Bulige,TZ1704111,10505 ,4992 ,5513 ,10505 ,4992 ,0 ,0 ,0 ,5513 
United Republic of Tanzania,Jamhuri ya Muungano wa Tanzania,TZ,Shinyanga,TZ17,Kahama,TZ1704,Kashishi,TZ1704121,13410 ,6392 ,7018 ,13410 ,6392 ,0 ,0 ,0 ,7018 
United Republic of Tanzania,Jamhuri ya Muungano wa Tanzania,TZ,Shinyanga,TZ17,Kahama,TZ1704,Mwanase,TZ1704131,14898 ,7024 ,7874 ,14898 ,7024 ,0 ,0 ,0 ,7874 
United Republic of Tanzania,Jamhuri ya Muungano wa Tanzania,TZ,Shinyanga,TZ17,Kahama,TZ1704,Mwalugulu,TZ1704141,18054 ,8745 ,9309 ,18054 ,8745 ,0 ,0 ,0 ,9309 
United Republic of Tanzania,Jamhuri ya Muungano wa Tanzania,TZ,Shinyanga,TZ17,Kahama,TZ1704,Jana,TZ1704151,16099 ,7823 ,8276 ,16099 ,7823 ,0 ,0 ,0 ,8276 
United Republic of Tanzania,Jamhuri ya Muungano wa Tanzania,TZ,Shinyanga,TZ17,Kahama,TZ1704,Isaka,TZ1704163,21690 ,10579 ,11111 ,15362 ,7530 ,6328 ,3049 ,3279 ,7832 
United Republic of Tanzania,Jamhuri ya Muungano wa Tanzania,TZ,Shinyanga,TZ17,Kahama,TZ1704,Chona,TZ1704171,18481 ,8882 ,9599 ,18481 ,8882 ,0 ,0 ,0 ,9599 
United Republic of Tanzania,Jamhuri ya Muungano wa Tanzania,TZ,Shinyanga,TZ17,Kahama,TZ1704,Chambo,TZ1704181,14516 ,7084 ,7432 ,14516 ,7084 ,0 ,0 ,0 ,7432 
United Republic of Tanzania,Jamhuri ya Muungano wa Tanzania,TZ,Shinyanga,TZ17,Kahama,TZ1704,Kisuke,TZ1704191,10467 ,5157 ,5310 ,10467 ,5157 ,0 ,0 ,0 ,5310 
United Republic of Tanzania,Jamhuri ya Muungano wa Tanzania,TZ,Shinyanga,TZ17,Kahama,TZ1704,Mapamba,TZ1704201,6273 ,3072 ,3201 ,6273 ,3072 ,0 ,0 ,0 ,3201 
United Republic of Tanzania,Jamhuri ya Muungano wa Tanzania,TZ,Shinyanga,TZ17,Kahama,TZ1704,Bukomela,TZ1704211,6492 ,3220 ,3272 ,6492 ,3220 ,0 ,0 ,0 ,3272 
United Republic of Tanzania,Jamhuri ya Muungano wa Tanzania,TZ,Shinyanga,TZ17,Kahama,TZ1704,Ukune,TZ1704221,11717 ,5693 ,6024 ,11717 ,5693 ,0 ,0 ,0 ,6024 
United Republic of Tanzania,Jamhuri ya Muungano wa Tanzania,TZ,Shinyanga,TZ17,Kahama,TZ1704,Igunda,TZ1704231,6597 ,3182 ,3415 ,6597 ,3182 ,0 ,0 ,0 ,3415 
United Republic of Tanzania,Jamhuri ya Muungano wa Tanzania,TZ,Shinyanga,TZ17,Kahama,TZ1704,Kinamapula,TZ1704241,12695 ,6149 ,6546 ,12695 ,6149 ,0 ,0 ,0 ,6546 
United Republic of Tanzania,Jamhuri ya Muungano wa Tanzania,TZ,Shinyanga,TZ17,Kahama,TZ1704,Igwamanoni,TZ1704251,14901 ,7245 ,7656 ,14901 ,7245 ,0 ,0 ,0 ,7656 
United Republic of Tanzania,Jamhuri ya Muungano wa Tanzania,TZ,Shinyanga,TZ17,Kahama,TZ1704,Mpunze,TZ1704261,9338 ,4576 ,4762 ,9338 ,4576 ,0 ,0 ,0 ,4762 
United Republic of Tanzania,Jamhuri ya Muungano wa Tanzania,TZ,Shinyanga,TZ17,Kahama,TZ1704,Sabasabini,TZ1704271,11563 ,5702 ,5861 ,11563 ,5702 ,0 ,0 ,0 ,5861 
United Republic of Tanzania,Jamhuri ya Muungano wa Tanzania,TZ,Shinyanga,TZ17,Kahama,TZ1704,Idahina,TZ1704281,23937 ,11912 ,12025 ,23937 ,11912 ,0 ,0 ,0 ,12025 
United Republic of Tanzania,Jamhuri ya Muungano wa Tanzania,TZ,Shinyanga,TZ17,Kahama,TZ1704,Bulungwa,TZ1704291,24642 ,12090 ,12552 ,24642 ,12090 ,0 ,0 ,0 ,12552 
United Republic of Tanzania,Jamhuri ya Muungano wa Tanzania,TZ,Shinyanga,TZ17,Kahama,TZ1704,Nyankende,TZ1704301,14515 ,7113 ,7402 ,14515 ,7113 ,0 ,0 ,0 ,7402 
United Republic of Tanzania,Jamhuri ya Muungano wa Tanzania,TZ,Shinyanga,TZ17,Kahama,TZ1704,Ulewe,TZ1704311,18308 ,8875 ,9433 ,18308 ,8875 ,0 ,0 ,0 ,9433 
United Republic of Tanzania,Jamhuri ya Muungano wa Tanzania,TZ,Shinyanga,TZ17,Kahama,TZ1704,Ushetu,TZ1704321,17538 ,8728 ,8810 ,17538 ,8728 ,0 ,0 ,0 ,8810 
United Republic of Tanzania,Jamhuri ya Muungano wa Tanzania,TZ,Shinyanga,TZ17,Kahama,TZ1704,Uyogo,TZ1704331,15291 ,7407 ,7884 ,15291 ,7407 ,0 ,0 ,0 ,7884 
United Republic of Tanzania,Jamhuri ya Muungano wa Tanzania,TZ,Shinyanga,TZ17,Kahama,TZ1704,Ulowa,TZ1704343,19230 ,9780 ,9450 ,16584 ,8494 ,2646 ,1286 ,1360 ,8090 
United Republic of Tanzania,Jamhuri ya Muungano wa Tanzania,TZ,Shinyanga,TZ17,Kahama,TZ1704,Ubagwe,TZ1704351,16574 ,8362 ,8212 ,16574 ,8362 ,0 ,0 ,0 ,8212 
United Republic of Tanzania,Jamhuri ya Muungano wa Tanzania,TZ,Shinyanga,TZ17,Kahama Township Authority,TZ1705,Ngogwa,TZ1705011,8202 ,4071 ,4131 ,8202 ,4071 ,0 ,0 ,0 ,4131 
United Republic of Tanzania,Jamhuri ya Muungano wa Tanzania,TZ,Shinyanga,TZ17,Kahama Township Authority,TZ1705,Wendele,TZ1705021,7536 ,3746 ,3790 ,7536 ,3746 ,0 ,0 ,0 ,3790 
United Republic of Tanzania,Jamhuri ya Muungano wa Tanzania,TZ,Shinyanga,TZ17,Kahama Township Authority,TZ1705,Kinaga,TZ1705031,14841 ,7176 ,7665 ,14841 ,7176 ,0 ,0 ,0 ,7665 
United Republic of Tanzania,Jamhuri ya Muungano wa Tanzania,TZ,Shinyanga,TZ17,Kahama Township Authority,TZ1705,Isagehe,TZ1705041,10828 ,5222 ,5606 ,10828 ,5222 ,0 ,0 ,0 ,5606 
United Republic of Tanzania,Jamhuri ya Muungano wa Tanzania,TZ,Shinyanga,TZ17,Kahama Township Authority,TZ1705,Mondo,TZ1705051,11481 ,5563 ,5918 ,11481 ,5563 ,0 ,0 ,0 ,5918 
United Republic of Tanzania,Jamhuri ya Muungano wa Tanzania,TZ,Shinyanga,TZ17,Kahama Township Authority,TZ1705,Kagongwa,TZ1705063,21446 ,10253 ,11193 ,3023 ,1485 ,18423 ,8768 ,9655 ,1538 
United Republic of Tanzania,Jamhuri ya Muungano wa Tanzania,TZ,Shinyanga,TZ17,Kahama Township Authority,TZ1705,Nyahanga,TZ1705073,15794 ,7512 ,8282 ,2642 ,1320 ,13152 ,6192 ,6960 ,1322 
United Republic of Tanzania,Jamhuri ya Muungano wa Tanzania,TZ,Shinyanga,TZ17,Kahama Township Authority,TZ1705,Malunga,TZ1705083,10225 ,4854 ,5371 ,2613 ,1313 ,7612 ,3541 ,4071 ,1300 
United Republic of Tanzania,Jamhuri ya Muungano wa Tanzania,TZ,Shinyanga,TZ17,Kahama Township Authority,TZ1705,Mhongolo,TZ1705093,15427 ,7473 ,7954 ,4369 ,2121 ,11058 ,5352 ,5706 ,2248 
United Republic of Tanzania,Jamhuri ya Muungano wa Tanzania,TZ,Shinyanga,TZ17,Kahama Township Authority,TZ1705,Mwendakulima,TZ1705103,13711 ,6697 ,7014 ,10922 ,5460 ,2789 ,1237 ,1552 ,5462 
United Republic of Tanzania,Jamhuri ya Muungano wa Tanzania,TZ,Shinyanga,TZ17,Kahama Township Authority,TZ1705,Zongomera,TZ1705111,10438 ,5261 ,5177 ,10438 ,5261 ,0 ,0 ,0 ,5177 
United Republic of Tanzania,Jamhuri ya Muungano wa Tanzania,TZ,Shinyanga,TZ17,Kahama Township Authority,TZ1705,Mhungula,TZ1705123,10486 ,5055 ,5431 ,7040 ,3439 ,3446 ,1616 ,1830 ,3601 
United Republic of Tanzania,Jamhuri ya Muungano wa Tanzania,TZ,Shinyanga,TZ17,Kahama Township Authority,TZ1705,Nyihogo,TZ1705132,13622 ,6575 ,7047 ,0 ,0 ,13622 ,6575 ,7047 ,0 
United Republic of Tanzania,Jamhuri ya Muungano wa Tanzania,TZ,Shinyanga,TZ17,Kahama Township Authority,TZ1705,Nyasubi,TZ1705143,20181 ,9712 ,10469 ,5740 ,2688 ,14441 ,7024 ,7417 ,3052 
United Republic of Tanzania,Jamhuri ya Muungano wa Tanzania,TZ,Shinyanga,TZ17,Kahama Township Authority,TZ1705,Kahama Mjini,TZ1705152,6621 ,3479 ,3142 ,0 ,0 ,6621 ,3479 ,3142 ,0 
United Republic of Tanzania,Jamhuri ya Muungano wa Tanzania,TZ,Shinyanga,TZ17,Kahama Township Authority,TZ1705,Majengo,TZ1705163,15917 ,7583 ,8334 ,11994 ,5709 ,3923 ,1874 ,2049 ,6285 
United Republic of Tanzania,Jamhuri ya Muungano wa Tanzania,TZ,Shinyanga,TZ17,Kahama Township Authority,TZ1705,Busoka,TZ1705171,5323 ,2618 ,2705 ,5323 ,2618 ,0 ,0 ,0 ,2705 
United Republic of Tanzania,Jamhuri ya Muungano wa Tanzania,TZ,Shinyanga,TZ17,Kahama Township Authority,TZ1705,Kilago,TZ1705181,11118 ,5390 ,5728 ,11118 ,5390 ,0 ,0 ,0 ,5728 
United Republic of Tanzania,Jamhuri ya Muungano wa Tanzania,TZ,Shinyanga,TZ17,Kahama Township Authority,TZ1705,Iyenze,TZ1705191,7620 ,3649 ,3971 ,7620 ,3649 ,0 ,0 ,0 ,3971 
United Republic of Tanzania,Jamhuri ya Muungano wa Tanzania,TZ,Shinyanga,TZ17,Kahama Township Authority,TZ1705,Nyandekwa,TZ1705201,11391 ,5609 ,5782 ,11391 ,5609 ,0 ,0 ,0 ,5782 
United Republic of Tanzania,Jamhuri ya Muungano wa Tanzania,TZ,Kagera,TZ18,Karagwe,TZ1801,Igurwa,TZ1801011,10525 ,5203 ,5322 ,10525 ,5203 ,0 ,0 ,0 ,5322 
United Republic of Tanzania,Jamhuri ya Muungano wa Tanzania,TZ,Kagera,TZ18,Karagwe,TZ1801,Kanoni,TZ1801021,17126 ,8584 ,8542 ,17126 ,8584 ,0 ,0 ,0 ,8542 
United Republic of Tanzania,Jamhuri ya Muungano wa Tanzania,TZ,Kagera,TZ18,Karagwe,TZ1801,Kihanga,TZ1801031,18202 ,9400 ,8802 ,18202 ,9400 ,0 ,0 ,0 ,8802 
United Republic of Tanzania,Jamhuri ya Muungano wa Tanzania,TZ,Kagera,TZ18,Karagwe,TZ1801,Kituntu,TZ1801041,12970 ,6201 ,6769 ,12970 ,6201 ,0 ,0 ,0 ,6769 
United Republic of Tanzania,Jamhuri ya Muungano wa Tanzania,TZ,Kagera,TZ18,Karagwe,TZ1801,Chanika,TZ1801051,17632 ,8793 ,8839 ,17632 ,8793 ,0 ,0 ,0 ,8839 
United Republic of Tanzania,Jamhuri ya Muungano wa Tanzania,TZ,Kagera,TZ18,Karagwe,TZ1801,Kayanga,TZ1801063,18968 ,9341 ,9627 ,6548 ,3233 ,12420 ,6108 ,6312 ,3315 
United Republic of Tanzania,Jamhuri ya Muungano wa Tanzania,TZ,Kagera,TZ18,Karagwe,TZ1801,Bugene,TZ1801073,15867 ,7805 ,8062 ,10077 ,5001 ,5790 ,2804 ,2986 ,5076 
United Republic of Tanzania,Jamhuri ya Muungano wa Tanzania,TZ,Kagera,TZ18,Karagwe,TZ1801,Ndama,TZ1801083,11887 ,5805 ,6082 ,9185 ,4480 ,2702 ,1325 ,1377 ,4705 
United Republic of Tanzania,Jamhuri ya Muungano wa Tanzania,TZ,Kagera,TZ18,Karagwe,TZ1801,Rugera,TZ1801091,7388 ,3672 ,3716 ,7388 ,3672 ,0 ,0 ,0 ,3716 
United Republic of Tanzania,Jamhuri ya Muungano wa Tanzania,TZ,Kagera,TZ18,Karagwe,TZ1801,Ihembe,TZ1801101,8846 ,4377 ,4469 ,8846 ,4377 ,0 ,0 ,0 ,4469 
United Republic of Tanzania,Jamhuri ya Muungano wa Tanzania,TZ,Kagera,TZ18,Karagwe,TZ1801,Nyaishozi,TZ1801111,12782 ,6209 ,6573 ,12782 ,6209 ,0 ,0 ,0 ,6573 
United Republic of Tanzania,Jamhuri ya Muungano wa Tanzania,TZ,Kagera,TZ18,Karagwe,TZ1801,Rugu,TZ1801121,14160 ,7091 ,7069 ,14160 ,7091 ,0 ,0 ,0 ,7069 
United Republic of Tanzania,Jamhuri ya Muungano wa Tanzania,TZ,Kagera,TZ18,Karagwe,TZ1801,Nyakasimbi,TZ1801131,12803 ,6269 ,6534 ,12803 ,6269 ,0 ,0 ,0 ,6534 
United Republic of Tanzania,Jamhuri ya Muungano wa Tanzania,TZ,Kagera,TZ18,Karagwe,TZ1801,Nyakakika,TZ1801141,16605 ,8157 ,8448 ,16605 ,8157 ,0 ,0 ,0 ,8448 
United Republic of Tanzania,Jamhuri ya Muungano wa Tanzania,TZ,Kagera,TZ18,Karagwe,TZ1801,Nyakabanga,TZ1801151,16531 ,8149 ,8382 ,16531 ,8149 ,0 ,0 ,0 ,8382 
United Republic of Tanzania,Jamhuri ya Muungano wa Tanzania,TZ,Kagera,TZ18,Karagwe,TZ1801,Bweranyange,TZ1801161,18629 ,9112 ,9517 ,18629 ,9112 ,0 ,0 ,0 ,9517 
United Republic of Tanzania,Jamhuri ya Muungano wa Tanzania,TZ,Kagera,TZ18,Karagwe,TZ1801,Kibondo,TZ1801171,12621 ,6051 ,6570 ,12621 ,6051 ,0 ,0 ,0 ,6570 
United Republic of Tanzania,Jamhuri ya Muungano wa Tanzania,TZ,Kagera,TZ18,Karagwe,TZ1801,Nyabiyonza,TZ1801181,10748 ,5301 ,5447 ,10748 ,5301 ,0 ,0 ,0 ,5447 
United Republic of Tanzania,Jamhuri ya Muungano wa Tanzania,TZ,Kagera,TZ18,Karagwe,TZ1801,Kiruruma,TZ1801191,34945 ,17046 ,17899 ,34945 ,17046 ,0 ,0 ,0 ,17899 
United Republic of Tanzania,Jamhuri ya Muungano wa Tanzania,TZ,Kagera,TZ18,Karagwe,TZ1801,Nyakahanga,TZ1801203,20284 ,10059 ,10225 ,16749 ,8434 ,3535 ,1625 ,1910 ,8315 
United Republic of Tanzania,Jamhuri ya Muungano wa Tanzania,TZ,Kagera,TZ18,Karagwe,TZ1801,Ihanda,TZ1801211,14583 ,7216 ,7367 ,14583 ,7216 ,0 ,0 ,0 ,7367 
United Republic of Tanzania,Jamhuri ya Muungano wa Tanzania,TZ,Kagera,TZ18,Karagwe,TZ1801,Chonyonyo,TZ1801221,7918 ,4023 ,3895 ,7918 ,4023 ,0 ,0 ,0 ,3895 
United Republic of Tanzania,Jamhuri ya Muungano wa Tanzania,TZ,Kagera,TZ18,Bukoba,TZ1802,Rubafu,TZ1802011,8442 ,4197 ,4245 ,8442 ,4197 ,0 ,0 ,0 ,4245 
United Republic of Tanzania,Jamhuri ya Muungano wa Tanzania,TZ,Kagera,TZ18,Bukoba,TZ1802,Kishanje,TZ1802021,8381 ,4105 ,4276 ,8381 ,4105 ,0 ,0 ,0 ,4276 
United Republic of Tanzania,Jamhuri ya Muungano wa Tanzania,TZ,Kagera,TZ18,Bukoba,TZ1802,Kaagya,TZ1802031,11413 ,5651 ,5762 ,11413 ,5651 ,0 ,0 ,0 ,5762 
United Republic of Tanzania,Jamhuri ya Muungano wa Tanzania,TZ,Kagera,TZ18,Bukoba,TZ1802,Buhendangabo,TZ1802041,7724 ,3696 ,4028 ,7724 ,3696 ,0 ,0 ,0 ,4028 
United Republic of Tanzania,Jamhuri ya Muungano wa Tanzania,TZ,Kagera,TZ18,Bukoba,TZ1802,Nyakato,TZ1802051,14414 ,6839 ,7575 ,14414 ,6839 ,0 ,0 ,0 ,7575 
United Republic of Tanzania,Jamhuri ya Muungano wa Tanzania,TZ,Kagera,TZ18,Bukoba,TZ1802,Katoma,TZ1802061,6762 ,3224 ,3538 ,6762 ,3224 ,0 ,0 ,0 ,3538 
United Republic of Tanzania,Jamhuri ya Muungano wa Tanzania,TZ,Kagera,TZ18,Bukoba,TZ1802,Karabagaine,TZ1802071,15302 ,7504 ,7798 ,15302 ,7504 ,0 ,0 ,0 ,7798 
United Republic of Tanzania,Jamhuri ya Muungano wa Tanzania,TZ,Kagera,TZ18,Bukoba,TZ1802,Bujugo,TZ1802081,7140 ,3430 ,3710 ,7140 ,3430 ,0 ,0 ,0 ,3710 
United Republic of Tanzania,Jamhuri ya Muungano wa Tanzania,TZ,Kagera,TZ18,Bukoba,TZ1802,Maruku,TZ1802091,9202 ,4443 ,4759 ,9202 ,4443 ,0 ,0 ,0 ,4759 
United Republic of Tanzania,Jamhuri ya Muungano wa Tanzania,TZ,Kagera,TZ18,Bukoba,TZ1802,Kanyangereko,TZ1802101,10166 ,5093 ,5073 ,10166 ,5093 ,0 ,0 ,0 ,5073 
United Republic of Tanzania,Jamhuri ya Muungano wa Tanzania,TZ,Kagera,TZ18,Bukoba,TZ1802,Katerero,TZ1802111,5884 ,2806 ,3078 ,5884 ,2806 ,0 ,0 ,0 ,3078 
United Republic of Tanzania,Jamhuri ya Muungano wa Tanzania,TZ,Kagera,TZ18,Bukoba,TZ1802,Kemondo,TZ1802123,15900 ,7724 ,8176 ,8018 ,3889 ,7882 ,3835 ,4047 ,4129 
United Republic of Tanzania,Jamhuri ya Muungano wa Tanzania,TZ,Kagera,TZ18,Bukoba,TZ1802,Nyakibimbili,TZ1802131,8341 ,4100 ,4241 ,8341 ,4100 ,0 ,0 ,0 ,4241 
United Republic of Tanzania,Jamhuri ya Muungano wa Tanzania,TZ,Kagera,TZ18,Bukoba,TZ1802,Ibwera,TZ1802141,9456 ,4610 ,4846 ,9456 ,4610 ,0 ,0 ,0 ,4846 
United Republic of Tanzania,Jamhuri ya Muungano wa Tanzania,TZ,Kagera,TZ18,Bukoba,TZ1802,Mikoni,TZ1802151,8004 ,3971 ,4033 ,8004 ,3971 ,0 ,0 ,0 ,4033 
United Republic of Tanzania,Jamhuri ya Muungano wa Tanzania,TZ,Kagera,TZ18,Bukoba,TZ1802,Butelankuzi,TZ1802161,9864 ,4779 ,5085 ,9864 ,4779 ,0 ,0 ,0 ,5085 
United Republic of Tanzania,Jamhuri ya Muungano wa Tanzania,TZ,Kagera,TZ18,Bukoba,TZ1802,Rubale,TZ1802171,8901 ,4371 ,4530 ,8901 ,4371 ,0 ,0 ,0 ,4530 
United Republic of Tanzania,Jamhuri ya Muungano wa Tanzania,TZ,Kagera,TZ18,Bukoba,TZ1802,Rukoma,TZ1802181,11747 ,5816 ,5931 ,11747 ,5816 ,0 ,0 ,0 ,5931 
United Republic of Tanzania,Jamhuri ya Muungano wa Tanzania,TZ,Kagera,TZ18,Bukoba,TZ1802,Kikomero,TZ1802191,6165 ,3031 ,3134 ,6165 ,3031 ,0 ,0 ,0 ,3134 
United Republic of Tanzania,Jamhuri ya Muungano wa Tanzania,TZ,Kagera,TZ18,Bukoba,TZ1802,Kibirizi,TZ1802201,7807 ,3930 ,3877 ,7807 ,3930 ,0 ,0 ,0 ,3877 
United Republic of Tanzania,Jamhuri ya Muungano wa Tanzania,TZ,Kagera,TZ18,Bukoba,TZ1802,Izimbya,TZ1802211,10054 ,4839 ,5215 ,10054 ,4839 ,0 ,0 ,0 ,5215 
United Republic of Tanzania,Jamhuri ya Muungano wa Tanzania,TZ,Kagera,TZ18,Bukoba,TZ1802,Butulage,TZ1802221,10049 ,4893 ,5156 ,10049 ,4893 ,0 ,0 ,0 ,5156 
United Republic of Tanzania,Jamhuri ya Muungano wa Tanzania,TZ,Kagera,TZ18,Bukoba,TZ1802,Ruhunga,TZ1802231,10155 ,5025 ,5130 ,10155 ,5025 ,0 ,0 ,0 ,5130 
United Republic of Tanzania,Jamhuri ya Muungano wa Tanzania,TZ,Kagera,TZ18,Bukoba,TZ1802,Mugajwale,TZ1802241,10381 ,5079 ,5302 ,10381 ,5079 ,0 ,0 ,0 ,5302 
United Republic of Tanzania,Jamhuri ya Muungano wa Tanzania,TZ,Kagera,TZ18,Bukoba,TZ1802,Kyamulaile,TZ1802251,13478 ,6698 ,6780 ,13478 ,6698 ,0 ,0 ,0 ,6780 
United Republic of Tanzania,Jamhuri ya Muungano wa Tanzania,TZ,Kagera,TZ18,Bukoba,TZ1802,Katoro,TZ1802263,13648 ,6440 ,7208 ,11400 ,5401 ,2248 ,1039 ,1209 ,5999 
United Republic of Tanzania,Jamhuri ya Muungano wa Tanzania,TZ,Kagera,TZ18,Bukoba,TZ1802,Kaibanja,TZ1802271,13905 ,6705 ,7200 ,13905 ,6705 ,0 ,0 ,0 ,7200 
United Republic of Tanzania,Jamhuri ya Muungano wa Tanzania,TZ,Kagera,TZ18,Bukoba,TZ1802,Kasharu,TZ1802281,7764 ,3706 ,4058 ,7764 ,3706 ,0 ,0 ,0 ,4058 
United Republic of Tanzania,Jamhuri ya Muungano wa Tanzania,TZ,Kagera,TZ18,Bukoba,TZ1802,Kishogo,TZ1802291,9248 ,4437 ,4811 ,9248 ,4437 ,0 ,0 ,0 ,4811 
United Republic of Tanzania,Jamhuri ya Muungano wa Tanzania,TZ,Kagera,TZ18,Muleba,TZ1803,Muhutwe,TZ1803011,11491 ,5588 ,5903 ,11491 ,5588 ,0 ,0 ,0 ,5903 
United Republic of Tanzania,Jamhuri ya Muungano wa Tanzania,TZ,Kagera,TZ18,Muleba,TZ1803,Mayondwe,TZ1803021,7216 ,3659 ,3557 ,7216 ,3659 ,0 ,0 ,0 ,3557 
United Republic of Tanzania,Jamhuri ya Muungano wa Tanzania,TZ,Kagera,TZ18,Muleba,TZ1803,Goziba,TZ1803031,3578 ,2222 ,1356 ,3578 ,2222 ,0 ,0 ,0 ,1356 
United Republic of Tanzania,Jamhuri ya Muungano wa Tanzania,TZ,Kagera,TZ18,Muleba,TZ1803,Kerebe,TZ1803041,3101 ,1879 ,1222 ,3101 ,1879 ,0 ,0 ,0 ,1222 
United Republic of Tanzania,Jamhuri ya Muungano wa Tanzania,TZ,Kagera,TZ18,Muleba,TZ1803,Bumbire,TZ1803051,13024 ,7502 ,5522 ,13024 ,7502 ,0 ,0 ,0 ,5522 
United Republic of Tanzania,Jamhuri ya Muungano wa Tanzania,TZ,Kagera,TZ18,Muleba,TZ1803,Ikuza,TZ1803061,11978 ,6513 ,5465 ,11978 ,6513 ,0 ,0 ,0 ,5465 
United Republic of Tanzania,Jamhuri ya Muungano wa Tanzania,TZ,Kagera,TZ18,Muleba,TZ1803,Izigo,TZ1803071,10843 ,5183 ,5660 ,10843 ,5183 ,0 ,0 ,0 ,5660 
United Republic of Tanzania,Jamhuri ya Muungano wa Tanzania,TZ,Kagera,TZ18,Muleba,TZ1803,Katoke,TZ1803081,12176 ,6019 ,6157 ,12176 ,6019 ,0 ,0 ,0 ,6157 
United Republic of Tanzania,Jamhuri ya Muungano wa Tanzania,TZ,Kagera,TZ18,Muleba,TZ1803,Kagoma,TZ1803091,7011 ,3546 ,3465 ,7011 ,3546 ,0 ,0 ,0 ,3465 
United Republic of Tanzania,Jamhuri ya Muungano wa Tanzania,TZ,Kagera,TZ18,Muleba,TZ1803,Kikuku,TZ1803101,9556 ,4720 ,4836 ,9556 ,4720 ,0 ,0 ,0 ,4836 
United Republic of Tanzania,Jamhuri ya Muungano wa Tanzania,TZ,Kagera,TZ18,Muleba,TZ1803,Bureza,TZ1803111,7472 ,3564 ,3908 ,7472 ,3564 ,0 ,0 ,0 ,3908 
United Republic of Tanzania,Jamhuri ya Muungano wa Tanzania,TZ,Kagera,TZ18,Muleba,TZ1803,Muleba,TZ1803123,18464 ,9064 ,9400 ,10647 ,5065 ,7817 ,3999 ,3818 ,5582 
United Republic of Tanzania,Jamhuri ya Muungano wa Tanzania,TZ,Kagera,TZ18,Muleba,TZ1803,Ikondo,TZ1803131,6312 ,3060 ,3252 ,6312 ,3060 ,0 ,0 ,0 ,3252 
United Republic of Tanzania,Jamhuri ya Muungano wa Tanzania,TZ,Kagera,TZ18,Muleba,TZ1803,Buhangaza,TZ1803141,6603 ,3271 ,3332 ,6603 ,3271 ,0 ,0 ,0 ,3332 
United Republic of Tanzania,Jamhuri ya Muungano wa Tanzania,TZ,Kagera,TZ18,Muleba,TZ1803,Mazinga,TZ1803151,6730 ,3791 ,2939 ,6730 ,3791 ,0 ,0 ,0 ,2939 
United Republic of Tanzania,Jamhuri ya Muungano wa Tanzania,TZ,Kagera,TZ18,Muleba,TZ1803,Magata (Karutanga),TZ1803161,7670 ,3758 ,3912 ,7670 ,3758 ,0 ,0 ,0 ,3912 
United Republic of Tanzania,Jamhuri ya Muungano wa Tanzania,TZ,Kagera,TZ18,Muleba,TZ1803,Gwanseli,TZ1803171,14456 ,7031 ,7425 ,14456 ,7031 ,0 ,0 ,0 ,7425 
United Republic of Tanzania,Jamhuri ya Muungano wa Tanzania,TZ,Kagera,TZ18,Muleba,TZ1803,Kibanga,TZ1803181,10432 ,5008 ,5424 ,10432 ,5008 ,0 ,0 ,0 ,5424 
United Republic of Tanzania,Jamhuri ya Muungano wa Tanzania,TZ,Kagera,TZ18,Muleba,TZ1803,Kasharunga,TZ1803191,24272 ,12088 ,12184 ,24272 ,12088 ,0 ,0 ,0 ,12184 
United Republic of Tanzania,Jamhuri ya Muungano wa Tanzania,TZ,Kagera,TZ18,Muleba,TZ1803,Rulanda,TZ1803201,10166 ,5057 ,5109 ,10166 ,5057 ,0 ,0 ,0 ,5109 
United Republic of Tanzania,Jamhuri ya Muungano wa Tanzania,TZ,Kagera,TZ18,Muleba,TZ1803,Kimwani,TZ1803211,20161 ,10487 ,9674 ,20161 ,10487 ,0 ,0 ,0 ,9674 
United Republic of Tanzania,Jamhuri ya Muungano wa Tanzania,TZ,Kagera,TZ18,Muleba,TZ1803,Nyakabango,TZ1803221,15424 ,7660 ,7764 ,15424 ,7660 ,0 ,0 ,0 ,7764 
United Republic of Tanzania,Jamhuri ya Muungano wa Tanzania,TZ,Kagera,TZ18,Muleba,TZ1803,Kyebitembe,TZ1803231,25460 ,12596 ,12864 ,25460 ,12596 ,0 ,0 ,0 ,12864 
United Republic of Tanzania,Jamhuri ya Muungano wa Tanzania,TZ,Kagera,TZ18,Muleba,TZ1803,Karambi,TZ1803241,19059 ,9509 ,9550 ,19059 ,9509 ,0 ,0 ,0 ,9550 
United Republic of Tanzania,Jamhuri ya Muungano wa Tanzania,TZ,Kagera,TZ18,Muleba,TZ1803,Mubunda,TZ1803251,16724 ,8202 ,8522 ,16724 ,8202 ,0 ,0 ,0 ,8522 
United Republic of Tanzania,Jamhuri ya Muungano wa Tanzania,TZ,Kagera,TZ18,Muleba,TZ1803,Bisheke,TZ1803261,17665 ,8448 ,9217 ,17665 ,8448 ,0 ,0 ,0 ,9217 
United Republic of Tanzania,Jamhuri ya Muungano wa Tanzania,TZ,Kagera,TZ18,Muleba,TZ1803,Burungura,TZ1803271,13354 ,6625 ,6729 ,13354 ,6625 ,0 ,0 ,0 ,6729 
United Republic of Tanzania,Jamhuri ya Muungano wa Tanzania,TZ,Kagera,TZ18,Muleba,TZ1803,Biirabo,TZ1803281,18900 ,9185 ,9715 ,18900 ,9185 ,0 ,0 ,0 ,9715 
United Republic of Tanzania,Jamhuri ya Muungano wa Tanzania,TZ,Kagera,TZ18,Muleba,TZ1803,Mushabago,TZ1803291,8792 ,4217 ,4575 ,8792 ,4217 ,0 ,0 ,0 ,4575 
United Republic of Tanzania,Jamhuri ya Muungano wa Tanzania,TZ,Kagera,TZ18,Muleba,TZ1803,Nyakatanga,TZ1803301,9079 ,4368 ,4711 ,9079 ,4368 ,0 ,0 ,0 ,4711 
United Republic of Tanzania,Jamhuri ya Muungano wa Tanzania,TZ,Kagera,TZ18,Muleba,TZ1803,Ngenge,TZ1803311,20339 ,10076 ,10263 ,20339 ,10076 ,0 ,0 ,0 ,10263 
United Republic of Tanzania,Jamhuri ya Muungano wa Tanzania,TZ,Kagera,TZ18,Muleba,TZ1803,Rutoro,TZ1803321,9979 ,5220 ,4759 ,9979 ,5220 ,0 ,0 ,0 ,4759 
United Republic of Tanzania,Jamhuri ya Muungano wa Tanzania,TZ,Kagera,TZ18,Muleba,TZ1803,Kabirizi,TZ1803331,12666 ,6160 ,6506 ,12666 ,6160 ,0 ,0 ,0 ,6506 
United Republic of Tanzania,Jamhuri ya Muungano wa Tanzania,TZ,Kagera,TZ18,Muleba,TZ1803,Nshamba,TZ1803343,24432 ,11476 ,12956 ,20009 ,9373 ,4423 ,2103 ,2320 ,10636 
United Republic of Tanzania,Jamhuri ya Muungano wa Tanzania,TZ,Kagera,TZ18,Muleba,TZ1803,Kashasha,TZ1803351,11021 ,5364 ,5657 ,11021 ,5364 ,0 ,0 ,0 ,5657 
United Republic of Tanzania,Jamhuri ya Muungano wa Tanzania,TZ,Kagera,TZ18,Muleba,TZ1803,Ijumbi,TZ1803361,13178 ,6174 ,7004 ,13178 ,6174 ,0 ,0 ,0 ,7004 
United Republic of Tanzania,Jamhuri ya Muungano wa Tanzania,TZ,Kagera,TZ18,Muleba,TZ1803,Kishanda,TZ1803371,17753 ,8480 ,9273 ,17753 ,8480 ,0 ,0 ,0 ,9273 
United Republic of Tanzania,Jamhuri ya Muungano wa Tanzania,TZ,Kagera,TZ18,Muleba,TZ1803,Buganguzi,TZ1803381,10562 ,5011 ,5551 ,10562 ,5011 ,0 ,0 ,0 ,5551 
United Republic of Tanzania,Jamhuri ya Muungano wa Tanzania,TZ,Kagera,TZ18,Muleba,TZ1803,Ibuga,TZ1803391,12730 ,6198 ,6532 ,12730 ,6198 ,0 ,0 ,0 ,6532 
United Republic of Tanzania,Jamhuri ya Muungano wa Tanzania,TZ,Kagera,TZ18,Muleba,TZ1803,Bulyakashaju,TZ1803401,9951 ,4948 ,5003 ,9951 ,4948 ,0 ,0 ,0 ,5003 
United Republic of Tanzania,Jamhuri ya Muungano wa Tanzania,TZ,Kagera,TZ18,Muleba,TZ1803,Kamachumu,TZ1803413,17567 ,8502 ,9065 ,14060 ,6740 ,3507 ,1762 ,1745 ,7320 
United Republic of Tanzania,Jamhuri ya Muungano wa Tanzania,TZ,Kagera,TZ18,Muleba,TZ1803,Ruhanga,TZ1803421,7518 ,3751 ,3767 ,7518 ,3751 ,0 ,0 ,0 ,3767 
United Republic of Tanzania,Jamhuri ya Muungano wa Tanzania,TZ,Kagera,TZ18,Muleba,TZ1803,Mafumbo,TZ1803431,5445 ,2678 ,2767 ,5445 ,2678 ,0 ,0 ,0 ,2767 
United Republic of Tanzania,Jamhuri ya Muungano wa Tanzania,TZ,Kagera,TZ18,Biharamulo,TZ1804,Nyakahura,TZ1804011,26123 ,13362 ,12761 ,26123 ,13362 ,0 ,0 ,0 ,12761 
United Republic of Tanzania,Jamhuri ya Muungano wa Tanzania,TZ,Kagera,TZ18,Biharamulo,TZ1804,Ruziba,TZ1804021,12090 ,6046 ,6044 ,12090 ,6046 ,0 ,0 ,0 ,6044 
United Republic of Tanzania,Jamhuri ya Muungano wa Tanzania,TZ,Kagera,TZ18,Biharamulo,TZ1804,Biharamulo Mjini,TZ1804033,24573 ,11751 ,12822 ,12873 ,6219 ,11700 ,5532 ,6168 ,6654 
United Republic of Tanzania,Jamhuri ya Muungano wa Tanzania,TZ,Kagera,TZ18,Biharamulo,TZ1804,Bisibo,TZ1804041,14694 ,7363 ,7331 ,14694 ,7363 ,0 ,0 ,0 ,7331 
United Republic of Tanzania,Jamhuri ya Muungano wa Tanzania,TZ,Kagera,TZ18,Biharamulo,TZ1804,Nyarubungo,TZ1804051,28426 ,14093 ,14333 ,28426 ,14093 ,0 ,0 ,0 ,14333 
United Republic of Tanzania,Jamhuri ya Muungano wa Tanzania,TZ,Kagera,TZ18,Biharamulo,TZ1804,Nyamahanga,TZ1804061,10760 ,5347 ,5413 ,10760 ,5347 ,0 ,0 ,0 ,5413 
United Republic of Tanzania,Jamhuri ya Muungano wa Tanzania,TZ,Kagera,TZ18,Biharamulo,TZ1804,Runazi,TZ1804071,14472 ,7210 ,7262 ,14472 ,7210 ,0 ,0 ,0 ,7262 
United Republic of Tanzania,Jamhuri ya Muungano wa Tanzania,TZ,Kagera,TZ18,Biharamulo,TZ1804,Kabindi,TZ1804081,25312 ,12335 ,12977 ,25312 ,12335 ,0 ,0 ,0 ,12977 
United Republic of Tanzania,Jamhuri ya Muungano wa Tanzania,TZ,Kagera,TZ18,Biharamulo,TZ1804,Nyamigogo,TZ1804091,15583 ,7682 ,7901 ,15583 ,7682 ,0 ,0 ,0 ,7901 
United Republic of Tanzania,Jamhuri ya Muungano wa Tanzania,TZ,Kagera,TZ18,Biharamulo,TZ1804,Nyabusozi,TZ1804101,23988 ,11661 ,12327 ,23988 ,11661 ,0 ,0 ,0 ,12327 
United Republic of Tanzania,Jamhuri ya Muungano wa Tanzania,TZ,Kagera,TZ18,Biharamulo,TZ1804,Nemba,TZ1804111,20189 ,10131 ,10058 ,20189 ,10131 ,0 ,0 ,0 ,10058 
United Republic of Tanzania,Jamhuri ya Muungano wa Tanzania,TZ,Kagera,TZ18,Biharamulo,TZ1804,Lusahunga,TZ1804121,37234 ,18285 ,18949 ,37234 ,18285 ,0 ,0 ,0 ,18949 
United Republic of Tanzania,Jamhuri ya Muungano wa Tanzania,TZ,Kagera,TZ18,Biharamulo,TZ1804,Kaniha,TZ1804131,19525 ,10102 ,9423 ,19525 ,10102 ,0 ,0 ,0 ,9423 
United Republic of Tanzania,Jamhuri ya Muungano wa Tanzania,TZ,Kagera,TZ18,Biharamulo,TZ1804,Nyantakara,TZ1804141,16370 ,8331 ,8039 ,16370 ,8331 ,0 ,0 ,0 ,8039 
United Republic of Tanzania,Jamhuri ya Muungano wa Tanzania,TZ,Kagera,TZ18,Biharamulo,TZ1804,Kalenge,TZ1804151,34147 ,16873 ,17274 ,34147 ,16873 ,0 ,0 ,0 ,17274 
United Republic of Tanzania,Jamhuri ya Muungano wa Tanzania,TZ,Kagera,TZ18,Ngara,TZ1805,Rusumo,TZ1805011,12925 ,6428 ,6497 ,12925 ,6428 ,0 ,0 ,0 ,6497 
United Republic of Tanzania,Jamhuri ya Muungano wa Tanzania,TZ,Kagera,TZ18,Ngara,TZ1805,Nyakisasa,TZ1805021,19211 ,9270 ,9941 ,19211 ,9270 ,0 ,0 ,0 ,9941 
United Republic of Tanzania,Jamhuri ya Muungano wa Tanzania,TZ,Kagera,TZ18,Ngara,TZ1805,Rulenge,TZ1805033,17313 ,8252 ,9061 ,12475 ,5973 ,4838 ,2279 ,2559 ,6502 
United Republic of Tanzania,Jamhuri ya Muungano wa Tanzania,TZ,Kagera,TZ18,Ngara,TZ1805,Keza,TZ1805041,9525 ,4586 ,4939 ,9525 ,4586 ,0 ,0 ,0 ,4939 
United Republic of Tanzania,Jamhuri ya Muungano wa Tanzania,TZ,Kagera,TZ18,Ngara,TZ1805,Murusagamba,TZ1805051,18093 ,8613 ,9480 ,18093 ,8613 ,0 ,0 ,0 ,9480 
United Republic of Tanzania,Jamhuri ya Muungano wa Tanzania,TZ,Kagera,TZ18,Ngara,TZ1805,Muganza,TZ1805061,15000 ,7035 ,7965 ,15000 ,7035 ,0 ,0 ,0 ,7965 
United Republic of Tanzania,Jamhuri ya Muungano wa Tanzania,TZ,Kagera,TZ18,Ngara,TZ1805,Bugarama,TZ1805071,28718 ,13398 ,15320 ,28718 ,13398 ,0 ,0 ,0 ,15320 
United Republic of Tanzania,Jamhuri ya Muungano wa Tanzania,TZ,Kagera,TZ18,Ngara,TZ1805,Bukiriro,TZ1805081,19875 ,9440 ,10435 ,19875 ,9440 ,0 ,0 ,0 ,10435 
United Republic of Tanzania,Jamhuri ya Muungano wa Tanzania,TZ,Kagera,TZ18,Ngara,TZ1805,Kabanga,TZ1805093,22010 ,10441 ,11569 ,18566 ,8795 ,3444 ,1646 ,1798 ,9771 
United Republic of Tanzania,Jamhuri ya Muungano wa Tanzania,TZ,Kagera,TZ18,Ngara,TZ1805,Mabawe,TZ1805101,12823 ,6049 ,6774 ,12823 ,6049 ,0 ,0 ,0 ,6774 
United Republic of Tanzania,Jamhuri ya Muungano wa Tanzania,TZ,Kagera,TZ18,Ngara,TZ1805,Kanazi,TZ1805111,17937 ,8513 ,9424 ,17937 ,8513 ,0 ,0 ,0 ,9424 
United Republic of Tanzania,Jamhuri ya Muungano wa Tanzania,TZ,Kagera,TZ18,Ngara,TZ1805,Mugoma,TZ1805121,13493 ,6342 ,7151 ,13493 ,6342 ,0 ,0 ,0 ,7151 
United Republic of Tanzania,Jamhuri ya Muungano wa Tanzania,TZ,Kagera,TZ18,Ngara,TZ1805,Kirushya,TZ1805131,10628 ,4874 ,5754 ,10628 ,4874 ,0 ,0 ,0 ,5754 
United Republic of Tanzania,Jamhuri ya Muungano wa Tanzania,TZ,Kagera,TZ18,Ngara,TZ1805,Ntobeye,TZ1805141,15758 ,7548 ,8210 ,15758 ,7548 ,0 ,0 ,0 ,8210 
United Republic of Tanzania,Jamhuri ya Muungano wa Tanzania,TZ,Kagera,TZ18,Ngara,TZ1805,Nyamiyaga,TZ1805151,8381 ,4042 ,4339 ,8381 ,4042 ,0 ,0 ,0 ,4339 
United Republic of Tanzania,Jamhuri ya Muungano wa Tanzania,TZ,Kagera,TZ18,Ngara,TZ1805,Ngara Mjini,TZ1805163,20968 ,9804 ,11164 ,7098 ,3356 ,13870 ,6448 ,7422 ,3742 
United Republic of Tanzania,Jamhuri ya Muungano wa Tanzania,TZ,Kagera,TZ18,Ngara,TZ1805,Kibimba,TZ1805171,12778 ,6094 ,6684 ,12778 ,6094 ,0 ,0 ,0 ,6684 
United Republic of Tanzania,Jamhuri ya Muungano wa Tanzania,TZ,Kagera,TZ18,Ngara,TZ1805,Mbuba,TZ1805181,11046 ,5240 ,5806 ,11046 ,5240 ,0 ,0 ,0 ,5806 
United Republic of Tanzania,Jamhuri ya Muungano wa Tanzania,TZ,Kagera,TZ18,Ngara,TZ1805,Murukulazo,TZ1805191,15142 ,7410 ,7732 ,15142 ,7410 ,0 ,0 ,0 ,7732 
United Republic of Tanzania,Jamhuri ya Muungano wa Tanzania,TZ,Kagera,TZ18,Ngara,TZ1805,Kasulo,TZ1805201,18432 ,9064 ,9368 ,18432 ,9064 ,0 ,0 ,0 ,9368 
United Republic of Tanzania,Jamhuri ya Muungano wa Tanzania,TZ,Kagera,TZ18,Bukoba Urban,TZ1806,Hamugembe,TZ1806012,12906 ,6116 ,6790 ,0 ,0 ,12906 ,6116 ,6790 ,0 
United Republic of Tanzania,Jamhuri ya Muungano wa Tanzania,TZ,Kagera,TZ18,Bukoba Urban,TZ1806,Nshambya,TZ1806022,9020 ,4378 ,4642 ,0 ,0 ,9020 ,4378 ,4642 ,0 
United Republic of Tanzania,Jamhuri ya Muungano wa Tanzania,TZ,Kagera,TZ18,Bukoba Urban,TZ1806,Buhemba,TZ1806032,4042 ,1938 ,2104 ,0 ,0 ,4042 ,1938 ,2104 ,0 
United Republic of Tanzania,Jamhuri ya Muungano wa Tanzania,TZ,Kagera,TZ18,Bukoba Urban,TZ1806,Kahororo,TZ1806042,6618 ,3387 ,3231 ,0 ,0 ,6618 ,3387 ,3231 ,0 
United Republic of Tanzania,Jamhuri ya Muungano wa Tanzania,TZ,Kagera,TZ18,Bukoba Urban,TZ1806,Kashai,TZ1806052,30791 ,14689 ,16102 ,0 ,0 ,30791 ,14689 ,16102 ,0 
United Republic of Tanzania,Jamhuri ya Muungano wa Tanzania,TZ,Kagera,TZ18,Bukoba Urban,TZ1806,Miembeni,TZ1806062,6543 ,3464 ,3079 ,0 ,0 ,6543 ,3464 ,3079 ,0 
United Republic of Tanzania,Jamhuri ya Muungano wa Tanzania,TZ,Kagera,TZ18,Bukoba Urban,TZ1806,Bilele,TZ1806072,5405 ,2577 ,2828 ,0 ,0 ,5405 ,2577 ,2828 ,0 
United Republic of Tanzania,Jamhuri ya Muungano wa Tanzania,TZ,Kagera,TZ18,Bukoba Urban,TZ1806,Bakoba,TZ1806082,17474 ,8481 ,8993 ,0 ,0 ,17474 ,8481 ,8993 ,0 
United Republic of Tanzania,Jamhuri ya Muungano wa Tanzania,TZ,Kagera,TZ18,Bukoba Urban,TZ1806,Ijuganyondo,TZ1806092,2591 ,1285 ,1306 ,0 ,0 ,2591 ,1285 ,1306 ,0 
United Republic of Tanzania,Jamhuri ya Muungano wa Tanzania,TZ,Kagera,TZ18,Bukoba Urban,TZ1806,Kitendaguro,TZ1806102,5672 ,2766 ,2906 ,0 ,0 ,5672 ,2766 ,2906 ,0 
United Republic of Tanzania,Jamhuri ya Muungano wa Tanzania,TZ,Kagera,TZ18,Bukoba Urban,TZ1806,Kibeta,TZ1806112,8088 ,3969 ,4119 ,0 ,0 ,8088 ,3969 ,4119 ,0 
United Republic of Tanzania,Jamhuri ya Muungano wa Tanzania,TZ,Kagera,TZ18,Bukoba Urban,TZ1806,Kagondo,TZ1806122,4170 ,2035 ,2135 ,0 ,0 ,4170 ,2035 ,2135 ,0 
United Republic of Tanzania,Jamhuri ya Muungano wa Tanzania,TZ,Kagera,TZ18,Bukoba Urban,TZ1806,Nyanga,TZ1806132,3129 ,1571 ,1558 ,0 ,0 ,3129 ,1571 ,1558 ,0 
United Republic of Tanzania,Jamhuri ya Muungano wa Tanzania,TZ,Kagera,TZ18,Bukoba Urban,TZ1806,Rwamishenye,TZ1806142,12347 ,5865 ,6482 ,0 ,0 ,12347 ,5865 ,6482 ,0 
United Republic of Tanzania,Jamhuri ya Muungano wa Tanzania,TZ,Kagera,TZ18,Missenyi,TZ1807,Kakunyu,TZ1807011,20133 ,10267 ,9866 ,20133 ,10267 ,0 ,0 ,0 ,9866 
United Republic of Tanzania,Jamhuri ya Muungano wa Tanzania,TZ,Kagera,TZ18,Missenyi,TZ1807,Nsunga,TZ1807021,19001 ,10159 ,8842 ,19001 ,10159 ,0 ,0 ,0 ,8842 
United Republic of Tanzania,Jamhuri ya Muungano wa Tanzania,TZ,Kagera,TZ18,Missenyi,TZ1807,Mutukula,TZ1807033,15499 ,7735 ,7764 ,10642 ,5340 ,4857 ,2395 ,2462 ,5302 
United Republic of Tanzania,Jamhuri ya Muungano wa Tanzania,TZ,Kagera,TZ18,Missenyi,TZ1807,Kassambya,TZ1807043,26633 ,13055 ,13578 ,21346 ,10479 ,5287 ,2576 ,2711 ,10867 
United Republic of Tanzania,Jamhuri ya Muungano wa Tanzania,TZ,Kagera,TZ18,Missenyi,TZ1807,Minziro,TZ1807051,9951 ,4828 ,5123 ,9951 ,4828 ,0 ,0 ,0 ,5123 
United Republic of Tanzania,Jamhuri ya Muungano wa Tanzania,TZ,Kagera,TZ18,Missenyi,TZ1807,Ruzinga,TZ1807061,3293 ,1549 ,1744 ,3293 ,1549 ,0 ,0 ,0 ,1744 
United Republic of Tanzania,Jamhuri ya Muungano wa Tanzania,TZ,Kagera,TZ18,Missenyi,TZ1807,Kashenye,TZ1807071,5657 ,2740 ,2917 ,5657 ,2740 ,0 ,0 ,0 ,2917 
United Republic of Tanzania,Jamhuri ya Muungano wa Tanzania,TZ,Kagera,TZ18,Missenyi,TZ1807,Kanyigo,TZ1807081,10168 ,4954 ,5214 ,10168 ,4954 ,0 ,0 ,0 ,5214 
United Republic of Tanzania,Jamhuri ya Muungano wa Tanzania,TZ,Kagera,TZ18,Missenyi,TZ1807,Ishunju,TZ1807091,3479 ,1635 ,1844 ,3479 ,1635 ,0 ,0 ,0 ,1844 
United Republic of Tanzania,Jamhuri ya Muungano wa Tanzania,TZ,Kagera,TZ18,Missenyi,TZ1807,Buyango,TZ1807101,8878 ,4273 ,4605 ,8878 ,4273 ,0 ,0 ,0 ,4605 
United Republic of Tanzania,Jamhuri ya Muungano wa Tanzania,TZ,Kagera,TZ18,Missenyi,TZ1807,Bwanjai,TZ1807111,8298 ,3990 ,4308 ,8298 ,3990 ,0 ,0 ,0 ,4308 
United Republic of Tanzania,Jamhuri ya Muungano wa Tanzania,TZ,Kagera,TZ18,Missenyi,TZ1807,Ishozi,TZ1807121,7194 ,3517 ,3677 ,7194 ,3517 ,0 ,0 ,0 ,3677 
United Republic of Tanzania,Jamhuri ya Muungano wa Tanzania,TZ,Kagera,TZ18,Missenyi,TZ1807,Gera,TZ1807131,4831 ,2341 ,2490 ,4831 ,2341 ,0 ,0 ,0 ,2490 
United Republic of Tanzania,Jamhuri ya Muungano wa Tanzania,TZ,Kagera,TZ18,Missenyi,TZ1807,Bugandika,TZ1807141,9444 ,4478 ,4966 ,9444 ,4478 ,0 ,0 ,0 ,4966 
United Republic of Tanzania,Jamhuri ya Muungano wa Tanzania,TZ,Kagera,TZ18,Missenyi,TZ1807,Kitobo,TZ1807151,7327 ,3531 ,3796 ,7327 ,3531 ,0 ,0 ,0 ,3796 
United Republic of Tanzania,Jamhuri ya Muungano wa Tanzania,TZ,Kagera,TZ18,Missenyi,TZ1807,Bugorora,TZ1807161,6905 ,3366 ,3539 ,6905 ,3366 ,0 ,0 ,0 ,3539 
United Republic of Tanzania,Jamhuri ya Muungano wa Tanzania,TZ,Kagera,TZ18,Missenyi,TZ1807,Kyaka,TZ1807173,13190 ,6437 ,6753 ,9316 ,4586 ,3874 ,1851 ,2023 ,4730 
United Republic of Tanzania,Jamhuri ya Muungano wa Tanzania,TZ,Kagera,TZ18,Missenyi,TZ1807,Mushasha,TZ1807181,5083 ,2496 ,2587 ,5083 ,2496 ,0 ,0 ,0 ,2587 
United Republic of Tanzania,Jamhuri ya Muungano wa Tanzania,TZ,Kagera,TZ18,Missenyi,TZ1807,Kilimilil,TZ1807191,11456 ,5652 ,5804 ,11456 ,5652 ,0 ,0 ,0 ,5804 
United Republic of Tanzania,Jamhuri ya Muungano wa Tanzania,TZ,Kagera,TZ18,Missenyi,TZ1807,Mabale,TZ1807201,6212 ,3082 ,3130 ,6212 ,3082 ,0 ,0 ,0 ,3130 
United Republic of Tanzania,Jamhuri ya Muungano wa Tanzania,TZ,Kagera,TZ18,Kyerwa,TZ1808,Isingiro,TZ1808011,16705 ,8040 ,8665 ,16705 ,8040 ,0 ,0 ,0 ,8665 
United Republic of Tanzania,Jamhuri ya Muungano wa Tanzania,TZ,Kagera,TZ18,Kyerwa,TZ1808,Kaisho,TZ1808021,12878 ,6212 ,6666 ,12878 ,6212 ,0 ,0 ,0 ,6666 
United Republic of Tanzania,Jamhuri ya Muungano wa Tanzania,TZ,Kagera,TZ18,Kyerwa,TZ1808,Rutunguru,TZ1808031,9797 ,4864 ,4933 ,9797 ,4864 ,0 ,0 ,0 ,4933 
United Republic of Tanzania,Jamhuri ya Muungano wa Tanzania,TZ,Kagera,TZ18,Kyerwa,TZ1808,Kibingo,TZ1808041,20572 ,10037 ,10535 ,20572 ,10037 ,0 ,0 ,0 ,10535 
United Republic of Tanzania,Jamhuri ya Muungano wa Tanzania,TZ,Kagera,TZ18,Kyerwa,TZ1808,Murongo,TZ1808051,15044 ,7380 ,7664 ,15044 ,7380 ,0 ,0 ,0 ,7664 
United Republic of Tanzania,Jamhuri ya Muungano wa Tanzania,TZ,Kagera,TZ18,Kyerwa,TZ1808,Bugomora,TZ1808061,11144 ,5572 ,5572 ,11144 ,5572 ,0 ,0 ,0 ,5572 
United Republic of Tanzania,Jamhuri ya Muungano wa Tanzania,TZ,Kagera,TZ18,Kyerwa,TZ1808,Kibale,TZ1808071,15254 ,7532 ,7722 ,15254 ,7532 ,0 ,0 ,0 ,7722 
United Republic of Tanzania,Jamhuri ya Muungano wa Tanzania,TZ,Kagera,TZ18,Kyerwa,TZ1808,Mabira,TZ1808081,21529 ,10339 ,11190 ,21529 ,10339 ,0 ,0 ,0 ,11190 
United Republic of Tanzania,Jamhuri ya Muungano wa Tanzania,TZ,Kagera,TZ18,Kyerwa,TZ1808,Businde,TZ1808091,19230 ,9392 ,9838 ,19230 ,9392 ,0 ,0 ,0 ,9838 
United Republic of Tanzania,Jamhuri ya Muungano wa Tanzania,TZ,Kagera,TZ18,Kyerwa,TZ1808,Kamuli,TZ1808101,20074 ,9768 ,10306 ,20074 ,9768 ,0 ,0 ,0 ,10306 
United Republic of Tanzania,Jamhuri ya Muungano wa Tanzania,TZ,Kagera,TZ18,Kyerwa,TZ1808,Nyakatuntu,TZ1808111,15168 ,7461 ,7707 ,15168 ,7461 ,0 ,0 ,0 ,7707 
United Republic of Tanzania,Jamhuri ya Muungano wa Tanzania,TZ,Kagera,TZ18,Kyerwa,TZ1808,Kimuli,TZ1808121,17926 ,8853 ,9073 ,17926 ,8853 ,0 ,0 ,0 ,9073 
United Republic of Tanzania,Jamhuri ya Muungano wa Tanzania,TZ,Kagera,TZ18,Kyerwa,TZ1808,Kikukuru,TZ1808131,17337 ,8471 ,8866 ,17337 ,8471 ,0 ,0 ,0 ,8866 
United Republic of Tanzania,Jamhuri ya Muungano wa Tanzania,TZ,Kagera,TZ18,Kyerwa,TZ1808,Rwabwere,TZ1808141,20669 ,10086 ,10583 ,20669 ,10086 ,0 ,0 ,0 ,10583 
United Republic of Tanzania,Jamhuri ya Muungano wa Tanzania,TZ,Kagera,TZ18,Kyerwa,TZ1808,Nkwenda,TZ1808151,22421 ,10914 ,11507 ,22421 ,10914 ,0 ,0 ,0 ,11507 
United Republic of Tanzania,Jamhuri ya Muungano wa Tanzania,TZ,Kagera,TZ18,Kyerwa,TZ1808,Rukuraijo,TZ1808161,24214 ,11909 ,12305 ,24214 ,11909 ,0 ,0 ,0 ,12305 
United Republic of Tanzania,Jamhuri ya Muungano wa Tanzania,TZ,Kagera,TZ18,Kyerwa,TZ1808,Songambele,TZ1808171,19459 ,9571 ,9888 ,19459 ,9571 ,0 ,0 ,0 ,9888 
United Republic of Tanzania,Jamhuri ya Muungano wa Tanzania,TZ,Kagera,TZ18,Kyerwa,TZ1808,Kyerwa,TZ1808181,21605 ,10797 ,10808 ,21605 ,10797 ,0 ,0 ,0 ,10808 
United Republic of Tanzania,Jamhuri ya Muungano wa Tanzania,TZ,Mwanza,TZ19,Ukerewe,TZ1901,Nansio,TZ1901012,7674 ,3441 ,4233 ,0 ,0 ,7674 ,3441 ,4233 ,0 
United Republic of Tanzania,Jamhuri ya Muungano wa Tanzania,TZ,Mwanza,TZ19,Ukerewe,TZ1901,Kagera,TZ1901022,9427 ,4266 ,5161 ,0 ,0 ,9427 ,4266 ,5161 ,0 
United Republic of Tanzania,Jamhuri ya Muungano wa Tanzania,TZ,Mwanza,TZ19,Ukerewe,TZ1901,Nakatunguru,TZ1901032,8937 ,4095 ,4842 ,0 ,0 ,8937 ,4095 ,4842 ,0 
United Republic of Tanzania,Jamhuri ya Muungano wa Tanzania,TZ,Mwanza,TZ19,Ukerewe,TZ1901,Kakerege,TZ1901041,4223 ,1984 ,2239 ,4223 ,1984 ,0 ,0 ,0 ,2239 
United Republic of Tanzania,Jamhuri ya Muungano wa Tanzania,TZ,Mwanza,TZ19,Ukerewe,TZ1901,Bukongo,TZ1901053,6195 ,2895 ,3300 ,1309 ,596 ,4886 ,2299 ,2587 ,713 
United Republic of Tanzania,Jamhuri ya Muungano wa Tanzania,TZ,Mwanza,TZ19,Ukerewe,TZ1901,Nkilizya,TZ1901063,7854 ,3795 ,4059 ,1608 ,843 ,6246 ,2952 ,3294 ,765 
United Republic of Tanzania,Jamhuri ya Muungano wa Tanzania,TZ,Mwanza,TZ19,Ukerewe,TZ1901,Bukanda,TZ1901071,13344 ,6509 ,6835 ,13344 ,6509 ,0 ,0 ,0 ,6835 
United Republic of Tanzania,Jamhuri ya Muungano wa Tanzania,TZ,Mwanza,TZ19,Ukerewe,TZ1901,Mukituntu,TZ1901081,18960 ,9175 ,9785 ,18960 ,9175 ,0 ,0 ,0 ,9785 
United Republic of Tanzania,Jamhuri ya Muungano wa Tanzania,TZ,Mwanza,TZ19,Ukerewe,TZ1901,Igala,TZ1901091,17368 ,8411 ,8957 ,17368 ,8411 ,0 ,0 ,0 ,8957 
United Republic of Tanzania,Jamhuri ya Muungano wa Tanzania,TZ,Mwanza,TZ19,Ukerewe,TZ1901,Bwiro,TZ1901101,18908 ,9526 ,9382 ,18908 ,9526 ,0 ,0 ,0 ,9382 
United Republic of Tanzania,Jamhuri ya Muungano wa Tanzania,TZ,Mwanza,TZ19,Ukerewe,TZ1901,Muriti,TZ1901113,23014 ,11151 ,11863 ,18191 ,8856 ,4823 ,2295 ,2528 ,9335 
United Republic of Tanzania,Jamhuri ya Muungano wa Tanzania,TZ,Mwanza,TZ19,Ukerewe,TZ1901,Ilangala,TZ1901121,38008 ,19041 ,18967 ,38008 ,19041 ,0 ,0 ,0 ,18967 
United Republic of Tanzania,Jamhuri ya Muungano wa Tanzania,TZ,Mwanza,TZ19,Ukerewe,TZ1901,Namilembe,TZ1901131,16544 ,8065 ,8479 ,16544 ,8065 ,0 ,0 ,0 ,8479 
United Republic of Tanzania,Jamhuri ya Muungano wa Tanzania,TZ,Mwanza,TZ19,Ukerewe,TZ1901,Nduruma,TZ1901141,16397 ,7996 ,8401 ,16397 ,7996 ,0 ,0 ,0 ,8401 
United Republic of Tanzania,Jamhuri ya Muungano wa Tanzania,TZ,Mwanza,TZ19,Ukerewe,TZ1901,Murutunguru,TZ1901151,18156 ,9038 ,9118 ,18156 ,9038 ,0 ,0 ,0 ,9118 
United Republic of Tanzania,Jamhuri ya Muungano wa Tanzania,TZ,Mwanza,TZ19,Ukerewe,TZ1901,Kagunguli,TZ1901161,25130 ,12294 ,12836 ,25130 ,12294 ,0 ,0 ,0 ,12836 
United Republic of Tanzania,Jamhuri ya Muungano wa Tanzania,TZ,Mwanza,TZ19,Ukerewe,TZ1901,Bukindo,TZ1901171,8071 ,4012 ,4059 ,8071 ,4012 ,0 ,0 ,0 ,4059 
United Republic of Tanzania,Jamhuri ya Muungano wa Tanzania,TZ,Mwanza,TZ19,Ukerewe,TZ1901,Namagondo,TZ1901181,12034 ,5938 ,6096 ,12034 ,5938 ,0 ,0 ,0 ,6096 
United Republic of Tanzania,Jamhuri ya Muungano wa Tanzania,TZ,Mwanza,TZ19,Ukerewe,TZ1901,Ngoma,TZ1901191,18008 ,9095 ,8913 ,18008 ,9095 ,0 ,0 ,0 ,8913 
United Republic of Tanzania,Jamhuri ya Muungano wa Tanzania,TZ,Mwanza,TZ19,Ukerewe,TZ1901,Bwisya,TZ1901201,13141 ,6533 ,6608 ,13141 ,6533 ,0 ,0 ,0 ,6608 
United Republic of Tanzania,Jamhuri ya Muungano wa Tanzania,TZ,Mwanza,TZ19,Ukerewe,TZ1901,Bukungu,TZ1901211,8548 ,4287 ,4261 ,8548 ,4287 ,0 ,0 ,0 ,4261 
United Republic of Tanzania,Jamhuri ya Muungano wa Tanzania,TZ,Mwanza,TZ19,Ukerewe,TZ1901,Nyamanga,TZ1901221,7422 ,3618 ,3804 ,7422 ,3618 ,0 ,0 ,0 ,3804 
United Republic of Tanzania,Jamhuri ya Muungano wa Tanzania,TZ,Mwanza,TZ19,Ukerewe,TZ1901,Bukiro,TZ1901231,15911 ,7719 ,8192 ,15911 ,7719 ,0 ,0 ,0 ,8192 
United Republic of Tanzania,Jamhuri ya Muungano wa Tanzania,TZ,Mwanza,TZ19,Ukerewe,TZ1901,Irugwa,TZ1901241,11873 ,6395 ,5478 ,11873 ,6395 ,0 ,0 ,0 ,5478 
United Republic of Tanzania,Jamhuri ya Muungano wa Tanzania,TZ,Mwanza,TZ19,Magu,TZ1902,Kisesa,TZ1902013,30486 ,14639 ,15847 ,21836 ,10551 ,8650 ,4088 ,4562 ,11285 
United Republic of Tanzania,Jamhuri ya Muungano wa Tanzania,TZ,Mwanza,TZ19,Magu,TZ1902,Bujashi,TZ1902021,12881 ,6335 ,6546 ,12881 ,6335 ,0 ,0 ,0 ,6546 
United Republic of Tanzania,Jamhuri ya Muungano wa Tanzania,TZ,Mwanza,TZ19,Magu,TZ1902,Lutale,TZ1902031,12307 ,6026 ,6281 ,12307 ,6026 ,0 ,0 ,0 ,6281 
United Republic of Tanzania,Jamhuri ya Muungano wa Tanzania,TZ,Mwanza,TZ19,Magu,TZ1902,Kongolo,TZ1902041,14264 ,7075 ,7189 ,14264 ,7075 ,0 ,0 ,0 ,7189 
United Republic of Tanzania,Jamhuri ya Muungano wa Tanzania,TZ,Mwanza,TZ19,Magu,TZ1902,Nyanguge,TZ1902053,14449 ,6879 ,7570 ,7688 ,3708 ,6761 ,3171 ,3590 ,3980 
United Republic of Tanzania,Jamhuri ya Muungano wa Tanzania,TZ,Mwanza,TZ19,Magu,TZ1902,Kitongo Sim,TZ1902061,13540 ,6682 ,6858 ,13540 ,6682 ,0 ,0 ,0 ,6858 
United Republic of Tanzania,Jamhuri ya Muungano wa Tanzania,TZ,Mwanza,TZ19,Magu,TZ1902,Mwamanga,TZ1902071,10582 ,5129 ,5453 ,10582 ,5129 ,0 ,0 ,0 ,5453 
United Republic of Tanzania,Jamhuri ya Muungano wa Tanzania,TZ,Mwanza,TZ19,Magu,TZ1902,Kahangara,TZ1902081,19378 ,9576 ,9802 ,19378 ,9576 ,0 ,0 ,0 ,9802 
United Republic of Tanzania,Jamhuri ya Muungano wa Tanzania,TZ,Mwanza,TZ19,Magu,TZ1902,Nyigogo,TZ1902091,25202 ,12214 ,12988 ,25202 ,12214 ,0 ,0 ,0 ,12988 
United Republic of Tanzania,Jamhuri ya Muungano wa Tanzania,TZ,Mwanza,TZ19,Magu,TZ1902,Mwamabanza,TZ1902101,16079 ,7754 ,8325 ,16079 ,7754 ,0 ,0 ,0 ,8325 
United Republic of Tanzania,Jamhuri ya Muungano wa Tanzania,TZ,Mwanza,TZ19,Magu,TZ1902,Sukuma,TZ1902111,18599 ,9189 ,9410 ,18599 ,9189 ,0 ,0 ,0 ,9410 
United Republic of Tanzania,Jamhuri ya Muungano wa Tanzania,TZ,Mwanza,TZ19,Magu,TZ1902,Lubugu,TZ1902121,14858 ,7257 ,7601 ,14858 ,7257 ,0 ,0 ,0 ,7601 
United Republic of Tanzania,Jamhuri ya Muungano wa Tanzania,TZ,Mwanza,TZ19,Magu,TZ1902,Ng'haya,TZ1902131,20024 ,9900 ,10124 ,20024 ,9900 ,0 ,0 ,0 ,10124 
United Republic of Tanzania,Jamhuri ya Muungano wa Tanzania,TZ,Mwanza,TZ19,Magu,TZ1902,Nkungulu,TZ1902141,23539 ,11517 ,12022 ,23539 ,11517 ,0 ,0 ,0 ,12022 
United Republic of Tanzania,Jamhuri ya Muungano wa Tanzania,TZ,Mwanza,TZ19,Magu,TZ1902,Jinjimili,TZ1902151,10167 ,5049 ,5118 ,10167 ,5049 ,0 ,0 ,0 ,5118 
United Republic of Tanzania,Jamhuri ya Muungano wa Tanzania,TZ,Mwanza,TZ19,Magu,TZ1902,Shishani,TZ1902161,15302 ,7582 ,7720 ,15302 ,7582 ,0 ,0 ,0 ,7720 
United Republic of Tanzania,Jamhuri ya Muungano wa Tanzania,TZ,Mwanza,TZ19,Magu,TZ1902,Magu Mjini,TZ1902172,23822 ,11237 ,12585 ,0 ,0 ,23822 ,11237 ,12585 ,0 
United Republic of Tanzania,Jamhuri ya Muungano wa Tanzania,TZ,Mwanza,TZ19,Magu,TZ1902,Bukandwe,TZ1902181,10714 ,5230 ,5484 ,10714 ,5230 ,0 ,0 ,0 ,5484 
United Republic of Tanzania,Jamhuri ya Muungano wa Tanzania,TZ,Mwanza,TZ19,Nyamagana,TZ1903,Mkuyuni,TZ1903012,32199 ,15716 ,16483 ,0 ,0 ,32199 ,15716 ,16483 ,0 
United Republic of Tanzania,Jamhuri ya Muungano wa Tanzania,TZ,Mwanza,TZ19,Nyamagana,TZ1903,Igogo,TZ1903022,27303 ,13374 ,13929 ,0 ,0 ,27303 ,13374 ,13929 ,0 
United Republic of Tanzania,Jamhuri ya Muungano wa Tanzania,TZ,Mwanza,TZ19,Nyamagana,TZ1903,Pamba,TZ1903032,23519 ,11411 ,12108 ,0 ,0 ,23519 ,11411 ,12108 ,0 
United Republic of Tanzania,Jamhuri ya Muungano wa Tanzania,TZ,Mwanza,TZ19,Nyamagana,TZ1903,Nyamagana,TZ1903042,5807 ,2961 ,2846 ,0 ,0 ,5807 ,2961 ,2846 ,0 
United Republic of Tanzania,Jamhuri ya Muungano wa Tanzania,TZ,Mwanza,TZ19,Nyamagana,TZ1903,Mirongo,TZ1903052,2925 ,1478 ,1447 ,0 ,0 ,2925 ,1478 ,1447 ,0 
United Republic of Tanzania,Jamhuri ya Muungano wa Tanzania,TZ,Mwanza,TZ19,Nyamagana,TZ1903,Isamilo,TZ1903062,24220 ,11752 ,12468 ,0 ,0 ,24220 ,11752 ,12468 ,0 
United Republic of Tanzania,Jamhuri ya Muungano wa Tanzania,TZ,Mwanza,TZ19,Nyamagana,TZ1903,Mbugani,TZ1903072,19629 ,9583 ,10046 ,19629 ,9583 ,0 ,0 ,0 ,10046 
United Republic of Tanzania,Jamhuri ya Muungano wa Tanzania,TZ,Mwanza,TZ19,Nyamagana,TZ1903,Mahina,TZ1903082,59437 ,28550 ,30887 ,0 ,0 ,59437 ,28550 ,30887 ,0 
United Republic of Tanzania,Jamhuri ya Muungano wa Tanzania,TZ,Mwanza,TZ19,Nyamagana,TZ1903,Igoma,TZ1903092,56596 ,27321 ,29275 ,0 ,0 ,56596 ,27321 ,29275 ,0 
United Republic of Tanzania,Jamhuri ya Muungano wa Tanzania,TZ,Mwanza,TZ19,Nyamagana,TZ1903,Buhongwa,TZ1903102,26681 ,12789 ,13892 ,0 ,0 ,26681 ,12789 ,13892 ,0 
United Republic of Tanzania,Jamhuri ya Muungano wa Tanzania,TZ,Mwanza,TZ19,Nyamagana,TZ1903,Mkolani,TZ1903112,30728 ,14864 ,15864 ,14300 ,7073 ,16428 ,7791 ,8637 ,7227 
United Republic of Tanzania,Jamhuri ya Muungano wa Tanzania,TZ,Mwanza,TZ19,Nyamagana,TZ1903,Butimba,TZ1903122,46944 ,24287 ,22657 ,0 ,0 ,46944 ,24287 ,22657 ,0 
United Republic of Tanzania,Jamhuri ya Muungano wa Tanzania,TZ,Mwanza,TZ19,Kwimba,TZ1904,Walla,TZ1904011,17190 ,8424 ,8766 ,17190 ,8424 ,0 ,0 ,0 ,8766 
United Republic of Tanzania,Jamhuri ya Muungano wa Tanzania,TZ,Mwanza,TZ19,Kwimba,TZ1904,Bungulwa,TZ1904021,10361 ,5071 ,5290 ,10361 ,5071 ,0 ,0 ,0 ,5290 
United Republic of Tanzania,Jamhuri ya Muungano wa Tanzania,TZ,Mwanza,TZ19,Kwimba,TZ1904,Sumve,TZ1904031,16436 ,7984 ,8452 ,16436 ,7984 ,0 ,0 ,0 ,8452 
United Republic of Tanzania,Jamhuri ya Muungano wa Tanzania,TZ,Mwanza,TZ19,Kwimba,TZ1904,Mantare,TZ1904041,11599 ,5797 ,5802 ,11599 ,5797 ,0 ,0 ,0 ,5802 
United Republic of Tanzania,Jamhuri ya Muungano wa Tanzania,TZ,Mwanza,TZ19,Kwimba,TZ1904,Ngulla,TZ1904051,12692 ,6137 ,6555 ,12692 ,6137 ,0 ,0 ,0 ,6555 
United Republic of Tanzania,Jamhuri ya Muungano wa Tanzania,TZ,Mwanza,TZ19,Kwimba,TZ1904,Mwabomba,TZ1904061,10844 ,5237 ,5607 ,0 ,0 ,10844 ,5237 ,5607 ,0 
United Republic of Tanzania,Jamhuri ya Muungano wa Tanzania,TZ,Mwanza,TZ19,Kwimba,TZ1904,Mwagi,TZ1904071,10096 ,5030 ,5066 ,10096 ,5030 ,0 ,0 ,0 ,5066 
United Republic of Tanzania,Jamhuri ya Muungano wa Tanzania,TZ,Mwanza,TZ19,Kwimba,TZ1904,Iseni,TZ1904081,10349 ,5170 ,5179 ,10349 ,5170 ,0 ,0 ,0 ,5179 
United Republic of Tanzania,Jamhuri ya Muungano wa Tanzania,TZ,Mwanza,TZ19,Kwimba,TZ1904,Nyambiti,TZ1904091,13731 ,6711 ,7020 ,13731 ,6711 ,0 ,0 ,0 ,7020 
United Republic of Tanzania,Jamhuri ya Muungano wa Tanzania,TZ,Mwanza,TZ19,Kwimba,TZ1904,Maligisu,TZ1904101,20788 ,10007 ,10781 ,20788 ,10007 ,0 ,0 ,0 ,10781 
United Republic of Tanzania,Jamhuri ya Muungano wa Tanzania,TZ,Mwanza,TZ19,Kwimba,TZ1904,Mwandu,TZ1904111,11132 ,5479 ,5653 ,11132 ,5479 ,0 ,0 ,0 ,5653 
United Republic of Tanzania,Jamhuri ya Muungano wa Tanzania,TZ,Mwanza,TZ19,Kwimba,TZ1904,Malya,TZ1904123,15437 ,7490 ,7947 ,10766 ,5297 ,4671 ,2193 ,2478 ,5469 
United Republic of Tanzania,Jamhuri ya Muungano wa Tanzania,TZ,Mwanza,TZ19,Kwimba,TZ1904,Lyoma,TZ1904131,12561 ,6104 ,6457 ,12561 ,6104 ,0 ,0 ,0 ,6457 
United Republic of Tanzania,Jamhuri ya Muungano wa Tanzania,TZ,Mwanza,TZ19,Kwimba,TZ1904,Mwang'halanga,TZ1904141,11099 ,5390 ,5709 ,11099 ,5390 ,0 ,0 ,0 ,5709 
United Republic of Tanzania,Jamhuri ya Muungano wa Tanzania,TZ,Mwanza,TZ19,Kwimba,TZ1904,Nyamilama,TZ1904151,7611 ,3724 ,3887 ,7611 ,3724 ,0 ,0 ,0 ,3887 
United Republic of Tanzania,Jamhuri ya Muungano wa Tanzania,TZ,Mwanza,TZ19,Kwimba,TZ1904,Mwakilambiti,TZ1904161,11325 ,5485 ,5840 ,11325 ,5485 ,0 ,0 ,0 ,5840 
United Republic of Tanzania,Jamhuri ya Muungano wa Tanzania,TZ,Mwanza,TZ19,Kwimba,TZ1904,Hungumalwa,TZ1904171,16508 ,7931 ,8577 ,16508 ,7931 ,0 ,0 ,0 ,8577 
United Republic of Tanzania,Jamhuri ya Muungano wa Tanzania,TZ,Mwanza,TZ19,Kwimba,TZ1904,Mwamala,TZ1904181,7380 ,3603 ,3777 ,7380 ,3603 ,0 ,0 ,0 ,3777 
United Republic of Tanzania,Jamhuri ya Muungano wa Tanzania,TZ,Mwanza,TZ19,Kwimba,TZ1904,Kikubiji,TZ1904191,22032 ,10578 ,11454 ,22032 ,10578 ,0 ,0 ,0 ,11454 
United Republic of Tanzania,Jamhuri ya Muungano wa Tanzania,TZ,Mwanza,TZ19,Kwimba,TZ1904,Mhande,TZ1904201,18780 ,9163 ,9617 ,0 ,0 ,18780 ,9163 ,9617 ,0 
United Republic of Tanzania,Jamhuri ya Muungano wa Tanzania,TZ,Mwanza,TZ19,Kwimba,TZ1904,Bupamwa,TZ1904211,17366 ,8437 ,8929 ,17366 ,8437 ,0 ,0 ,0 ,8929 
United Republic of Tanzania,Jamhuri ya Muungano wa Tanzania,TZ,Mwanza,TZ19,Kwimba,TZ1904,Fukalo,TZ1904221,17534 ,8556 ,8978 ,17534 ,8556 ,0 ,0 ,0 ,8978 
United Republic of Tanzania,Jamhuri ya Muungano wa Tanzania,TZ,Mwanza,TZ19,Kwimba,TZ1904,Ng'hundi,TZ1904231,9255 ,4520 ,4735 ,9255 ,4520 ,0 ,0 ,0 ,4735 
United Republic of Tanzania,Jamhuri ya Muungano wa Tanzania,TZ,Mwanza,TZ19,Kwimba,TZ1904,Igongwa,TZ1904241,11705 ,5707 ,5998 ,11705 ,5707 ,0 ,0 ,0 ,5998 
United Republic of Tanzania,Jamhuri ya Muungano wa Tanzania,TZ,Mwanza,TZ19,Kwimba,TZ1904,Ngudu,TZ1904252,27630 ,13471 ,14159 ,0 ,0 ,27630 ,13471 ,14159 ,0 
United Republic of Tanzania,Jamhuri ya Muungano wa Tanzania,TZ,Mwanza,TZ19,Kwimba,TZ1904,Bugando,TZ1904261,7173 ,3468 ,3705 ,7173 ,3468 ,0 ,0 ,0 ,3705 
United Republic of Tanzania,Jamhuri ya Muungano wa Tanzania,TZ,Mwanza,TZ19,Kwimba,TZ1904,Nkalalo,TZ1904271,7266 ,3597 ,3669 ,7266 ,3597 ,0 ,0 ,0 ,3669 
United Republic of Tanzania,Jamhuri ya Muungano wa Tanzania,TZ,Mwanza,TZ19,Kwimba,TZ1904,Mwankulwe,TZ1904281,9495 ,4705 ,4790 ,9495 ,4705 ,0 ,0 ,0 ,4790 
United Republic of Tanzania,Jamhuri ya Muungano wa Tanzania,TZ,Mwanza,TZ19,Kwimba,TZ1904,Ilula,TZ1904291,11966 ,5782 ,6184 ,11966 ,5782 ,0 ,0 ,0 ,6184 
United Republic of Tanzania,Jamhuri ya Muungano wa Tanzania,TZ,Mwanza,TZ19,Kwimba,TZ1904,Shilembo,TZ1904301,9882 ,4875 ,5007 ,9882 ,4875 ,0 ,0 ,0 ,5007 
United Republic of Tanzania,Jamhuri ya Muungano wa Tanzania,TZ,Mwanza,TZ19,Sengerema,TZ1905,Ibisabageni,TZ1905012,13256 ,6251 ,7005 ,0 ,0 ,13256 ,6251 ,7005 ,0 
United Republic of Tanzania,Jamhuri ya Muungano wa Tanzania,TZ,Mwanza,TZ19,Sengerema,TZ1905,Nyamazugo,TZ1905021,16353 ,8100 ,8253 ,16353 ,8100 ,0 ,0 ,0 ,8253 
United Republic of Tanzania,Jamhuri ya Muungano wa Tanzania,TZ,Mwanza,TZ19,Sengerema,TZ1905,Chifumfu,TZ1905031,23381 ,11983 ,11398 ,23381 ,11983 ,0 ,0 ,0 ,11398 
United Republic of Tanzania,Jamhuri ya Muungano wa Tanzania,TZ,Mwanza,TZ19,Sengerema,TZ1905,Katunguru,TZ1905041,20284 ,10131 ,10153 ,20284 ,10131 ,0 ,0 ,0 ,10153 
United Republic of Tanzania,Jamhuri ya Muungano wa Tanzania,TZ,Mwanza,TZ19,Sengerema,TZ1905,Kasungamile,TZ1905051,15599 ,7829 ,7770 ,15599 ,7829 ,0 ,0 ,0 ,7770 
United Republic of Tanzania,Jamhuri ya Muungano wa Tanzania,TZ,Mwanza,TZ19,Sengerema,TZ1905,Nyamatongo,TZ1905061,26707 ,13441 ,13266 ,26707 ,13441 ,0 ,0 ,0 ,13266 
United Republic of Tanzania,Jamhuri ya Muungano wa Tanzania,TZ,Mwanza,TZ19,Sengerema,TZ1905,Tabaruka,TZ1905071,9747 ,4892 ,4855 ,9747 ,4892 ,0 ,0 ,0 ,4855 
United Republic of Tanzania,Jamhuri ya Muungano wa Tanzania,TZ,Mwanza,TZ19,Sengerema,TZ1905,Busisi,TZ1905081,16839 ,8447 ,8392 ,16839 ,8447 ,0 ,0 ,0 ,8392 
United Republic of Tanzania,Jamhuri ya Muungano wa Tanzania,TZ,Mwanza,TZ19,Sengerema,TZ1905,Buyagu,TZ1905091,15483 ,7767 ,7716 ,15483 ,7767 ,0 ,0 ,0 ,7716 
United Republic of Tanzania,Jamhuri ya Muungano wa Tanzania,TZ,Mwanza,TZ19,Sengerema,TZ1905,Igalula,TZ1905101,18851 ,9480 ,9371 ,18851 ,9480 ,0 ,0 ,0 ,9371 
United Republic of Tanzania,Jamhuri ya Muungano wa Tanzania,TZ,Mwanza,TZ19,Sengerema,TZ1905,Kagunga,TZ1905111,19817 ,9849 ,9968 ,19817 ,9849 ,0 ,0 ,0 ,9968 
United Republic of Tanzania,Jamhuri ya Muungano wa Tanzania,TZ,Mwanza,TZ19,Sengerema,TZ1905,Sima,TZ1905121,15477 ,7746 ,7731 ,15477 ,7746 ,0 ,0 ,0 ,7731 
United Republic of Tanzania,Jamhuri ya Muungano wa Tanzania,TZ,Mwanza,TZ19,Sengerema,TZ1905,Nyakasunga,TZ1905131,20817 ,10411 ,10406 ,20817 ,10411 ,0 ,0 ,0 ,10406 
United Republic of Tanzania,Jamhuri ya Muungano wa Tanzania,TZ,Mwanza,TZ19,Sengerema,TZ1905,Kalebezo,TZ1905141,18960 ,9284 ,9676 ,18960 ,9284 ,0 ,0 ,0 ,9676 
United Republic of Tanzania,Jamhuri ya Muungano wa Tanzania,TZ,Mwanza,TZ19,Sengerema,TZ1905,Nyehunge,TZ1905151,35726 ,17445 ,18281 ,35726 ,17445 ,0 ,0 ,0 ,18281 
United Republic of Tanzania,Jamhuri ya Muungano wa Tanzania,TZ,Mwanza,TZ19,Sengerema,TZ1905,Kafunzo,TZ1905161,10743 ,5287 ,5456 ,10743 ,5287 ,0 ,0 ,0 ,5456 
United Republic of Tanzania,Jamhuri ya Muungano wa Tanzania,TZ,Mwanza,TZ19,Sengerema,TZ1905,Bupandwa,TZ1905171,30194 ,14873 ,15321 ,30194 ,14873 ,0 ,0 ,0 ,15321 
United Republic of Tanzania,Jamhuri ya Muungano wa Tanzania,TZ,Mwanza,TZ19,Sengerema,TZ1905,Katwe,TZ1905181,24167 ,12111 ,12056 ,24167 ,12111 ,0 ,0 ,0 ,12056 
United Republic of Tanzania,Jamhuri ya Muungano wa Tanzania,TZ,Mwanza,TZ19,Sengerema,TZ1905,Maisome,TZ1905191,16489 ,8699 ,7790 ,16489 ,8699 ,0 ,0 ,0 ,7790 
United Republic of Tanzania,Jamhuri ya Muungano wa Tanzania,TZ,Mwanza,TZ19,Sengerema,TZ1905,Kazunzu,TZ1905201,14063 ,6995 ,7068 ,14063 ,6995 ,0 ,0 ,0 ,7068 
United Republic of Tanzania,Jamhuri ya Muungano wa Tanzania,TZ,Mwanza,TZ19,Sengerema,TZ1905,Lugata,TZ1905211,25593 ,12980 ,12613 ,25593 ,12980 ,0 ,0 ,0 ,12613 
United Republic of Tanzania,Jamhuri ya Muungano wa Tanzania,TZ,Mwanza,TZ19,Sengerema,TZ1905,Nyakaliro,TZ1905221,33830 ,16740 ,17090 ,33830 ,16740 ,0 ,0 ,0 ,17090 
United Republic of Tanzania,Jamhuri ya Muungano wa Tanzania,TZ,Mwanza,TZ19,Sengerema,TZ1905,Nyakasasa,TZ1905231,21941 ,11500 ,10441 ,21941 ,11500 ,0 ,0 ,0 ,10441 
United Republic of Tanzania,Jamhuri ya Muungano wa Tanzania,TZ,Mwanza,TZ19,Sengerema,TZ1905,Buzilasoga,TZ1905241,13348 ,6661 ,6687 ,13348 ,6661 ,0 ,0 ,0 ,6687 
United Republic of Tanzania,Jamhuri ya Muungano wa Tanzania,TZ,Mwanza,TZ19,Sengerema,TZ1905,Nyanzenda,TZ1905251,20654 ,10020 ,10634 ,20654 ,10020 ,0 ,0 ,0 ,10634 
United Republic of Tanzania,Jamhuri ya Muungano wa Tanzania,TZ,Mwanza,TZ19,Sengerema,TZ1905,Bulyaheke,TZ1905261,35378 ,18024 ,17354 ,35378 ,18024 ,0 ,0 ,0 ,17354 
United Republic of Tanzania,Jamhuri ya Muungano wa Tanzania,TZ,Mwanza,TZ19,Sengerema,TZ1905,Irenza,TZ1905271,19212 ,9602 ,9610 ,19212 ,9602 ,0 ,0 ,0 ,9610 
United Republic of Tanzania,Jamhuri ya Muungano wa Tanzania,TZ,Mwanza,TZ19,Sengerema,TZ1905,Kasenyi,TZ1905281,15591 ,7835 ,7756 ,15591 ,7835 ,0 ,0 ,0 ,7756 
United Republic of Tanzania,Jamhuri ya Muungano wa Tanzania,TZ,Mwanza,TZ19,Sengerema,TZ1905,Mwambului,TZ1905292,12847 ,6471 ,6376 ,12847 ,6471 ,0 ,0 ,0 ,6376 
United Republic of Tanzania,Jamhuri ya Muungano wa Tanzania,TZ,Mwanza,TZ19,Sengerema,TZ1905,Nyatukala,TZ1905302,20166 ,9748 ,10418 ,0 ,0 ,20166 ,9748 ,10418 ,0 
United Republic of Tanzania,Jamhuri ya Muungano wa Tanzania,TZ,Mwanza,TZ19,Sengerema,TZ1905,Nyampulukano,TZ1905312,32648 ,15289 ,17359 ,0 ,0 ,32648 ,15289 ,17359 ,0 
United Republic of Tanzania,Jamhuri ya Muungano wa Tanzania,TZ,Mwanza,TZ19,Sengerema,TZ1905,Nyampande,TZ1905321,9571 ,4701 ,4870 ,9571 ,4701 ,0 ,0 ,0 ,4870 
United Republic of Tanzania,Jamhuri ya Muungano wa Tanzania,TZ,Mwanza,TZ19,Sengerema,TZ1905,Kishinda,TZ1905331,12342 ,6115 ,6227 ,12342 ,6115 ,0 ,0 ,0 ,6227 
United Republic of Tanzania,Jamhuri ya Muungano wa Tanzania,TZ,Mwanza,TZ19,Sengerema,TZ1905,Igulumuki,TZ1905341,8963 ,4545 ,4418 ,8963 ,4545 ,0 ,0 ,0 ,4418 
United Republic of Tanzania,Jamhuri ya Muungano wa Tanzania,TZ,Mwanza,TZ19,Ilemela,TZ1906,Buswelu,TZ1906012,22897 ,11047 ,11850 ,0 ,0 ,22897 ,11047 ,11850 ,0 
United Republic of Tanzania,Jamhuri ya Muungano wa Tanzania,TZ,Mwanza,TZ19,Ilemela,TZ1906,Nyakato,TZ1906022,82348 ,39264 ,43084 ,0 ,0 ,82348 ,39264 ,43084 ,0 
United Republic of Tanzania,Jamhuri ya Muungano wa Tanzania,TZ,Mwanza,TZ19,Ilemela,TZ1906,Nyamanoro,TZ1906032,51456 ,23945 ,27511 ,0 ,0 ,51456 ,23945 ,27511 ,0 
United Republic of Tanzania,Jamhuri ya Muungano wa Tanzania,TZ,Mwanza,TZ19,Ilemela,TZ1906,Kirumba,TZ1906042,28103 ,13621 ,14482 ,0 ,0 ,28103 ,13621 ,14482 ,0 
United Republic of Tanzania,Jamhuri ya Muungano wa Tanzania,TZ,Mwanza,TZ19,Ilemela,TZ1906,Kitangiri,TZ1906052,20802 ,9877 ,10925 ,0 ,0 ,20802 ,9877 ,10925 ,0 
United Republic of Tanzania,Jamhuri ya Muungano wa Tanzania,TZ,Mwanza,TZ19,Ilemela,TZ1906,Pasiansi,TZ1906062,35723 ,17360 ,18363 ,0 ,0 ,35723 ,17360 ,18363 ,0 
United Republic of Tanzania,Jamhuri ya Muungano wa Tanzania,TZ,Mwanza,TZ19,Ilemela,TZ1906,Ilemela,TZ1906072,43244 ,20694 ,22550 ,0 ,0 ,43244 ,20694 ,22550 ,0 
United Republic of Tanzania,Jamhuri ya Muungano wa Tanzania,TZ,Mwanza,TZ19,Ilemela,TZ1906,Bugogwa,TZ1906082,37312 ,18311 ,19001 ,0 ,0 ,37312 ,18311 ,19001 ,0 
United Republic of Tanzania,Jamhuri ya Muungano wa Tanzania,TZ,Mwanza,TZ19,Ilemela,TZ1906,Sangabuye,TZ1906092,21116 ,10599 ,10517 ,0 ,0 ,21116 ,10599 ,10517 ,0 
United Republic of Tanzania,Jamhuri ya Muungano wa Tanzania,TZ,Mwanza,TZ19,Misungwi,TZ1907,Bulemeji,TZ1907011,9387 ,4677 ,4710 ,9387 ,4677 ,0 ,0 ,0 ,4710 
United Republic of Tanzania,Jamhuri ya Muungano wa Tanzania,TZ,Mwanza,TZ19,Misungwi,TZ1907,Idetemya,TZ1907021,15387 ,7592 ,7795 ,15387 ,7592 ,0 ,0 ,0 ,7795 
United Republic of Tanzania,Jamhuri ya Muungano wa Tanzania,TZ,Mwanza,TZ19,Misungwi,TZ1907,Usagara,TZ1907033,15037 ,7364 ,7673 ,9973 ,4961 ,5064 ,2403 ,2661 ,5012 
United Republic of Tanzania,Jamhuri ya Muungano wa Tanzania,TZ,Mwanza,TZ19,Misungwi,TZ1907,Ukiriguru,TZ1907041,10271 ,5044 ,5227 ,10271 ,5044 ,0 ,0 ,0 ,5227 
United Republic of Tanzania,Jamhuri ya Muungano wa Tanzania,TZ,Mwanza,TZ19,Misungwi,TZ1907,Kanyelele,TZ1907051,14371 ,7158 ,7213 ,14371 ,7158 ,0 ,0 ,0 ,7213 
United Republic of Tanzania,Jamhuri ya Muungano wa Tanzania,TZ,Mwanza,TZ19,Misungwi,TZ1907,Koromije,TZ1907061,13686 ,6788 ,6898 ,13686 ,6788 ,0 ,0 ,0 ,6898 
United Republic of Tanzania,Jamhuri ya Muungano wa Tanzania,TZ,Mwanza,TZ19,Misungwi,TZ1907,Igokelo,TZ1907071,18305 ,9087 ,9218 ,18305 ,9087 ,0 ,0 ,0 ,9218 
United Republic of Tanzania,Jamhuri ya Muungano wa Tanzania,TZ,Mwanza,TZ19,Misungwi,TZ1907,Mwaniko,TZ1907081,8144 ,4005 ,4139 ,8144 ,4005 ,0 ,0 ,0 ,4139 
United Republic of Tanzania,Jamhuri ya Muungano wa Tanzania,TZ,Mwanza,TZ19,Misungwi,TZ1907,Misungwi,TZ1907093,16574 ,7941 ,8633 ,10739 ,5163 ,5835 ,2778 ,3057 ,5576 
United Republic of Tanzania,Jamhuri ya Muungano wa Tanzania,TZ,Mwanza,TZ19,Misungwi,TZ1907,Masasi,TZ1907103,15216 ,7454 ,7762 ,15216 ,7454 ,0 ,0 ,0 ,7762 
United Republic of Tanzania,Jamhuri ya Muungano wa Tanzania,TZ,Mwanza,TZ19,Misungwi,TZ1907,Kijima,TZ1907111,12034 ,5888 ,6146 ,12034 ,5888 ,0 ,0 ,0 ,6146 
United Republic of Tanzania,Jamhuri ya Muungano wa Tanzania,TZ,Mwanza,TZ19,Misungwi,TZ1907,Shilalo,TZ1907121,13205 ,6483 ,6722 ,13205 ,6483 ,0 ,0 ,0 ,6722 
United Republic of Tanzania,Jamhuri ya Muungano wa Tanzania,TZ,Mwanza,TZ19,Misungwi,TZ1907,Buhingo,TZ1907131,13871 ,6772 ,7099 ,13871 ,6772 ,0 ,0 ,0 ,7099 
United Republic of Tanzania,Jamhuri ya Muungano wa Tanzania,TZ,Mwanza,TZ19,Misungwi,TZ1907,Busongo,TZ1907141,9022 ,4504 ,4518 ,9022 ,4504 ,0 ,0 ,0 ,4518 
United Republic of Tanzania,Jamhuri ya Muungano wa Tanzania,TZ,Mwanza,TZ19,Misungwi,TZ1907,Nhundulu,TZ1907151,20236 ,9920 ,10316 ,20236 ,9920 ,0 ,0 ,0 ,10316 
United Republic of Tanzania,Jamhuri ya Muungano wa Tanzania,TZ,Mwanza,TZ19,Misungwi,TZ1907,Lubili,TZ1907161,5572 ,2796 ,2776 ,5572 ,2796 ,0 ,0 ,0 ,2776 
United Republic of Tanzania,Jamhuri ya Muungano wa Tanzania,TZ,Mwanza,TZ19,Misungwi,TZ1907,Ilujamate,TZ1907171,15195 ,8148 ,7047 ,15195 ,8148 ,0 ,0 ,0 ,7047 
United Republic of Tanzania,Jamhuri ya Muungano wa Tanzania,TZ,Mwanza,TZ19,Misungwi,TZ1907,Mbarika,TZ1907181,39041 ,19010 ,20031 ,0 ,0 ,39041 ,19010 ,20031 ,0 
United Republic of Tanzania,Jamhuri ya Muungano wa Tanzania,TZ,Mwanza,TZ19,Misungwi,TZ1907,Sumbugu,TZ1907191,14100 ,6973 ,7127 ,14100 ,6973 ,0 ,0 ,0 ,7127 
United Republic of Tanzania,Jamhuri ya Muungano wa Tanzania,TZ,Mwanza,TZ19,Misungwi,TZ1907,Kasololo,TZ1907201,15896 ,7860 ,8036 ,15896 ,7860 ,0 ,0 ,0 ,8036 
United Republic of Tanzania,Jamhuri ya Muungano wa Tanzania,TZ,Mwanza,TZ19,Misungwi,TZ1907,Ilalambogo,TZ1907211,5691 ,2834 ,2857 ,5691 ,2834 ,0 ,0 ,0 ,2857 
United Republic of Tanzania,Jamhuri ya Muungano wa Tanzania,TZ,Mwanza,TZ19,Misungwi,TZ1907,Isesa,TZ1907221,7579 ,3724 ,3855 ,7579 ,3724 ,0 ,0 ,0 ,3855 
United Republic of Tanzania,Jamhuri ya Muungano wa Tanzania,TZ,Mwanza,TZ19,Misungwi,TZ1907,Gulumungu,TZ1907231,11638 ,5833 ,5805 ,11638 ,5833 ,0 ,0 ,0 ,5805 
United Republic of Tanzania,Jamhuri ya Muungano wa Tanzania,TZ,Mwanza,TZ19,Misungwi,TZ1907,Mabuki,TZ1907241,16314 ,8322 ,7992 ,16314 ,8322 ,0 ,0 ,0 ,7992 
United Republic of Tanzania,Jamhuri ya Muungano wa Tanzania,TZ,Mwanza,TZ19,Misungwi,TZ1907,Mondo,TZ1907251,9451 ,4671 ,4780 ,9451 ,4671 ,0 ,0 ,0 ,4780 
United Republic of Tanzania,Jamhuri ya Muungano wa Tanzania,TZ,Mwanza,TZ19,Misungwi,TZ1907,Mamaye,TZ1907261,8789 ,4340 ,4449 ,8789 ,4340 ,0 ,0 ,0 ,4449 
United Republic of Tanzania,Jamhuri ya Muungano wa Tanzania,TZ,Mwanza,TZ19,Misungwi,TZ1907,Fella,TZ1907271,5908 ,2955 ,2953 ,5908 ,2955 ,0 ,0 ,0 ,2953 
United Republic of Tanzania,Jamhuri ya Muungano wa Tanzania,TZ,Mara,TZ20,Tarime,TZ2001,Susuni,TZ2001011,10381 ,4885 ,5496 ,10381 ,4885 ,0 ,0 ,0 ,5496 
United Republic of Tanzania,Jamhuri ya Muungano wa Tanzania,TZ,Mara,TZ20,Tarime,TZ2001,Mwema,TZ2001021,10204 ,4981 ,5223 ,10204 ,4981 ,0 ,0 ,0 ,5223 
United Republic of Tanzania,Jamhuri ya Muungano wa Tanzania,TZ,Mara,TZ20,Tarime,TZ2001,Sirari,TZ2001033,15917 ,7574 ,8343 ,4933 ,2423 ,10984 ,5151 ,5833 ,2510 
United Republic of Tanzania,Jamhuri ya Muungano wa Tanzania,TZ,Mara,TZ20,Tarime,TZ2001,Pemba,TZ2001041,10844 ,5174 ,5670 ,10844 ,5174 ,0 ,0 ,0 ,5670 
United Republic of Tanzania,Jamhuri ya Muungano wa Tanzania,TZ,Mara,TZ20,Tarime,TZ2001,Nyakonga,TZ2001051,6797 ,3288 ,3509 ,6797 ,3288 ,0 ,0 ,0 ,3509 
United Republic of Tanzania,Jamhuri ya Muungano wa Tanzania,TZ,Mara,TZ20,Tarime,TZ2001,Nyarero,TZ2001061,12331 ,5952 ,6379 ,12331 ,5952 ,0 ,0 ,0 ,6379 
United Republic of Tanzania,Jamhuri ya Muungano wa Tanzania,TZ,Mara,TZ20,Tarime,TZ2001,Nyamwaga,TZ2001071,13917 ,6677 ,7240 ,13917 ,6677 ,0 ,0 ,0 ,7240 
United Republic of Tanzania,Jamhuri ya Muungano wa Tanzania,TZ,Mara,TZ20,Tarime,TZ2001,Muriba,TZ2001081,10861 ,5283 ,5578 ,10861 ,5283 ,0 ,0 ,0 ,5578 
United Republic of Tanzania,Jamhuri ya Muungano wa Tanzania,TZ,Mara,TZ20,Tarime,TZ2001,Nyanungu,TZ2001091,11272 ,5352 ,5920 ,11272 ,5352 ,0 ,0 ,0 ,5920 
United Republic of Tanzania,Jamhuri ya Muungano wa Tanzania,TZ,Mara,TZ20,Tarime,TZ2001,Gorong'a,TZ2001101,11062 ,5321 ,5741 ,11062 ,5321 ,0 ,0 ,0 ,5741 
United Republic of Tanzania,Jamhuri ya Muungano wa Tanzania,TZ,Mara,TZ20,Tarime,TZ2001,Nyarokoba,TZ2001111,15670 ,7466 ,8204 ,15670 ,7466 ,0 ,0 ,0 ,8204 
United Republic of Tanzania,Jamhuri ya Muungano wa Tanzania,TZ,Mara,TZ20,Tarime,TZ2001,Kemambo,TZ2001121,13338 ,6591 ,6747 ,13338 ,6591 ,0 ,0 ,0 ,6747 
United Republic of Tanzania,Jamhuri ya Muungano wa Tanzania,TZ,Mara,TZ20,Tarime,TZ2001,Kibasuka,TZ2001131,15137 ,7167 ,7970 ,15137 ,7167 ,0 ,0 ,0 ,7970 
United Republic of Tanzania,Jamhuri ya Muungano wa Tanzania,TZ,Mara,TZ20,Tarime,TZ2001,Binagi,TZ2001141,9443 ,4555 ,4888 ,9443 ,4555 ,0 ,0 ,0 ,4888 
United Republic of Tanzania,Jamhuri ya Muungano wa Tanzania,TZ,Mara,TZ20,Tarime,TZ2001,Turwa,TZ2001153,27238 ,13010 ,14228 ,19723 ,9448 ,7515 ,3562 ,3953 ,10275 
United Republic of Tanzania,Jamhuri ya Muungano wa Tanzania,TZ,Mara,TZ20,Tarime,TZ2001,Bomani,TZ2001162,9165 ,4621 ,4544 ,0 ,0 ,9165 ,4621 ,4544 ,0 
United Republic of Tanzania,Jamhuri ya Muungano wa Tanzania,TZ,Mara,TZ20,Tarime,TZ2001,Nyandoto,TZ2001171,7893 ,3721 ,4172 ,7893 ,3721 ,0 ,0 ,0 ,4172 
United Republic of Tanzania,Jamhuri ya Muungano wa Tanzania,TZ,Mara,TZ20,Tarime,TZ2001,Matongo,TZ2001183,19176 ,9490 ,9686 ,4760 ,2289 ,14416 ,7201 ,7215 ,2471 
United Republic of Tanzania,Jamhuri ya Muungano wa Tanzania,TZ,Mara,TZ20,Tarime,TZ2001,Manga,TZ2001191,7249 ,3493 ,3756 ,7249 ,3493 ,0 ,0 ,0 ,3756 
United Republic of Tanzania,Jamhuri ya Muungano wa Tanzania,TZ,Mara,TZ20,Tarime,TZ2001,Bumera,TZ2001201,9601 ,4490 ,5111 ,9601 ,4490 ,0 ,0 ,0 ,5111 
United Republic of Tanzania,Jamhuri ya Muungano wa Tanzania,TZ,Mara,TZ20,Tarime,TZ2001,Komaswa,TZ2001211,6860 ,3238 ,3622 ,6860 ,3238 ,0 ,0 ,0 ,3622 
United Republic of Tanzania,Jamhuri ya Muungano wa Tanzania,TZ,Mara,TZ20,Tarime,TZ2001,Kiore,TZ2001221,8020 ,3790 ,4230 ,8020 ,3790 ,0 ,0 ,0 ,4230 
United Republic of Tanzania,Jamhuri ya Muungano wa Tanzania,TZ,Mara,TZ20,Tarime,TZ2001,Sabasaba,TZ2001232,11524 ,5368 ,6156 ,0 ,0 ,11524 ,5368 ,6156 ,0 
United Republic of Tanzania,Jamhuri ya Muungano wa Tanzania,TZ,Mara,TZ20,Tarime,TZ2001,Nyamisangura,TZ2001242,12742 ,5874 ,6868 ,0 ,0 ,12742 ,5874 ,6868 ,0 
United Republic of Tanzania,Jamhuri ya Muungano wa Tanzania,TZ,Mara,TZ20,Tarime,TZ2001,Kentare,TZ2001251,9475 ,4542 ,4933 ,9475 ,4542 ,0 ,0 ,0 ,4933 
United Republic of Tanzania,Jamhuri ya Muungano wa Tanzania,TZ,Mara,TZ20,Tarime,TZ2001,Nyamaranga,TZ2001261,10966 ,5348 ,5618 ,10966 ,5348 ,0 ,0 ,0 ,5618 
United Republic of Tanzania,Jamhuri ya Muungano wa Tanzania,TZ,Mara,TZ20,Tarime,TZ2001,Mbogi,TZ2001271,8124 ,3966 ,4158 ,8124 ,3966 ,0 ,0 ,0 ,4158 
United Republic of Tanzania,Jamhuri ya Muungano wa Tanzania,TZ,Mara,TZ20,Tarime,TZ2001,Genyange,TZ2001281,7453 ,3560 ,3893 ,7453 ,3560 ,0 ,0 ,0 ,3893 
United Republic of Tanzania,Jamhuri ya Muungano wa Tanzania,TZ,Mara,TZ20,Tarime,TZ2001,Nyansicha,TZ2001291,7061 ,3426 ,3635 ,7061 ,3426 ,0 ,0 ,0 ,3635 
United Republic of Tanzania,Jamhuri ya Muungano wa Tanzania,TZ,Mara,TZ20,Tarime,TZ2001,Itiryo,TZ2001301,9972 ,4783 ,5189 ,9972 ,4783 ,0 ,0 ,0 ,5189 
United Republic of Tanzania,Jamhuri ya Muungano wa Tanzania,TZ,Mara,TZ20,Serengeti,TZ2002,Kenyamonta,TZ2002011,11336 ,5363 ,5973 ,11336 ,5363 ,0 ,0 ,0 ,5973 
United Republic of Tanzania,Jamhuri ya Muungano wa Tanzania,TZ,Mara,TZ20,Serengeti,TZ2002,Busawe,TZ2002021,5532 ,2707 ,2825 ,5532 ,2707 ,0 ,0 ,0 ,2825 
United Republic of Tanzania,Jamhuri ya Muungano wa Tanzania,TZ,Mara,TZ20,Serengeti,TZ2002,Kisaka,TZ2002031,12534 ,6046 ,6488 ,12534 ,6046 ,0 ,0 ,0 ,6488 
United Republic of Tanzania,Jamhuri ya Muungano wa Tanzania,TZ,Mara,TZ20,Serengeti,TZ2002,Kebanchabancha,TZ2002041,8241 ,4015 ,4226 ,8241 ,4015 ,0 ,0 ,0 ,4226 
United Republic of Tanzania,Jamhuri ya Muungano wa Tanzania,TZ,Mara,TZ20,Serengeti,TZ2002,Ring'wani,TZ2002051,8785 ,4191 ,4594 ,8785 ,4191 ,0 ,0 ,0 ,4594 
United Republic of Tanzania,Jamhuri ya Muungano wa Tanzania,TZ,Mara,TZ20,Serengeti,TZ2002,Rung'abure,TZ2002061,9698 ,4662 ,5036 ,9698 ,4662 ,0 ,0 ,0 ,5036 
United Republic of Tanzania,Jamhuri ya Muungano wa Tanzania,TZ,Mara,TZ20,Serengeti,TZ2002,Machochwe,TZ2002071,9871 ,4639 ,5232 ,9871 ,4639 ,0 ,0 ,0 ,5232 
United Republic of Tanzania,Jamhuri ya Muungano wa Tanzania,TZ,Mara,TZ20,Serengeti,TZ2002,Kisangura,TZ2002081,8506 ,4227 ,4279 ,8506 ,4227 ,0 ,0 ,0 ,4279 
United Republic of Tanzania,Jamhuri ya Muungano wa Tanzania,TZ,Mara,TZ20,Serengeti,TZ2002,Mugumu,TZ2002092,10226 ,4958 ,5268 ,0 ,0 ,10226 ,4958 ,5268 ,0 
United Republic of Tanzania,Jamhuri ya Muungano wa Tanzania,TZ,Mara,TZ20,Serengeti,TZ2002,Ikoma,TZ2002101,6502 ,4015 ,2487 ,6502 ,4015 ,0 ,0 ,0 ,2487 
United Republic of Tanzania,Jamhuri ya Muungano wa Tanzania,TZ,Mara,TZ20,Serengeti,TZ2002,Natta,TZ2002111,12849 ,6504 ,6345 ,12849 ,6504 ,0 ,0 ,0 ,6345 
United Republic of Tanzania,Jamhuri ya Muungano wa Tanzania,TZ,Mara,TZ20,Serengeti,TZ2002,Issenye,TZ2002123,10161 ,4946 ,5215 ,7454 ,3696 ,2707 ,1250 ,1457 ,3758 
United Republic of Tanzania,Jamhuri ya Muungano wa Tanzania,TZ,Mara,TZ20,Serengeti,TZ2002,Rigicha,TZ2002131,9465 ,4637 ,4828 ,9465 ,4637 ,0 ,0 ,0 ,4828 
United Republic of Tanzania,Jamhuri ya Muungano wa Tanzania,TZ,Mara,TZ20,Serengeti,TZ2002,Nyambureti,TZ2002141,14158 ,6832 ,7326 ,14158 ,6832 ,0 ,0 ,0 ,7326 
United Republic of Tanzania,Jamhuri ya Muungano wa Tanzania,TZ,Mara,TZ20,Serengeti,TZ2002,Nyamoko,TZ2002151,8237 ,3923 ,4314 ,8237 ,3923 ,0 ,0 ,0 ,4314 
United Republic of Tanzania,Jamhuri ya Muungano wa Tanzania,TZ,Mara,TZ20,Serengeti,TZ2002,Manchira,TZ2002161,7888 ,3938 ,3950 ,7888 ,3938 ,0 ,0 ,0 ,3950 
United Republic of Tanzania,Jamhuri ya Muungano wa Tanzania,TZ,Mara,TZ20,Serengeti,TZ2002,Kyambahi,TZ2002171,7022 ,3510 ,3512 ,7022 ,3510 ,0 ,0 ,0 ,3512 
United Republic of Tanzania,Jamhuri ya Muungano wa Tanzania,TZ,Mara,TZ20,Serengeti,TZ2002,Nyamatare,TZ2002181,5476 ,2607 ,2869 ,5476 ,2607 ,0 ,0 ,0 ,2869 
United Republic of Tanzania,Jamhuri ya Muungano wa Tanzania,TZ,Mara,TZ20,Serengeti,TZ2002,Majimoto,TZ2002191,8536 ,4170 ,4366 ,8536 ,4170 ,0 ,0 ,0 ,4366 
United Republic of Tanzania,Jamhuri ya Muungano wa Tanzania,TZ,Mara,TZ20,Serengeti,TZ2002,Magange,TZ2002201,7262 ,3474 ,3788 ,7262 ,3474 ,0 ,0 ,0 ,3788 
United Republic of Tanzania,Jamhuri ya Muungano wa Tanzania,TZ,Mara,TZ20,Serengeti,TZ2002,Nyansurura,TZ2002211,10129 ,4898 ,5231 ,10129 ,4898 ,0 ,0 ,0 ,5231 
United Republic of Tanzania,Jamhuri ya Muungano wa Tanzania,TZ,Mara,TZ20,Serengeti,TZ2002,Mosongo,TZ2002221,11618 ,5638 ,5980 ,11618 ,5638 ,0 ,0 ,0 ,5980 
United Republic of Tanzania,Jamhuri ya Muungano wa Tanzania,TZ,Mara,TZ20,Serengeti,TZ2002,Sedeco,TZ2002231,11436 ,5388 ,6048 ,11436 ,5388 ,0 ,0 ,0 ,6048 
United Republic of Tanzania,Jamhuri ya Muungano wa Tanzania,TZ,Mara,TZ20,Serengeti,TZ2002,Mbalibali,TZ2002241,11390 ,5419 ,5971 ,11390 ,5419 ,0 ,0 ,0 ,5971 
United Republic of Tanzania,Jamhuri ya Muungano wa Tanzania,TZ,Mara,TZ20,Serengeti,TZ2002,Stendi Kuu,TZ2002252,6625 ,3117 ,3508 ,0 ,0 ,6625 ,3117 ,3508 ,0 
United Republic of Tanzania,Jamhuri ya Muungano wa Tanzania,TZ,Mara,TZ20,Serengeti,TZ2002,Geitasamo,TZ2002261,5520 ,2607 ,2913 ,5520 ,2607 ,0 ,0 ,0 ,2913 
United Republic of Tanzania,Jamhuri ya Muungano wa Tanzania,TZ,Mara,TZ20,Serengeti,TZ2002,Morotonga,TZ2002273,4108 ,1936 ,2172 ,2182 ,1052 ,1926 ,884 ,1042 ,1130 
United Republic of Tanzania,Jamhuri ya Muungano wa Tanzania,TZ,Mara,TZ20,Serengeti,TZ2002,Uwanja wa Ndege,TZ2002281,6309 ,3032 ,3277 ,6309 ,3032 ,0 ,0 ,0 ,3277 
United Republic of Tanzania,Jamhuri ya Muungano wa Tanzania,TZ,Mara,TZ20,Musoma,TZ2003,Bukumi,TZ2003011,12097 ,5865 ,6232 ,12097 ,5865 ,0 ,0 ,0 ,6232 
United Republic of Tanzania,Jamhuri ya Muungano wa Tanzania,TZ,Mara,TZ20,Musoma,TZ2003,Makojo,TZ2003021,9648 ,4720 ,4928 ,9648 ,4720 ,0 ,0 ,0 ,4928 
United Republic of Tanzania,Jamhuri ya Muungano wa Tanzania,TZ,Mara,TZ20,Musoma,TZ2003,Bwasi,TZ2003031,11717 ,5624 ,6093 ,11717 ,5624 ,0 ,0 ,0 ,6093 
United Republic of Tanzania,Jamhuri ya Muungano wa Tanzania,TZ,Mara,TZ20,Musoma,TZ2003,Bulinga,TZ2003041,6368 ,3077 ,3291 ,6368 ,3077 ,0 ,0 ,0 ,3291 
United Republic of Tanzania,Jamhuri ya Muungano wa Tanzania,TZ,Mara,TZ20,Musoma,TZ2003,Bukima,TZ2003051,18537 ,8996 ,9541 ,18537 ,8996 ,0 ,0 ,0 ,9541 
United Republic of Tanzania,Jamhuri ya Muungano wa Tanzania,TZ,Mara,TZ20,Musoma,TZ2003,Murangi,TZ2003061,16933 ,8411 ,8522 ,16933 ,8411 ,0 ,0 ,0 ,8522 
United Republic of Tanzania,Jamhuri ya Muungano wa Tanzania,TZ,Mara,TZ20,Musoma,TZ2003,Bugwema,TZ2003071,11251 ,5635 ,5616 ,11251 ,5635 ,0 ,0 ,0 ,5616 
United Republic of Tanzania,Jamhuri ya Muungano wa Tanzania,TZ,Mara,TZ20,Musoma,TZ2003,Nyamrandirira,TZ2003081,13705 ,6856 ,6849 ,13705 ,6856 ,0 ,0 ,0 ,6849 
United Republic of Tanzania,Jamhuri ya Muungano wa Tanzania,TZ,Mara,TZ20,Musoma,TZ2003,Nyambono,TZ2003091,18106 ,8888 ,9218 ,18106 ,8888 ,0 ,0 ,0 ,9218 
United Republic of Tanzania,Jamhuri ya Muungano wa Tanzania,TZ,Mara,TZ20,Musoma,TZ2003,Suguti,TZ2003101,13729 ,6704 ,7025 ,13729 ,6704 ,0 ,0 ,0 ,7025 
United Republic of Tanzania,Jamhuri ya Muungano wa Tanzania,TZ,Mara,TZ20,Musoma,TZ2003,Tegeruka,TZ2003111,10701 ,5240 ,5461 ,10701 ,5240 ,0 ,0 ,0 ,5461 
United Republic of Tanzania,Jamhuri ya Muungano wa Tanzania,TZ,Mara,TZ20,Musoma,TZ2003,Kiriba,TZ2003121,16737 ,8301 ,8436 ,16737 ,8301 ,0 ,0 ,0 ,8436 
United Republic of Tanzania,Jamhuri ya Muungano wa Tanzania,TZ,Mara,TZ20,Musoma,TZ2003,Busambara,TZ2003131,8706 ,4141 ,4565 ,8706 ,4141 ,0 ,0 ,0 ,4565 
United Republic of Tanzania,Jamhuri ya Muungano wa Tanzania,TZ,Mara,TZ20,Musoma,TZ2003,Mugango,TZ2003143,10121 ,4866 ,5255 ,7546 ,3656 ,2575 ,1210 ,1365 ,3890 
United Republic of Tanzania,Jamhuri ya Muungano wa Tanzania,TZ,Mara,TZ20,Bunda,TZ2004,Nyamuswa,TZ2004013,9323 ,4370 ,4953 ,7108 ,3315 ,2215 ,1055 ,1160 ,3793 
United Republic of Tanzania,Jamhuri ya Muungano wa Tanzania,TZ,Mara,TZ20,Bunda,TZ2004,Salama,TZ2004021,9073 ,4341 ,4732 ,9073 ,4341 ,0 ,0 ,0 ,4732 
United Republic of Tanzania,Jamhuri ya Muungano wa Tanzania,TZ,Mara,TZ20,Bunda,TZ2004,Mihingo,TZ2004031,13161 ,6129 ,7032 ,13161 ,6129 ,0 ,0 ,0 ,7032 
United Republic of Tanzania,Jamhuri ya Muungano wa Tanzania,TZ,Mara,TZ20,Bunda,TZ2004,Mugeta,TZ2004041,14363 ,7019 ,7344 ,14363 ,7019 ,0 ,0 ,0 ,7344 
United Republic of Tanzania,Jamhuri ya Muungano wa Tanzania,TZ,Mara,TZ20,Bunda,TZ2004,Hunyari,TZ2004051,14569 ,7264 ,7305 ,14569 ,7264 ,0 ,0 ,0 ,7305 
United Republic of Tanzania,Jamhuri ya Muungano wa Tanzania,TZ,Mara,TZ20,Bunda,TZ2004,Mcharo,TZ2004061,10115 ,4949 ,5166 ,10115 ,4949 ,0 ,0 ,0 ,5166 
United Republic of Tanzania,Jamhuri ya Muungano wa Tanzania,TZ,Mara,TZ20,Bunda,TZ2004,Sazira,TZ2004071,10803 ,5285 ,5518 ,10803 ,5285 ,0 ,0 ,0 ,5518 
United Republic of Tanzania,Jamhuri ya Muungano wa Tanzania,TZ,Mara,TZ20,Bunda,TZ2004,Kunzugu,TZ2004081,11249 ,5627 ,5622 ,11249 ,5627 ,0 ,0 ,0 ,5622 
United Republic of Tanzania,Jamhuri ya Muungano wa Tanzania,TZ,Mara,TZ20,Bunda,TZ2004,Bunda Mjini,TZ2004093,17280 ,7923 ,9357 ,3764 ,1750 ,13516 ,6173 ,7343 ,2014 
United Republic of Tanzania,Jamhuri ya Muungano wa Tanzania,TZ,Mara,TZ20,Bunda,TZ2004,Guta,TZ2004101,15676 ,7575 ,8101 ,15676 ,7575 ,0 ,0 ,0 ,8101 
United Republic of Tanzania,Jamhuri ya Muungano wa Tanzania,TZ,Mara,TZ20,Bunda,TZ2004,Butimba,TZ2004111,8505 ,4138 ,4367 ,8505 ,4138 ,0 ,0 ,0 ,4367 
United Republic of Tanzania,Jamhuri ya Muungano wa Tanzania,TZ,Mara,TZ20,Bunda,TZ2004,Neruma,TZ2004121,15784 ,7549 ,8235 ,15784 ,7549 ,0 ,0 ,0 ,8235 
United Republic of Tanzania,Jamhuri ya Muungano wa Tanzania,TZ,Mara,TZ20,Bunda,TZ2004,Kibara,TZ2004133,8412 ,3968 ,4444 ,355 ,201 ,8057 ,3767 ,4290 ,154 
United Republic of Tanzania,Jamhuri ya Muungano wa Tanzania,TZ,Mara,TZ20,Bunda,TZ2004,Nansimo,TZ2004141,12714 ,6252 ,6462 ,12714 ,6252 ,0 ,0 ,0 ,6462 
United Republic of Tanzania,Jamhuri ya Muungano wa Tanzania,TZ,Mara,TZ20,Bunda,TZ2004,Kisorya,TZ2004151,10179 ,5000 ,5179 ,10179 ,5000 ,0 ,0 ,0 ,5179 
United Republic of Tanzania,Jamhuri ya Muungano wa Tanzania,TZ,Mara,TZ20,Bunda,TZ2004,Igundu,TZ2004161,12507 ,6314 ,6193 ,12507 ,6314 ,0 ,0 ,0 ,6193 
United Republic of Tanzania,Jamhuri ya Muungano wa Tanzania,TZ,Mara,TZ20,Bunda,TZ2004,Iramba,TZ2004171,10715 ,5360 ,5355 ,10715 ,5360 ,0 ,0 ,0 ,5355 
United Republic of Tanzania,Jamhuri ya Muungano wa Tanzania,TZ,Mara,TZ20,Bunda,TZ2004,Namhula,TZ2004181,13151 ,6459 ,6692 ,13151 ,6459 ,0 ,0 ,0 ,6692 
United Republic of Tanzania,Jamhuri ya Muungano wa Tanzania,TZ,Mara,TZ20,Bunda,TZ2004,Wariku,TZ2004191,9900 ,4943 ,4957 ,9900 ,4943 ,0 ,0 ,0 ,4957 
United Republic of Tanzania,Jamhuri ya Muungano wa Tanzania,TZ,Mara,TZ20,Bunda,TZ2004,Kabasa,TZ2004201,13233 ,6442 ,6791 ,13233 ,6442 ,0 ,0 ,0 ,6791 
United Republic of Tanzania,Jamhuri ya Muungano wa Tanzania,TZ,Mara,TZ20,Bunda,TZ2004,Nampindi,TZ2004211,9639 ,4733 ,4906 ,9639 ,4733 ,0 ,0 ,0 ,4906 
United Republic of Tanzania,Jamhuri ya Muungano wa Tanzania,TZ,Mara,TZ20,Bunda,TZ2004,Chitengule,TZ2004221,12912 ,6236 ,6676 ,12912 ,6236 ,0 ,0 ,0 ,6676 
United Republic of Tanzania,Jamhuri ya Muungano wa Tanzania,TZ,Mara,TZ20,Bunda,TZ2004,Kasuguti,TZ2004231,7085 ,3425 ,3660 ,7085 ,3425 ,0 ,0 ,0 ,3660 
United Republic of Tanzania,Jamhuri ya Muungano wa Tanzania,TZ,Mara,TZ20,Bunda,TZ2004,Balili,TZ2004243,15524 ,7282 ,8242 ,5079 ,2456 ,10445 ,4826 ,5619 ,2623 
United Republic of Tanzania,Jamhuri ya Muungano wa Tanzania,TZ,Mara,TZ20,Bunda,TZ2004,Bunda Stoo,TZ2004253,12632 ,5893 ,6739 ,2347 ,1175 ,10285 ,4718 ,5567 ,1172 
United Republic of Tanzania,Jamhuri ya Muungano wa Tanzania,TZ,Mara,TZ20,Bunda,TZ2004,Nyasura,TZ2004263,17565 ,8540 ,9025 ,3693 ,1807 ,13872 ,6733 ,7139 ,1886 
United Republic of Tanzania,Jamhuri ya Muungano wa Tanzania,TZ,Mara,TZ20,Bunda,TZ2004,Nyamang'uta,TZ2004271,10150 ,4884 ,5266 ,10150 ,4884 ,0 ,0 ,0 ,5266 
United Republic of Tanzania,Jamhuri ya Muungano wa Tanzania,TZ,Mara,TZ20,Bunda,TZ2004,Ketare,TZ2004281,8842 ,4341 ,4501 ,8842 ,4341 ,0 ,0 ,0 ,4501 
United Republic of Tanzania,Jamhuri ya Muungano wa Tanzania,TZ,Mara,TZ20,Musoma Urban,TZ2005,Mukendo,TZ2005012,2426 ,1360 ,1066 ,0 ,0 ,2426 ,1360 ,1066 ,0 
United Republic of Tanzania,Jamhuri ya Muungano wa Tanzania,TZ,Mara,TZ20,Musoma Urban,TZ2005,Mwigobero,TZ2005022,2179 ,974 ,1205 ,0 ,0 ,2179 ,974 ,1205 ,0 
United Republic of Tanzania,Jamhuri ya Muungano wa Tanzania,TZ,Mara,TZ20,Musoma Urban,TZ2005,Iringo,TZ2005032,5321 ,2448 ,2873 ,0 ,0 ,5321 ,2448 ,2873 ,0 
United Republic of Tanzania,Jamhuri ya Muungano wa Tanzania,TZ,Mara,TZ20,Musoma Urban,TZ2005,Kitaji,TZ2005042,5464 ,2560 ,2904 ,0 ,0 ,5464 ,2560 ,2904 ,0 
United Republic of Tanzania,Jamhuri ya Muungano wa Tanzania,TZ,Mara,TZ20,Musoma Urban,TZ2005,Nyasho,TZ2005052,6344 ,2856 ,3488 ,0 ,0 ,6344 ,2856 ,3488 ,0 
United Republic of Tanzania,Jamhuri ya Muungano wa Tanzania,TZ,Mara,TZ20,Musoma Urban,TZ2005,Bweri,TZ2005062,25943 ,12247 ,13696 ,0 ,0 ,25943 ,12247 ,13696 ,0 
United Republic of Tanzania,Jamhuri ya Muungano wa Tanzania,TZ,Mara,TZ20,Musoma Urban,TZ2005,Nyakato,TZ2005072,20419 ,9637 ,10782 ,0 ,0 ,20419 ,9637 ,10782 ,0 
United Republic of Tanzania,Jamhuri ya Muungano wa Tanzania,TZ,Mara,TZ20,Musoma Urban,TZ2005,Kigera,TZ2005082,21080 ,9750 ,11330 ,0 ,0 ,21080 ,9750 ,11330 ,0 
United Republic of Tanzania,Jamhuri ya Muungano wa Tanzania,TZ,Mara,TZ20,Musoma Urban,TZ2005,Kamunyonge,TZ2005092,5004 ,2303 ,2701 ,0 ,0 ,5004 ,2303 ,2701 ,0 
United Republic of Tanzania,Jamhuri ya Muungano wa Tanzania,TZ,Mara,TZ20,Musoma Urban,TZ2005,Nyamatare,TZ2005102,6527 ,3011 ,3516 ,0 ,0 ,6527 ,3011 ,3516 ,0 
United Republic of Tanzania,Jamhuri ya Muungano wa Tanzania,TZ,Mara,TZ20,Musoma Urban,TZ2005,Mwisenge,TZ2005112,13603 ,6243 ,7360 ,0 ,0 ,13603 ,6243 ,7360 ,0 
United Republic of Tanzania,Jamhuri ya Muungano wa Tanzania,TZ,Mara,TZ20,Musoma Urban,TZ2005,Buhare,TZ2005122,10129 ,4684 ,5445 ,0 ,0 ,10129 ,4684 ,5445 ,0 
United Republic of Tanzania,Jamhuri ya Muungano wa Tanzania,TZ,Mara,TZ20,Musoma Urban,TZ2005,Makoko,TZ2005132,9888 ,4621 ,5267 ,0 ,0 ,9888 ,4621 ,5267 ,0 
United Republic of Tanzania,Jamhuri ya Muungano wa Tanzania,TZ,Mara,TZ20,Rorya,TZ2006,Kigunga,TZ2006011,13824 ,6591 ,7233 ,13824 ,6591 ,0 ,0 ,0 ,7233 
United Republic of Tanzania,Jamhuri ya Muungano wa Tanzania,TZ,Mara,TZ20,Rorya,TZ2006,Kirogo,TZ2006021,7250 ,3520 ,3730 ,7250 ,3520 ,0 ,0 ,0 ,3730 
United Republic of Tanzania,Jamhuri ya Muungano wa Tanzania,TZ,Mara,TZ20,Rorya,TZ2006,Nyamtinga,TZ2006031,11203 ,5251 ,5952 ,11203 ,5251 ,0 ,0 ,0 ,5952 
United Republic of Tanzania,Jamhuri ya Muungano wa Tanzania,TZ,Mara,TZ20,Rorya,TZ2006,Nyamagaro,TZ2006041,17006 ,8186 ,8820 ,17006 ,8186 ,0 ,0 ,0 ,8820 
United Republic of Tanzania,Jamhuri ya Muungano wa Tanzania,TZ,Mara,TZ20,Rorya,TZ2006,Nyahongo,TZ2006051,18454 ,8637 ,9817 ,18454 ,8637 ,0 ,0 ,0 ,9817 
United Republic of Tanzania,Jamhuri ya Muungano wa Tanzania,TZ,Mara,TZ20,Rorya,TZ2006,Mkoma,TZ2006063,17132 ,7890 ,9242 ,6833 ,3204 ,10299 ,4686 ,5613 ,3629 
United Republic of Tanzania,Jamhuri ya Muungano wa Tanzania,TZ,Mara,TZ20,Rorya,TZ2006,Tai,TZ2006071,12506 ,5949 ,6557 ,12506 ,5949 ,0 ,0 ,0 ,6557 
United Republic of Tanzania,Jamhuri ya Muungano wa Tanzania,TZ,Mara,TZ20,Rorya,TZ2006,Bukura,TZ2006081,15228 ,7329 ,7899 ,15228 ,7329 ,0 ,0 ,0 ,7899 
United Republic of Tanzania,Jamhuri ya Muungano wa Tanzania,TZ,Mara,TZ20,Rorya,TZ2006,Roche,TZ2006091,8728 ,4164 ,4564 ,8728 ,4164 ,0 ,0 ,0 ,4564 
United Republic of Tanzania,Jamhuri ya Muungano wa Tanzania,TZ,Mara,TZ20,Rorya,TZ2006,Kitembe,TZ2006101,9845 ,4741 ,5104 ,9845 ,4741 ,0 ,0 ,0 ,5104 
United Republic of Tanzania,Jamhuri ya Muungano wa Tanzania,TZ,Mara,TZ20,Rorya,TZ2006,Mirare,TZ2006111,12416 ,5918 ,6498 ,12416 ,5918 ,0 ,0 ,0 ,6498 
United Republic of Tanzania,Jamhuri ya Muungano wa Tanzania,TZ,Mara,TZ20,Rorya,TZ2006,Goribe,TZ2006121,9915 ,4611 ,5304 ,9915 ,4611 ,0 ,0 ,0 ,5304 
United Republic of Tanzania,Jamhuri ya Muungano wa Tanzania,TZ,Mara,TZ20,Rorya,TZ2006,Ikoma,TZ2006131,10397 ,5001 ,5396 ,10397 ,5001 ,0 ,0 ,0 ,5396 
United Republic of Tanzania,Jamhuri ya Muungano wa Tanzania,TZ,Mara,TZ20,Rorya,TZ2006,Koryo,TZ2006143,7652 ,3484 ,4168 ,4899 ,2254 ,2753 ,1230 ,1523 ,2645 
United Republic of Tanzania,Jamhuri ya Muungano wa Tanzania,TZ,Mara,TZ20,Rorya,TZ2006,Bukwe,TZ2006151,9920 ,4677 ,5243 ,9920 ,4677 ,0 ,0 ,0 ,5243 
United Republic of Tanzania,Jamhuri ya Muungano wa Tanzania,TZ,Mara,TZ20,Rorya,TZ2006,Nyathorogo,TZ2006161,14809 ,7056 ,7753 ,14809 ,7056 ,0 ,0 ,0 ,7753 
United Republic of Tanzania,Jamhuri ya Muungano wa Tanzania,TZ,Mara,TZ20,Rorya,TZ2006,Rabour,TZ2006171,11259 ,5463 ,5796 ,11259 ,5463 ,0 ,0 ,0 ,5796 
United Republic of Tanzania,Jamhuri ya Muungano wa Tanzania,TZ,Mara,TZ20,Rorya,TZ2006,Kisumwa,TZ2006181,12447 ,5991 ,6456 ,12447 ,5991 ,0 ,0 ,0 ,6456 
United Republic of Tanzania,Jamhuri ya Muungano wa Tanzania,TZ,Mara,TZ20,Rorya,TZ2006,Komuge,TZ2006191,13651 ,6510 ,7141 ,13651 ,6510 ,0 ,0 ,0 ,7141 
United Republic of Tanzania,Jamhuri ya Muungano wa Tanzania,TZ,Mara,TZ20,Rorya,TZ2006,Nyamunga,TZ2006201,13161 ,6378 ,6783 ,13161 ,6378 ,0 ,0 ,0 ,6783 
United Republic of Tanzania,Jamhuri ya Muungano wa Tanzania,TZ,Mara,TZ20,Rorya,TZ2006,Kyang'ombe,TZ2006211,18438 ,8900 ,9538 ,18438 ,8900 ,0 ,0 ,0 ,9538 
United Republic of Tanzania,Jamhuri ya Muungano wa Tanzania,TZ,Mara,TZ20,Butiam,TZ2007,Bwiregi,TZ2007011,10275 ,4923 ,5352 ,10275 ,4923 ,0 ,0 ,0 ,5352 
United Republic of Tanzania,Jamhuri ya Muungano wa Tanzania,TZ,Mara,TZ20,Butiam,TZ2007,Buswahili,TZ2007021,11576 ,5498 ,6078 ,11576 ,5498 ,0 ,0 ,0 ,6078 
United Republic of Tanzania,Jamhuri ya Muungano wa Tanzania,TZ,Mara,TZ20,Butiam,TZ2007,Nyamimange,TZ2007031,5203 ,2459 ,2744 ,5203 ,2459 ,0 ,0 ,0 ,2744 
United Republic of Tanzania,Jamhuri ya Muungano wa Tanzania,TZ,Mara,TZ20,Butiam,TZ2007,Sirorisimba,TZ2007041,8220 ,3905 ,4315 ,8220 ,3905 ,0 ,0 ,0 ,4315 
United Republic of Tanzania,Jamhuri ya Muungano wa Tanzania,TZ,Mara,TZ20,Butiam,TZ2007,Buhemba,TZ2007051,9326 ,4515 ,4811 ,9326 ,4515 ,0 ,0 ,0 ,4811 
United Republic of Tanzania,Jamhuri ya Muungano wa Tanzania,TZ,Mara,TZ20,Butiam,TZ2007,Mirwa,TZ2007061,13722 ,6836 ,6886 ,13722 ,6836 ,0 ,0 ,0 ,6886 
United Republic of Tanzania,Jamhuri ya Muungano wa Tanzania,TZ,Mara,TZ20,Butiam,TZ2007,Muriaza,TZ2007071,10203 ,4855 ,5348 ,10203 ,4855 ,0 ,0 ,0 ,5348 
United Republic of Tanzania,Jamhuri ya Muungano wa Tanzania,TZ,Mara,TZ20,Butiam,TZ2007,Butiama,TZ2007083,19217 ,9225 ,9992 ,13896 ,6758 ,5321 ,2467 ,2854 ,7138 
United Republic of Tanzania,Jamhuri ya Muungano wa Tanzania,TZ,Mara,TZ20,Butiam,TZ2007,Masaba,TZ2007091,13147 ,6473 ,6674 ,13147 ,6473 ,0 ,0 ,0 ,6674 
United Republic of Tanzania,Jamhuri ya Muungano wa Tanzania,TZ,Mara,TZ20,Butiam,TZ2007,Kyanyari,TZ2007101,16676 ,8173 ,8503 ,16676 ,8173 ,0 ,0 ,0 ,8503 
United Republic of Tanzania,Jamhuri ya Muungano wa Tanzania,TZ,Mara,TZ20,Butiam,TZ2007,Kukirango,TZ2007113,24501 ,11753 ,12748 ,22584 ,10775 ,1917 ,978 ,939 ,11809 
United Republic of Tanzania,Jamhuri ya Muungano wa Tanzania,TZ,Mara,TZ20,Butiam,TZ2007,Buruma,TZ2007121,16480 ,8032 ,8448 ,16480 ,8032 ,0 ,0 ,0 ,8448 
United Republic of Tanzania,Jamhuri ya Muungano wa Tanzania,TZ,Mara,TZ20,Butiam,TZ2007,Nyakatende,TZ2007131,19341 ,9557 ,9784 ,19341 ,9557 ,0 ,0 ,0 ,9784 
United Republic of Tanzania,Jamhuri ya Muungano wa Tanzania,TZ,Mara,TZ20,Butiam,TZ2007,Etaro,TZ2007141,10492 ,5339 ,5153 ,10492 ,5339 ,0 ,0 ,0 ,5153 
United Republic of Tanzania,Jamhuri ya Muungano wa Tanzania,TZ,Mara,TZ20,Butiam,TZ2007,Nyegina,TZ2007151,8220 ,3943 ,4277 ,8220 ,3943 ,0 ,0 ,0 ,4277 
United Republic of Tanzania,Jamhuri ya Muungano wa Tanzania,TZ,Mara,TZ20,Butiam,TZ2007,Nyankanga,TZ2007161,9734 ,4690 ,5044 ,9734 ,4690 ,0 ,0 ,0 ,5044 
United Republic of Tanzania,Jamhuri ya Muungano wa Tanzania,TZ,Mara,TZ20,Butiam,TZ2007,Bisumwa,TZ2007171,10072 ,4785 ,5287 ,10072 ,4785 ,0 ,0 ,0 ,5287 
United Republic of Tanzania,Jamhuri ya Muungano wa Tanzania,TZ,Mara,TZ20,Butiam,TZ2007,Bukabwa,TZ2007181,11002 ,5312 ,5690 ,11002 ,5312 ,0 ,0 ,0 ,5690 
United Republic of Tanzania,Jamhuri ya Muungano wa Tanzania,TZ,Mara,TZ20,Butiam,TZ2007,Butuguri,TZ2007191,9006 ,4302 ,4704 ,9006 ,4302 ,0 ,0 ,0 ,4704 
United Republic of Tanzania,Jamhuri ya Muungano wa Tanzania,TZ,Mara,TZ20,Butiam,TZ2007,Busegwe,TZ2007201,5319 ,2554 ,2765 ,5319 ,2554 ,0 ,0 ,0 ,2765 
United Republic of Tanzania,Jamhuri ya Muungano wa Tanzania,TZ,Manyara,TZ21,Babati,TZ2101,Magara,TZ2101011,15336 ,8051 ,7285 ,15336 ,8051 ,0 ,0 ,0 ,7285 
United Republic of Tanzania,Jamhuri ya Muungano wa Tanzania,TZ,Manyara,TZ21,Babati,TZ2101,Nkaiti,TZ2101021,14150 ,7030 ,7120 ,14150 ,7030 ,0 ,0 ,0 ,7120 
United Republic of Tanzania,Jamhuri ya Muungano wa Tanzania,TZ,Manyara,TZ21,Babati,TZ2101,Mwada,TZ2101031,16139 ,8533 ,7606 ,16139 ,8533 ,0 ,0 ,0 ,7606 
United Republic of Tanzania,Jamhuri ya Muungano wa Tanzania,TZ,Manyara,TZ21,Babati,TZ2101,Mamire,TZ2101041a,9014 ,4638 ,4376 ,9014 ,4638 ,0 ,0 ,0 ,4376 
United Republic of Tanzania,Jamhuri ya Muungano wa Tanzania,TZ,Manyara,TZ21,Babati,TZ2101,Endokise,TZ2101041b,9246 ,4721 ,4525 ,9246 ,4721 ,0 ,0 ,0 ,4525 
United Republic of Tanzania,Jamhuri ya Muungano wa Tanzania,TZ,Manyara,TZ21,Babati,TZ2101,Galapo,TZ2101053,19578 ,9879 ,9699 ,17125 ,8684 ,2453 ,1195 ,1258 ,8441 
United Republic of Tanzania,Jamhuri ya Muungano wa Tanzania,TZ,Manyara,TZ21,Babati,TZ2101,Qashi,TZ2101061,19549 ,9962 ,9587 ,19549 ,9962 ,0 ,0 ,0 ,9587 
United Republic of Tanzania,Jamhuri ya Muungano wa Tanzania,TZ,Manyara,TZ21,Babati,TZ2101,Ayasanda,TZ2101071,6182 ,3180 ,3002 ,6182 ,3180 ,0 ,0 ,0 ,3002 
United Republic of Tanzania,Jamhuri ya Muungano wa Tanzania,TZ,Manyara,TZ21,Babati,TZ2101,Gidas,TZ2101081,7392 ,3764 ,3628 ,7392 ,3764 ,0 ,0 ,0 ,3628 
United Republic of Tanzania,Jamhuri ya Muungano wa Tanzania,TZ,Manyara,TZ21,Babati,TZ2101,Duru,TZ2101091,11526 ,5914 ,5612 ,11526 ,5914 ,0 ,0 ,0 ,5612 
United Republic of Tanzania,Jamhuri ya Muungano wa Tanzania,TZ,Manyara,TZ21,Babati,TZ2101,Riroda,TZ2101101,12179 ,6210 ,5969 ,12179 ,6210 ,0 ,0 ,0 ,5969 
United Republic of Tanzania,Jamhuri ya Muungano wa Tanzania,TZ,Manyara,TZ21,Babati,TZ2101,Arri,TZ2101111,14146 ,7099 ,7047 ,14146 ,7099 ,0 ,0 ,0 ,7047 
United Republic of Tanzania,Jamhuri ya Muungano wa Tanzania,TZ,Manyara,TZ21,Babati,TZ2101,Dareda,TZ2101123,22880 ,11452 ,11428 ,19414 ,9770 ,3466 ,1682 ,1784 ,9644 
United Republic of Tanzania,Jamhuri ya Muungano wa Tanzania,TZ,Manyara,TZ21,Babati,TZ2101,Dabil,TZ2101131,16781 ,8656 ,8125 ,16781 ,8656 ,0 ,0 ,0 ,8125 
United Republic of Tanzania,Jamhuri ya Muungano wa Tanzania,TZ,Manyara,TZ21,Babati,TZ2101,Ufana,TZ2101141,20189 ,10208 ,9981 ,20189 ,10208 ,0 ,0 ,0 ,9981 
United Republic of Tanzania,Jamhuri ya Muungano wa Tanzania,TZ,Manyara,TZ21,Babati,TZ2101,Bashneti,TZ2101151,13367 ,6578 ,6789 ,13367 ,6578 ,0 ,0 ,0 ,6789 
United Republic of Tanzania,Jamhuri ya Muungano wa Tanzania,TZ,Manyara,TZ21,Babati,TZ2101,Madunga,TZ2101161,21094 ,10522 ,10572 ,21094 ,10522 ,0 ,0 ,0 ,10572 
United Republic of Tanzania,Jamhuri ya Muungano wa Tanzania,TZ,Manyara,TZ21,Babati,TZ2101,Kiru,TZ2101171,13119 ,6832 ,6287 ,13119 ,6832 ,0 ,0 ,0 ,6287 
United Republic of Tanzania,Jamhuri ya Muungano wa Tanzania,TZ,Manyara,TZ21,Babati,TZ2101,Magugu,TZ2101183,32774 ,16672 ,16102 ,22504 ,11731 ,10270 ,4941 ,5329 ,10773 
United Republic of Tanzania,Jamhuri ya Muungano wa Tanzania,TZ,Manyara,TZ21,Babati,TZ2101,Boay,TZ2101191,6565 ,3385 ,3180 ,6565 ,3385 ,0 ,0 ,0 ,3180 
United Republic of Tanzania,Jamhuri ya Muungano wa Tanzania,TZ,Manyara,TZ21,Babati,TZ2101,Nar,TZ2101211,11186 ,5518 ,5668 ,11186 ,5518 ,0 ,0 ,0 ,5668 
United Republic of Tanzania,Jamhuri ya Muungano wa Tanzania,TZ,Manyara,TZ21,Hanang,TZ2102,Balagidalalu,TZ2102011,14478 ,7339 ,7139 ,14478 ,7339 ,0 ,0 ,0 ,7139 
United Republic of Tanzania,Jamhuri ya Muungano wa Tanzania,TZ,Manyara,TZ21,Hanang,TZ2102,Gehandu,TZ2102021,15222 ,7646 ,7576 ,15222 ,7646 ,0 ,0 ,0 ,7576 
United Republic of Tanzania,Jamhuri ya Muungano wa Tanzania,TZ,Manyara,TZ21,Hanang,TZ2102,Laghanga,TZ2102031,11872 ,6071 ,5801 ,11872 ,6071 ,0 ,0 ,0 ,5801 
United Republic of Tanzania,Jamhuri ya Muungano wa Tanzania,TZ,Manyara,TZ21,Hanang,TZ2102,Getanuwas,TZ2102041,12152 ,6190 ,5962 ,12152 ,6190 ,0 ,0 ,0 ,5962 
United Republic of Tanzania,Jamhuri ya Muungano wa Tanzania,TZ,Manyara,TZ21,Hanang,TZ2102,Hirbadaw,TZ2102051,7903 ,4037 ,3866 ,7903 ,4037 ,0 ,0 ,0 ,3866 
United Republic of Tanzania,Jamhuri ya Muungano wa Tanzania,TZ,Manyara,TZ21,Hanang,TZ2102,Bassodesh,TZ2102061,16762 ,8535 ,8227 ,16762 ,8535 ,0 ,0 ,0 ,8227 
United Republic of Tanzania,Jamhuri ya Muungano wa Tanzania,TZ,Manyara,TZ21,Hanang,TZ2102,Bassotu,TZ2102073,24527 ,12498 ,12029 ,19036 ,9729 ,5491 ,2769 ,2722 ,9307 
United Republic of Tanzania,Jamhuri ya Muungano wa Tanzania,TZ,Manyara,TZ21,Hanang,TZ2102,Gendabi,TZ2102081,10968 ,5579 ,5389 ,10968 ,5579 ,0 ,0 ,0 ,5389 
United Republic of Tanzania,Jamhuri ya Muungano wa Tanzania,TZ,Manyara,TZ21,Hanang,TZ2102,Mogitu,TZ2102091,21547 ,11015 ,10532 ,21547 ,11015 ,0 ,0 ,0 ,10532 
United Republic of Tanzania,Jamhuri ya Muungano wa Tanzania,TZ,Manyara,TZ21,Hanang,TZ2102,Giting,TZ2102101,13370 ,6726 ,6644 ,13370 ,6726 ,0 ,0 ,0 ,6644 
United Republic of Tanzania,Jamhuri ya Muungano wa Tanzania,TZ,Manyara,TZ21,Hanang,TZ2102,Masakta,TZ2102111,7321 ,3679 ,3642 ,7321 ,3679 ,0 ,0 ,0 ,3642 
United Republic of Tanzania,Jamhuri ya Muungano wa Tanzania,TZ,Manyara,TZ21,Hanang,TZ2102,Masqaroda,TZ2102121,7254 ,3625 ,3629 ,7254 ,3625 ,0 ,0 ,0 ,3629 
United Republic of Tanzania,Jamhuri ya Muungano wa Tanzania,TZ,Manyara,TZ21,Hanang,TZ2102,Endasak,TZ2102133,10054 ,4961 ,5093 ,5095 ,2491 ,4959 ,2470 ,2489 ,2604 
United Republic of Tanzania,Jamhuri ya Muungano wa Tanzania,TZ,Manyara,TZ21,Hanang,TZ2102,Gidahababieg,TZ2102141,5366 ,2743 ,2623 ,5366 ,2743 ,0 ,0 ,0 ,2623 
United Republic of Tanzania,Jamhuri ya Muungano wa Tanzania,TZ,Manyara,TZ21,Hanang,TZ2102,Maskron,TZ2102151,13149 ,6588 ,6561 ,13149 ,6588 ,0 ,0 ,0 ,6561 
United Republic of Tanzania,Jamhuri ya Muungano wa Tanzania,TZ,Manyara,TZ21,Hanang,TZ2102,Hidet,TZ2102161,6528 ,3423 ,3105 ,6528 ,3423 ,0 ,0 ,0 ,3105 
United Republic of Tanzania,Jamhuri ya Muungano wa Tanzania,TZ,Manyara,TZ21,Hanang,TZ2102,Simbay,TZ2102171,6737 ,3523 ,3214 ,6737 ,3523 ,0 ,0 ,0 ,3214 
United Republic of Tanzania,Jamhuri ya Muungano wa Tanzania,TZ,Manyara,TZ21,Hanang,TZ2102,Sirop,TZ2102181,5563 ,2816 ,2747 ,5563 ,2816 ,0 ,0 ,0 ,2747 
United Republic of Tanzania,Jamhuri ya Muungano wa Tanzania,TZ,Manyara,TZ21,Hanang,TZ2102,Gisambalang,TZ2102191,10937 ,5811 ,5126 ,10937 ,5811 ,0 ,0 ,0 ,5126 
United Republic of Tanzania,Jamhuri ya Muungano wa Tanzania,TZ,Manyara,TZ21,Hanang,TZ2102,Nangwa,TZ2102203,13165 ,6675 ,6490 ,10992 ,5539 ,2173 ,1136 ,1037 ,5453 
United Republic of Tanzania,Jamhuri ya Muungano wa Tanzania,TZ,Manyara,TZ21,Hanang,TZ2102,Katesh,TZ2102212,8774 ,4223 ,4551 ,0 ,0 ,8774 ,4223 ,4551 ,0 
United Republic of Tanzania,Jamhuri ya Muungano wa Tanzania,TZ,Manyara,TZ21,Hanang,TZ2102,Ganana,TZ2102222,7543 ,3610 ,3933 ,0 ,0 ,7543 ,3610 ,3933 ,0 
United Republic of Tanzania,Jamhuri ya Muungano wa Tanzania,TZ,Manyara,TZ21,Hanang,TZ2102,Dirma,TZ2102231,8538 ,4483 ,4055 ,8538 ,4483 ,0 ,0 ,0 ,4055 
United Republic of Tanzania,Jamhuri ya Muungano wa Tanzania,TZ,Manyara,TZ21,Hanang,TZ2102,Lalaji,TZ2102241,9698 ,5111 ,4587 ,9698 ,5111 ,0 ,0 ,0 ,4587 
United Republic of Tanzania,Jamhuri ya Muungano wa Tanzania,TZ,Manyara,TZ21,Hanang,TZ2102,Endasiwold,TZ2102251,6562 ,3305 ,3257 ,6562 ,3305 ,0 ,0 ,0 ,3257 
United Republic of Tanzania,Jamhuri ya Muungano wa Tanzania,TZ,Manyara,TZ21,Mbulu,TZ2103,Daudi,TZ2103011,7642 ,3864 ,3778 ,7642 ,3864 ,0 ,0 ,0 ,3778 
United Republic of Tanzania,Jamhuri ya Muungano wa Tanzania,TZ,Manyara,TZ21,Mbulu,TZ2103,Bargish,TZ2103021,8804 ,4469 ,4335 ,8804 ,4469 ,0 ,0 ,0 ,4335 
United Republic of Tanzania,Jamhuri ya Muungano wa Tanzania,TZ,Manyara,TZ21,Mbulu,TZ2103,Gehandu,TZ2103031,12092 ,6243 ,5849 ,12092 ,6243 ,0 ,0 ,0 ,5849 
United Republic of Tanzania,Jamhuri ya Muungano wa Tanzania,TZ,Manyara,TZ21,Mbulu,TZ2103,Kainam,TZ2103041,7679 ,3866 ,3813 ,7679 ,3866 ,0 ,0 ,0 ,3813 
United Republic of Tanzania,Jamhuri ya Muungano wa Tanzania,TZ,Manyara,TZ21,Mbulu,TZ2103,Murray,TZ2103051,9965 ,5082 ,4883 ,9965 ,5082 ,0 ,0 ,0 ,4883 
United Republic of Tanzania,Jamhuri ya Muungano wa Tanzania,TZ,Manyara,TZ21,Mbulu,TZ2103,Ayamaami,TZ2103062,4848 ,2452 ,2396 ,0 ,0 ,4848 ,2452 ,2396 ,0 
United Republic of Tanzania,Jamhuri ya Muungano wa Tanzania,TZ,Manyara,TZ21,Mbulu,TZ2103,Uhuru,TZ2103072,7141 ,3458 ,3683 ,0 ,0 ,7141 ,3458 ,3683 ,0 
United Republic of Tanzania,Jamhuri ya Muungano wa Tanzania,TZ,Manyara,TZ21,Mbulu,TZ2103,Tlawi,TZ2103081,8547 ,4358 ,4189 ,8547 ,4358 ,0 ,0 ,0 ,4189 
United Republic of Tanzania,Jamhuri ya Muungano wa Tanzania,TZ,Manyara,TZ21,Mbulu,TZ2103,Bashay,TZ2103091,10194 ,5263 ,4931 ,10194 ,5263 ,0 ,0 ,0 ,4931 
United Republic of Tanzania,Jamhuri ya Muungano wa Tanzania,TZ,Manyara,TZ21,Mbulu,TZ2103,Dongobesh,TZ2103103,11770 ,5941 ,5829 ,7099 ,3627 ,4671 ,2314 ,2357 ,3472 
United Republic of Tanzania,Jamhuri ya Muungano wa Tanzania,TZ,Manyara,TZ21,Mbulu,TZ2103,Tumati,TZ2103111,12798 ,6470 ,6328 ,12798 ,6470 ,0 ,0 ,0 ,6328 
United Republic of Tanzania,Jamhuri ya Muungano wa Tanzania,TZ,Manyara,TZ21,Mbulu,TZ2103,Maretadu,TZ2103121,14343 ,7259 ,7084 ,14343 ,7259 ,0 ,0 ,0 ,7084 
United Republic of Tanzania,Jamhuri ya Muungano wa Tanzania,TZ,Manyara,TZ21,Mbulu,TZ2103,Maghang,TZ2103131,13624 ,6790 ,6834 ,13624 ,6790 ,0 ,0 ,0 ,6834 
United Republic of Tanzania,Jamhuri ya Muungano wa Tanzania,TZ,Manyara,TZ21,Mbulu,TZ2103,Haydom,TZ2103143,23013 ,11225 ,11788 ,15116 ,7597 ,7897 ,3628 ,4269 ,7519 
United Republic of Tanzania,Jamhuri ya Muungano wa Tanzania,TZ,Manyara,TZ21,Mbulu,TZ2103,Yaeda Chini,TZ2103151,5420 ,2791 ,2629 ,5420 ,2791 ,0 ,0 ,0 ,2629 
United Republic of Tanzania,Jamhuri ya Muungano wa Tanzania,TZ,Manyara,TZ21,Mbulu,TZ2103,Masieda,TZ2103161,9929 ,5087 ,4842 ,9929 ,5087 ,0 ,0 ,0 ,4842 
United Republic of Tanzania,Jamhuri ya Muungano wa Tanzania,TZ,Manyara,TZ21,Mbulu,TZ2103,Marang,TZ2103171,7377 ,3793 ,3584 ,7377 ,3793 ,0 ,0 ,0 ,3584 
United Republic of Tanzania,Jamhuri ya Muungano wa Tanzania,TZ,Manyara,TZ21,Mbulu,TZ2103,Gunyoda,TZ2103181,11477 ,5793 ,5684 ,11477 ,5793 ,0 ,0 ,0 ,5684 
United Republic of Tanzania,Jamhuri ya Muungano wa Tanzania,TZ,Manyara,TZ21,Mbulu,TZ2103,Nahasey,TZ2103191,9844 ,5053 ,4791 ,9844 ,5053 ,0 ,0 ,0 ,4791 
United Republic of Tanzania,Jamhuri ya Muungano wa Tanzania,TZ,Manyara,TZ21,Mbulu,TZ2103,Endamilay,TZ2103201,13967 ,6984 ,6983 ,13967 ,6984 ,0 ,0 ,0 ,6983 
United Republic of Tanzania,Jamhuri ya Muungano wa Tanzania,TZ,Manyara,TZ21,Mbulu,TZ2103,Yaeda Ampa,TZ2103211,13138 ,6638 ,6500 ,13138 ,6638 ,0 ,0 ,0 ,6500 
United Republic of Tanzania,Jamhuri ya Muungano wa Tanzania,TZ,Manyara,TZ21,Mbulu,TZ2103,Masqaroda,TZ2103221,10262 ,5176 ,5086 ,10262 ,5176 ,0 ,0 ,0 ,5086 
United Republic of Tanzania,Jamhuri ya Muungano wa Tanzania,TZ,Manyara,TZ21,Mbulu,TZ2103,Nambisi,TZ2103231,8874 ,4557 ,4317 ,8874 ,4557 ,0 ,0 ,0 ,4317 
United Republic of Tanzania,Jamhuri ya Muungano wa Tanzania,TZ,Manyara,TZ21,Mbulu,TZ2103,Dinamu,TZ2103241,11606 ,5918 ,5688 ,11606 ,5918 ,0 ,0 ,0 ,5688 
United Republic of Tanzania,Jamhuri ya Muungano wa Tanzania,TZ,Manyara,TZ21,Mbulu,TZ2103,Ayamohe,TZ2103252,5785 ,2739 ,3046 ,0 ,0 ,5785 ,2739 ,3046 ,0 
United Republic of Tanzania,Jamhuri ya Muungano wa Tanzania,TZ,Manyara,TZ21,Mbulu,TZ2103,Sanu Baray,TZ2103262,6233 ,3031 ,3202 ,0 ,0 ,6233 ,3031 ,3202 ,0 
United Republic of Tanzania,Jamhuri ya Muungano wa Tanzania,TZ,Manyara,TZ21,Mbulu,TZ2103,Imboru,TZ2103272,7938 ,4063 ,3875 ,0 ,0 ,7938 ,4063 ,3875 ,0 
United Republic of Tanzania,Jamhuri ya Muungano wa Tanzania,TZ,Manyara,TZ21,Mbulu,TZ2103,Endagikot,TZ2103282,4463 ,2246 ,2217 ,0 ,0 ,4463 ,2246 ,2217 ,0 
United Republic of Tanzania,Jamhuri ya Muungano wa Tanzania,TZ,Manyara,TZ21,Mbulu,TZ2103,Geterer,TZ2103291,11445 ,5816 ,5629 ,11445 ,5816 ,0 ,0 ,0 ,5629 
United Republic of Tanzania,Jamhuri ya Muungano wa Tanzania,TZ,Manyara,TZ21,Mbulu,TZ2103,Hayderer,TZ2103301,13004 ,6458 ,6546 ,13004 ,6458 ,0 ,0 ,0 ,6546 
United Republic of Tanzania,Jamhuri ya Muungano wa Tanzania,TZ,Manyara,TZ21,Mbulu,TZ2103,Eshkesh,TZ2103311,5859 ,2961 ,2898 ,5859 ,2961 ,0 ,0 ,0 ,2898 
United Republic of Tanzania,Jamhuri ya Muungano wa Tanzania,TZ,Manyara,TZ21,Mbulu,TZ2103,Gidihim,TZ2103321,11198 ,5704 ,5494 ,11198 ,5704 ,0 ,0 ,0 ,5494 
United Republic of Tanzania,Jamhuri ya Muungano wa Tanzania,TZ,Manyara,TZ21,Simanjiro,TZ2104,Orkesmet,TZ2104012,5325 ,2601 ,2724 ,0 ,0 ,5325 ,2601 ,2724 ,0 
United Republic of Tanzania,Jamhuri ya Muungano wa Tanzania,TZ,Manyara,TZ21,Simanjiro,TZ2104,Naberera,TZ2104023,19814 ,10060 ,9754 ,19576 ,9931 ,238 ,129 ,109 ,9645 
United Republic of Tanzania,Jamhuri ya Muungano wa Tanzania,TZ,Manyara,TZ21,Simanjiro,TZ2104,Loiborsiret,TZ2104031,13569 ,6542 ,7027 ,13569 ,6542 ,0 ,0 ,0 ,7027 
United Republic of Tanzania,Jamhuri ya Muungano wa Tanzania,TZ,Manyara,TZ21,Simanjiro,TZ2104,Emboreet,TZ2104041,8860 ,4268 ,4592 ,8860 ,4268 ,0 ,0 ,0 ,4592 
United Republic of Tanzania,Jamhuri ya Muungano wa Tanzania,TZ,Manyara,TZ21,Simanjiro,TZ2104,Terrat,TZ2104051,8586 ,4081 ,4505 ,8586 ,4081 ,0 ,0 ,0 ,4505 
United Republic of Tanzania,Jamhuri ya Muungano wa Tanzania,TZ,Manyara,TZ21,Simanjiro,TZ2104,Oljoro  No. 5,TZ2104061,15527 ,7296 ,8231 ,15527 ,7296 ,0 ,0 ,0 ,8231 
United Republic of Tanzania,Jamhuri ya Muungano wa Tanzania,TZ,Manyara,TZ21,Simanjiro,TZ2104,Shambarai,TZ2104071,9420 ,4876 ,4544 ,9420 ,4876 ,0 ,0 ,0 ,4544 
United Republic of Tanzania,Jamhuri ya Muungano wa Tanzania,TZ,Manyara,TZ21,Simanjiro,TZ2104,Mererani,TZ2104082,13450 ,6838 ,6612 ,0 ,0 ,13450 ,6838 ,6612 ,0 
United Republic of Tanzania,Jamhuri ya Muungano wa Tanzania,TZ,Manyara,TZ21,Simanjiro,TZ2104,Msitu wa Tembo,TZ2104091,12054 ,5990 ,6064 ,12054 ,5990 ,0 ,0 ,0 ,6064 
United Republic of Tanzania,Jamhuri ya Muungano wa Tanzania,TZ,Manyara,TZ21,Simanjiro,TZ2104,Ngorika,TZ2104101,7417 ,3682 ,3735 ,7417 ,3682 ,0 ,0 ,0 ,3735 
United Republic of Tanzania,Jamhuri ya Muungano wa Tanzania,TZ,Manyara,TZ21,Simanjiro,TZ2104,Liborsoit,TZ2104111,7207 ,3928 ,3279 ,7207 ,3928 ,0 ,0 ,0 ,3279 
United Republic of Tanzania,Jamhuri ya Muungano wa Tanzania,TZ,Manyara,TZ21,Simanjiro,TZ2104,Ruvu Remiti,TZ2104121,5077 ,2471 ,2606 ,5077 ,2471 ,0 ,0 ,0 ,2606 
United Republic of Tanzania,Jamhuri ya Muungano wa Tanzania,TZ,Manyara,TZ21,Simanjiro,TZ2104,Kitwai,TZ2104131,5914 ,2778 ,3136 ,5914 ,2778 ,0 ,0 ,0 ,3136 
United Republic of Tanzania,Jamhuri ya Muungano wa Tanzania,TZ,Manyara,TZ21,Simanjiro,TZ2104,Komolo,TZ2104141,11555 ,5604 ,5951 ,11555 ,5604 ,0 ,0 ,0 ,5951 
United Republic of Tanzania,Jamhuri ya Muungano wa Tanzania,TZ,Manyara,TZ21,Simanjiro,TZ2104,Naisinyai,TZ2104151,11144 ,5893 ,5251 ,11144 ,5893 ,0 ,0 ,0 ,5251 
United Republic of Tanzania,Jamhuri ya Muungano wa Tanzania,TZ,Manyara,TZ21,Simanjiro,TZ2104,Endiantu,TZ2104162,13621 ,7006 ,6615 ,13621 ,7006 ,0 ,0 ,0 ,6615 
United Republic of Tanzania,Jamhuri ya Muungano wa Tanzania,TZ,Manyara,TZ21,Simanjiro,TZ2104,Endonyongijape,TZ2104171,10153 ,5061 ,5092 ,10153 ,5061 ,0 ,0 ,0 ,5092 
United Republic of Tanzania,Jamhuri ya Muungano wa Tanzania,TZ,Manyara,TZ21,Kiteto,TZ2105,Kibaya,TZ2105012,8759 ,4230 ,4529 ,0 ,0 ,8759 ,4230 ,4529 ,0 
United Republic of Tanzania,Jamhuri ya Muungano wa Tanzania,TZ,Manyara,TZ21,Kiteto,TZ2105,Partimbo,TZ2105021,20669 ,10397 ,10272 ,20669 ,10397 ,0 ,0 ,0 ,10272 
United Republic of Tanzania,Jamhuri ya Muungano wa Tanzania,TZ,Manyara,TZ21,Kiteto,TZ2105,Njoro,TZ2105031,15410 ,7639 ,7771 ,15410 ,7639 ,0 ,0 ,0 ,7771 
United Republic of Tanzania,Jamhuri ya Muungano wa Tanzania,TZ,Manyara,TZ21,Kiteto,TZ2105,Olboroti,TZ2105043,16497 ,8157 ,8340 ,13119 ,6454 ,3378 ,1703 ,1675 ,6665 
United Republic of Tanzania,Jamhuri ya Muungano wa Tanzania,TZ,Manyara,TZ21,Kiteto,TZ2105,Makame,TZ2105051,9751 ,4724 ,5027 ,9751 ,4724 ,0 ,0 ,0 ,5027 
United Republic of Tanzania,Jamhuri ya Muungano wa Tanzania,TZ,Manyara,TZ21,Kiteto,TZ2105,Ndedo,TZ2105061,5103 ,2393 ,2710 ,5103 ,2393 ,0 ,0 ,0 ,2710 
United Republic of Tanzania,Jamhuri ya Muungano wa Tanzania,TZ,Manyara,TZ21,Kiteto,TZ2105,Kijungu,TZ2105071,6165 ,3141 ,3024 ,6165 ,3141 ,0 ,0 ,0 ,3024 
United Republic of Tanzania,Jamhuri ya Muungano wa Tanzania,TZ,Manyara,TZ21,Kiteto,TZ2105,Lengatei,TZ2105081,12776 ,6256 ,6520 ,12776 ,6256 ,0 ,0 ,0 ,6520 
United Republic of Tanzania,Jamhuri ya Muungano wa Tanzania,TZ,Manyara,TZ21,Kiteto,TZ2105,Sunya,TZ2105091,23558 ,11694 ,11864 ,23558 ,11694 ,0 ,0 ,0 ,11864 
United Republic of Tanzania,Jamhuri ya Muungano wa Tanzania,TZ,Manyara,TZ21,Kiteto,TZ2105,Dongo,TZ2105101,17980 ,8680 ,9300 ,17980 ,8680 ,0 ,0 ,0 ,9300 
United Republic of Tanzania,Jamhuri ya Muungano wa Tanzania,TZ,Manyara,TZ21,Kiteto,TZ2105,Songambele,TZ2105111,7532 ,3685 ,3847 ,7532 ,3685 ,0 ,0 ,0 ,3847 
United Republic of Tanzania,Jamhuri ya Muungano wa Tanzania,TZ,Manyara,TZ21,Kiteto,TZ2105,Dosidosi,TZ2105121,7785 ,3779 ,4006 ,7785 ,3779 ,0 ,0 ,0 ,4006 
United Republic of Tanzania,Jamhuri ya Muungano wa Tanzania,TZ,Manyara,TZ21,Kiteto,TZ2105,Engusero,TZ2105131,24707 ,12123 ,12584 ,24707 ,12123 ,0 ,0 ,0 ,12584 
United Republic of Tanzania,Jamhuri ya Muungano wa Tanzania,TZ,Manyara,TZ21,Kiteto,TZ2105,Matui,TZ2105143,19883 ,9641 ,10242 ,12218 ,5939 ,7665 ,3702 ,3963 ,6279 
United Republic of Tanzania,Jamhuri ya Muungano wa Tanzania,TZ,Manyara,TZ21,Kiteto,TZ2105,Bwagamoyo,TZ2105153,10748 ,5291 ,5457 ,8359 ,4037 ,2389 ,1254 ,1135 ,4322 
United Republic of Tanzania,Jamhuri ya Muungano wa Tanzania,TZ,Manyara,TZ21,Kiteto,TZ2105,Loolera,TZ2105161,6098 ,3052 ,3046 ,6098 ,3052 ,0 ,0 ,0 ,3046 
United Republic of Tanzania,Jamhuri ya Muungano wa Tanzania,TZ,Manyara,TZ21,Kiteto,TZ2105,Magungu,TZ2105171,8732 ,4262 ,4470 ,8732 ,4262 ,0 ,0 ,0 ,4470 
United Republic of Tanzania,Jamhuri ya Muungano wa Tanzania,TZ,Manyara,TZ21,Kiteto,TZ2105,Chapakazi,TZ2105181,7773 ,3787 ,3986 ,7773 ,3787 ,0 ,0 ,0 ,3986 
United Republic of Tanzania,Jamhuri ya Muungano wa Tanzania,TZ,Manyara,TZ21,Kiteto,TZ2105,Namelock,TZ2105191,14743 ,7302 ,7441 ,14743 ,7302 ,0 ,0 ,0 ,7441 
United Republic of Tanzania,Jamhuri ya Muungano wa Tanzania,TZ,Manyara,TZ21,Babati Urban,TZ2106,Babati,TZ2106012,16718 ,8559 ,8159 ,0 ,0 ,16718 ,8559 ,8159 ,0 
United Republic of Tanzania,Jamhuri ya Muungano wa Tanzania,TZ,Manyara,TZ21,Babati Urban,TZ2106,Mutuka,TZ2106021,4910 ,2521 ,2389 ,4910 ,2521 ,0 ,0 ,0 ,2389 
United Republic of Tanzania,Jamhuri ya Muungano wa Tanzania,TZ,Manyara,TZ21,Babati Urban,TZ2106,Nangara,TZ2106033,7468 ,3905 ,3563 ,1887 ,972 ,5581 ,2933 ,2648 ,915 
United Republic of Tanzania,Jamhuri ya Muungano wa Tanzania,TZ,Manyara,TZ21,Babati Urban,TZ2106,Singe,TZ2106043,6620 ,3380 ,3240 ,3194 ,1652 ,3426 ,1728 ,1698 ,1542 
United Republic of Tanzania,Jamhuri ya Muungano wa Tanzania,TZ,Manyara,TZ21,Babati Urban,TZ2106,Bonga,TZ2106053,9603 ,4935 ,4668 ,5021 ,2624 ,4582 ,2311 ,2271 ,2397 
United Republic of Tanzania,Jamhuri ya Muungano wa Tanzania,TZ,Manyara,TZ21,Babati Urban,TZ2106,Bagara,TZ2106063,28920 ,14280 ,14640 ,6192 ,3181 ,22728 ,11099 ,11629 ,3011 
United Republic of Tanzania,Jamhuri ya Muungano wa Tanzania,TZ,Manyara,TZ21,Babati Urban,TZ2106,Sigino,TZ2106071,10038 ,5158 ,4880 ,10038 ,5158 ,0 ,0 ,0 ,4880 
United Republic of Tanzania,Jamhuri ya Muungano wa Tanzania,TZ,Manyara,TZ21,Babati Urban,TZ2106,Maisaka,TZ2106083,8831 ,4575 ,4256 ,3957 ,2082 ,4874 ,2493 ,2381 ,1875 
United Republic of Tanzania,Jamhuri ya Muungano wa Tanzania,TZ,Njombe,TZ22,Njombe Urban,TZ2201,Njombe Mjini,TZ2201012,26678 ,12464 ,14214 ,0 ,0 ,26678 ,12464 ,14214 ,0 
United Republic of Tanzania,Jamhuri ya Muungano wa Tanzania,TZ,Njombe,TZ22,Njombe Urban,TZ2201,Mjimwema,TZ2201022,13929 ,6505 ,7424 ,0 ,0 ,13929 ,6505 ,7424 ,0 
United Republic of Tanzania,Jamhuri ya Muungano wa Tanzania,TZ,Njombe,TZ22,Njombe Urban,TZ2201,Ramadhani,TZ2201032,16305 ,7695 ,8610 ,0 ,0 ,16305 ,7695 ,8610 ,0 
United Republic of Tanzania,Jamhuri ya Muungano wa Tanzania,TZ,Njombe,TZ22,Njombe Urban,TZ2201,Yakobi,TZ2201041,5660 ,2730 ,2930 ,5660 ,2730 ,0 ,0 ,0 ,2930 
United Republic of Tanzania,Jamhuri ya Muungano wa Tanzania,TZ,Njombe,TZ22,Njombe Urban,TZ2201,Kifanya,TZ2201051,9011 ,4171 ,4840 ,9011 ,4171 ,0 ,0 ,0 ,4840 
United Republic of Tanzania,Jamhuri ya Muungano wa Tanzania,TZ,Njombe,TZ22,Njombe Urban,TZ2201,Ihanga,TZ2201061,5095 ,2338 ,2757 ,5095 ,2338 ,0 ,0 ,0 ,2757 
United Republic of Tanzania,Jamhuri ya Muungano wa Tanzania,TZ,Njombe,TZ22,Njombe Urban,TZ2201,Iwungilo,TZ2201071,8419 ,3912 ,4507 ,8419 ,3912 ,0 ,0 ,0 ,4507 
United Republic of Tanzania,Jamhuri ya Muungano wa Tanzania,TZ,Njombe,TZ22,Njombe Urban,TZ2201,Luponde,TZ2201083,9372 ,4471 ,4901 ,6210 ,2998 ,3162 ,1473 ,1689 ,3212 
United Republic of Tanzania,Jamhuri ya Muungano wa Tanzania,TZ,Njombe,TZ22,Njombe Urban,TZ2201,Matola,TZ2201091,12262 ,5649 ,6613 ,12262 ,5649 ,0 ,0 ,0 ,6613 
United Republic of Tanzania,Jamhuri ya Muungano wa Tanzania,TZ,Njombe,TZ22,Njombe Urban,TZ2201,Makowo,TZ2201101,4213 ,2079 ,2134 ,4213 ,2079 ,0 ,0 ,0 ,2134 
United Republic of Tanzania,Jamhuri ya Muungano wa Tanzania,TZ,Njombe,TZ22,Njombe Urban,TZ2201,Lugenge,TZ2201111,5843 ,2737 ,3106 ,5843 ,2737 ,0 ,0 ,0 ,3106 
United Republic of Tanzania,Jamhuri ya Muungano wa Tanzania,TZ,Njombe,TZ22,Njombe Urban,TZ2201,Uwemba,TZ2201123,8900 ,4236 ,4664 ,4852 ,2376 ,4048 ,1860 ,2188 ,2476 
United Republic of Tanzania,Jamhuri ya Muungano wa Tanzania,TZ,Njombe,TZ22,Njombe Urban,TZ2201,Utalingolo,TZ2201131,4536 ,2125 ,2411 ,4536 ,2125 ,0 ,0 ,0 ,2411 
United Republic of Tanzania,Jamhuri ya Muungano wa Tanzania,TZ,Njombe,TZ22,Wanging'ombe,TZ2202,Saja,TZ2202011,11469 ,5391 ,6078 ,11469 ,5391 ,0 ,0 ,0 ,6078 
United Republic of Tanzania,Jamhuri ya Muungano wa Tanzania,TZ,Njombe,TZ22,Wanging'ombe,TZ2202,Kijombe,TZ2202021,8025 ,3918 ,4107 ,8025 ,3918 ,0 ,0 ,0 ,4107 
United Republic of Tanzania,Jamhuri ya Muungano wa Tanzania,TZ,Njombe,TZ22,Wanging'ombe,TZ2202,Wanging'ombe,TZ2202033,12115 ,5753 ,6362 ,9877 ,4681 ,2238 ,1072 ,1166 ,5196 
United Republic of Tanzania,Jamhuri ya Muungano wa Tanzania,TZ,Njombe,TZ22,Wanging'ombe,TZ2202,Ilembula,TZ2202043,15642 ,7150 ,8492 ,9202 ,4355 ,6440 ,2795 ,3645 ,4847 
United Republic of Tanzania,Jamhuri ya Muungano wa Tanzania,TZ,Njombe,TZ22,Wanging'ombe,TZ2202,Uhambule,TZ2202051,6028 ,2858 ,3170 ,6028 ,2858 ,0 ,0 ,0 ,3170 
United Republic of Tanzania,Jamhuri ya Muungano wa Tanzania,TZ,Njombe,TZ22,Wanging'ombe,TZ2202,Usuka,TZ2202061,6146 ,2961 ,3185 ,6146 ,2961 ,0 ,0 ,0 ,3185 
United Republic of Tanzania,Jamhuri ya Muungano wa Tanzania,TZ,Njombe,TZ22,Wanging'ombe,TZ2202,Igwachanya,TZ2202071,12067 ,5703 ,6364 ,12067 ,5703 ,0 ,0 ,0 ,6364 
United Republic of Tanzania,Jamhuri ya Muungano wa Tanzania,TZ,Njombe,TZ22,Wanging'ombe,TZ2202,Mdandu,TZ2202081,12886 ,6124 ,6762 ,12886 ,6124 ,0 ,0 ,0 ,6762 
United Republic of Tanzania,Jamhuri ya Muungano wa Tanzania,TZ,Njombe,TZ22,Wanging'ombe,TZ2202,Igima,TZ2202091,14363 ,6583 ,7780 ,14363 ,6583 ,0 ,0 ,0 ,7780 
United Republic of Tanzania,Jamhuri ya Muungano wa Tanzania,TZ,Njombe,TZ22,Wanging'ombe,TZ2202,Imalinyi,TZ2202101,8529 ,3993 ,4536 ,8529 ,3993 ,0 ,0 ,0 ,4536 
United Republic of Tanzania,Jamhuri ya Muungano wa Tanzania,TZ,Njombe,TZ22,Wanging'ombe,TZ2202,Ulembwe,TZ2202111,10883 ,4892 ,5991 ,10883 ,4892 ,0 ,0 ,0 ,5991 
United Republic of Tanzania,Jamhuri ya Muungano wa Tanzania,TZ,Njombe,TZ22,Wanging'ombe,TZ2202,Makoga,TZ2202121,8303 ,3741 ,4562 ,8303 ,3741 ,0 ,0 ,0 ,4562 
United Republic of Tanzania,Jamhuri ya Muungano wa Tanzania,TZ,Njombe,TZ22,Wanging'ombe,TZ2202,Kipengere,TZ2202131,7273 ,3243 ,4030 ,7273 ,3243 ,0 ,0 ,0 ,4030 
United Republic of Tanzania,Jamhuri ya Muungano wa Tanzania,TZ,Njombe,TZ22,Wanging'ombe,TZ2202,Igosi,TZ2202141,7204 ,3304 ,3900 ,7204 ,3304 ,0 ,0 ,0 ,3900 
United Republic of Tanzania,Jamhuri ya Muungano wa Tanzania,TZ,Njombe,TZ22,Wanging'ombe,TZ2202,Wangama,TZ2202151,4098 ,1879 ,2219 ,4098 ,1879 ,0 ,0 ,0 ,2219 
United Republic of Tanzania,Jamhuri ya Muungano wa Tanzania,TZ,Njombe,TZ22,Wanging'ombe,TZ2202,Kidugala,TZ2202161,4838 ,2262 ,2576 ,4838 ,2262 ,0 ,0 ,0 ,2576 
United Republic of Tanzania,Jamhuri ya Muungano wa Tanzania,TZ,Njombe,TZ22,Wanging'ombe,TZ2202,Luduga,TZ2202171,11947 ,5672 ,6275 ,11947 ,5672 ,0 ,0 ,0 ,6275 
United Republic of Tanzania,Jamhuri ya Muungano wa Tanzania,TZ,Njombe,TZ22,Makete,TZ2203,Lupalilo,TZ2203011,4527 ,1993 ,2534 ,4527 ,1993 ,0 ,0 ,0 ,2534 
United Republic of Tanzania,Jamhuri ya Muungano wa Tanzania,TZ,Njombe,TZ22,Makete,TZ2203,Mang'oto,TZ2203013,3781 ,1706 ,2075 ,3781 ,1706 ,0 ,0 ,0 ,2075 
United Republic of Tanzania,Jamhuri ya Muungano wa Tanzania,TZ,Njombe,TZ22,Makete,TZ2203,Iwawa,TZ2203023,10176 ,4697 ,5479 ,4993 ,2290 ,5183 ,2407 ,2776 ,2703 
United Republic of Tanzania,Jamhuri ya Muungano wa Tanzania,TZ,Njombe,TZ22,Makete,TZ2203,Lupila,TZ2203041,5004 ,2255 ,2749 ,5004 ,2255 ,0 ,0 ,0 ,2749 
United Republic of Tanzania,Jamhuri ya Muungano wa Tanzania,TZ,Njombe,TZ22,Makete,TZ2203,Ukwama,TZ2203051,3529 ,1616 ,1913 ,3529 ,1616 ,0 ,0 ,0 ,1913 
United Republic of Tanzania,Jamhuri ya Muungano wa Tanzania,TZ,Njombe,TZ22,Makete,TZ2203,Bulongwa,TZ2203061,3824 ,1708 ,2116 ,3824 ,1708 ,0 ,0 ,0 ,2116 
United Republic of Tanzania,Jamhuri ya Muungano wa Tanzania,TZ,Njombe,TZ22,Makete,TZ2203,Kipagalo,TZ2203071,3913 ,1801 ,2112 ,3913 ,1801 ,0 ,0 ,0 ,2112 
United Republic of Tanzania,Jamhuri ya Muungano wa Tanzania,TZ,Njombe,TZ22,Makete,TZ2203,Iniho,TZ2203081,3720 ,1781 ,1939 ,3720 ,1781 ,0 ,0 ,0 ,1939 
United Republic of Tanzania,Jamhuri ya Muungano wa Tanzania,TZ,Njombe,TZ22,Makete,TZ2203,Ipelele,TZ2203091,4890 ,2348 ,2542 ,4890 ,2348 ,0 ,0 ,0 ,2542 
United Republic of Tanzania,Jamhuri ya Muungano wa Tanzania,TZ,Njombe,TZ22,Makete,TZ2203,Kigulu,TZ2203101,918 ,432 ,486 ,918 ,432 ,0 ,0 ,0 ,486 
United Republic of Tanzania,Jamhuri ya Muungano wa Tanzania,TZ,Njombe,TZ22,Makete,TZ2203,Matamba,TZ2203113,10441 ,4952 ,5489 ,6495 ,3121 ,3946 ,1831 ,2115 ,3374 
United Republic of Tanzania,Jamhuri ya Muungano wa Tanzania,TZ,Njombe,TZ22,Makete,TZ2203,Mlondwe,TZ2203121,3937 ,1893 ,2044 ,3937 ,1893 ,0 ,0 ,0 ,2044 
United Republic of Tanzania,Jamhuri ya Muungano wa Tanzania,TZ,Njombe,TZ22,Makete,TZ2203,Kitulo,TZ2203131,3469 ,1679 ,1790 ,3469 ,1679 ,0 ,0 ,0 ,1790 
United Republic of Tanzania,Jamhuri ya Muungano wa Tanzania,TZ,Njombe,TZ22,Makete,TZ2203,Ikuwo,TZ2203141,3648 ,1755 ,1893 ,3648 ,1755 ,0 ,0 ,0 ,1893 
United Republic of Tanzania,Jamhuri ya Muungano wa Tanzania,TZ,Njombe,TZ22,Makete,TZ2203,Mfumbi,TZ2203151,4718 ,2242 ,2476 ,4718 ,2242 ,0 ,0 ,0 ,2476 
United Republic of Tanzania,Jamhuri ya Muungano wa Tanzania,TZ,Njombe,TZ22,Makete,TZ2203,Ipepo,TZ2203161,5020 ,2328 ,2692 ,5020 ,2328 ,0 ,0 ,0 ,2692 
United Republic of Tanzania,Jamhuri ya Muungano wa Tanzania,TZ,Njombe,TZ22,Makete,TZ2203,Mbalatse,TZ2203171,2952 ,1319 ,1633 ,2952 ,1319 ,0 ,0 ,0 ,1633 
United Republic of Tanzania,Jamhuri ya Muungano wa Tanzania,TZ,Njombe,TZ22,Makete,TZ2203,Tandala,TZ2203181,5933 ,2794 ,3139 ,5933 ,2794 ,0 ,0 ,0 ,3139 
United Republic of Tanzania,Jamhuri ya Muungano wa Tanzania,TZ,Njombe,TZ22,Makete,TZ2203,Luwumbu,TZ2203191,2240 ,1044 ,1196 ,2240 ,1044 ,0 ,0 ,0 ,1196 
United Republic of Tanzania,Jamhuri ya Muungano wa Tanzania,TZ,Njombe,TZ22,Makete,TZ2203,Isapulano,TZ2203201,3191 ,1534 ,1657 ,3191 ,1534 ,0 ,0 ,0 ,1657 
United Republic of Tanzania,Jamhuri ya Muungano wa Tanzania,TZ,Njombe,TZ22,Makete,TZ2203,Kigala,TZ2203211,3022 ,1391 ,1631 ,3022 ,1391 ,0 ,0 ,0 ,1631 
United Republic of Tanzania,Jamhuri ya Muungano wa Tanzania,TZ,Njombe,TZ22,Makete,TZ2203,Itundu,TZ2203221,4413 ,2032 ,2381 ,4413 ,2032 ,0 ,0 ,0 ,2381 
United Republic of Tanzania,Jamhuri ya Muungano wa Tanzania,TZ,Njombe,TZ22,Njombe,TZ2204,Mtwango,TZ2204013,12948 ,5999 ,6949 ,7706 ,3588 ,5242 ,2411 ,2831 ,4118 
United Republic of Tanzania,Jamhuri ya Muungano wa Tanzania,TZ,Njombe,TZ22,Njombe,TZ2204,Igongolo,TZ2204021,8447 ,3944 ,4503 ,8447 ,3944 ,0 ,0 ,0 ,4503 
United Republic of Tanzania,Jamhuri ya Muungano wa Tanzania,TZ,Njombe,TZ22,Njombe,TZ2204,Kichiwa,TZ2204031,9961 ,4543 ,5418 ,9961 ,4543 ,0 ,0 ,0 ,5418 
United Republic of Tanzania,Jamhuri ya Muungano wa Tanzania,TZ,Njombe,TZ22,Njombe,TZ2204,Ninga,TZ2204041,5751 ,2751 ,3000 ,5751 ,2751 ,0 ,0 ,0 ,3000 
United Republic of Tanzania,Jamhuri ya Muungano wa Tanzania,TZ,Njombe,TZ22,Njombe,TZ2204,Ikuna,TZ2204051,9178 ,4189 ,4989 ,9178 ,4189 ,0 ,0 ,0 ,4989 
United Republic of Tanzania,Jamhuri ya Muungano wa Tanzania,TZ,Njombe,TZ22,Njombe,TZ2204,Kidegembye,TZ2204061,8068 ,3756 ,4312 ,8068 ,3756 ,0 ,0 ,0 ,4312 
United Republic of Tanzania,Jamhuri ya Muungano wa Tanzania,TZ,Njombe,TZ22,Njombe,TZ2204,Matembwe,TZ2204073,8653 ,4083 ,4570 ,5774 ,2720 ,2879 ,1363 ,1516 ,3054 
United Republic of Tanzania,Jamhuri ya Muungano wa Tanzania,TZ,Njombe,TZ22,Njombe,TZ2204,Lupembe,TZ2204083,7709 ,3584 ,4125 ,5267 ,2451 ,2442 ,1133 ,1309 ,2816 
United Republic of Tanzania,Jamhuri ya Muungano wa Tanzania,TZ,Njombe,TZ22,Njombe,TZ2204,Ikondo,TZ2204091,7635 ,3637 ,3998 ,7635 ,3637 ,0 ,0 ,0 ,3998 
United Republic of Tanzania,Jamhuri ya Muungano wa Tanzania,TZ,Njombe,TZ22,Njombe,TZ2204,Mfriga,TZ2204101,4249 ,2122 ,2127 ,4249 ,2122 ,0 ,0 ,0 ,2127 
United Republic of Tanzania,Jamhuri ya Muungano wa Tanzania,TZ,Njombe,TZ22,Njombe,TZ2204,Idamba,TZ2204111,3148 ,1439 ,1709 ,3148 ,1439 ,0 ,0 ,0 ,1709 
United Republic of Tanzania,Jamhuri ya Muungano wa Tanzania,TZ,Njombe,TZ22,Ludewa,TZ2205,Lumbila,TZ2205011,1880 ,881 ,999 ,1880 ,881 ,0 ,0 ,0 ,999 
United Republic of Tanzania,Jamhuri ya Muungano wa Tanzania,TZ,Njombe,TZ22,Ludewa,TZ2205,Kilondo,TZ2205021,2053 ,959 ,1094 ,2053 ,959 ,0 ,0 ,0 ,1094 
United Republic of Tanzania,Jamhuri ya Muungano wa Tanzania,TZ,Njombe,TZ22,Ludewa,TZ2205,Mawengi,TZ2205031,9083 ,4298 ,4785 ,9083 ,4298 ,0 ,0 ,0 ,4785 
United Republic of Tanzania,Jamhuri ya Muungano wa Tanzania,TZ,Njombe,TZ22,Ludewa,TZ2205,Lupanga,TZ2205041,6439 ,2969 ,3470 ,6439 ,2969 ,0 ,0 ,0 ,3470 
United Republic of Tanzania,Jamhuri ya Muungano wa Tanzania,TZ,Njombe,TZ22,Ludewa,TZ2205,Mlangali,TZ2205053,12977 ,6089 ,6888 ,8506 ,3974 ,4471 ,2115 ,2356 ,4532 
United Republic of Tanzania,Jamhuri ya Muungano wa Tanzania,TZ,Njombe,TZ22,Ludewa,TZ2205,Milo,TZ2205061,6861 ,3120 ,3741 ,6861 ,3120 ,0 ,0 ,0 ,3741 
United Republic of Tanzania,Jamhuri ya Muungano wa Tanzania,TZ,Njombe,TZ22,Ludewa,TZ2205,Lugarawa,TZ2205073,8535 ,3993 ,4542 ,6138 ,2932 ,2397 ,1061 ,1336 ,3206 
United Republic of Tanzania,Jamhuri ya Muungano wa Tanzania,TZ,Njombe,TZ22,Ludewa,TZ2205,Madope,TZ2205081,5442 ,2549 ,2893 ,5442 ,2549 ,0 ,0 ,0 ,2893 
United Republic of Tanzania,Jamhuri ya Muungano wa Tanzania,TZ,Njombe,TZ22,Ludewa,TZ2205,Madilu,TZ2205091,9172 ,4336 ,4836 ,9172 ,4336 ,0 ,0 ,0 ,4836 
United Republic of Tanzania,Jamhuri ya Muungano wa Tanzania,TZ,Njombe,TZ22,Ludewa,TZ2205,Mundindi,TZ2205101,7346 ,3706 ,3640 ,7346 ,3706 ,0 ,0 ,0 ,3640 
United Republic of Tanzania,Jamhuri ya Muungano wa Tanzania,TZ,Njombe,TZ22,Ludewa,TZ2205,Mavanga,TZ2205111,7651 ,3853 ,3798 ,7651 ,3853 ,0 ,0 ,0 ,3798 
United Republic of Tanzania,Jamhuri ya Muungano wa Tanzania,TZ,Njombe,TZ22,Ludewa,TZ2205,Ibumi,TZ2205121,1812 ,940 ,872 ,1812 ,940 ,0 ,0 ,0 ,872 
United Republic of Tanzania,Jamhuri ya Muungano wa Tanzania,TZ,Njombe,TZ22,Ludewa,TZ2205,Nkomang'ombe,TZ2205131,3649 ,1818 ,1831 ,3649 ,1818 ,0 ,0 ,0 ,1831 
United Republic of Tanzania,Jamhuri ya Muungano wa Tanzania,TZ,Njombe,TZ22,Ludewa,TZ2205,Luilo,TZ2205141,3976 ,1861 ,2115 ,3976 ,1861 ,0 ,0 ,0 ,2115 
United Republic of Tanzania,Jamhuri ya Muungano wa Tanzania,TZ,Njombe,TZ22,Ludewa,TZ2205,Masasi,TZ2205151,2293 ,1082 ,1211 ,2293 ,1082 ,0 ,0 ,0 ,1211 
United Republic of Tanzania,Jamhuri ya Muungano wa Tanzania,TZ,Njombe,TZ22,Ludewa,TZ2205,Manda,TZ2205163,4304 ,1993 ,2311 ,2507 ,1151 ,1797 ,842 ,955 ,1356 
United Republic of Tanzania,Jamhuri ya Muungano wa Tanzania,TZ,Njombe,TZ22,Ludewa,TZ2205,Iwela,TZ2205171,1193 ,579 ,614 ,1193 ,579 ,0 ,0 ,0 ,614 
United Republic of Tanzania,Jamhuri ya Muungano wa Tanzania,TZ,Njombe,TZ22,Ludewa,TZ2205,Lupingu,TZ2205181,4842 ,2236 ,2606 ,4842 ,2236 ,0 ,0 ,0 ,2606 
United Republic of Tanzania,Jamhuri ya Muungano wa Tanzania,TZ,Njombe,TZ22,Ludewa,TZ2205,Ludewa,TZ2205193,10115 ,4853 ,5262 ,2652 ,1302 ,7463 ,3551 ,3912 ,1350 
United Republic of Tanzania,Jamhuri ya Muungano wa Tanzania,TZ,Njombe,TZ22,Ludewa,TZ2205,Ludende,TZ2205201,5498 ,2619 ,2879 ,5498 ,2619 ,0 ,0 ,0 ,2879 
United Republic of Tanzania,Jamhuri ya Muungano wa Tanzania,TZ,Njombe,TZ22,Ludewa,TZ2205,Luana,TZ2205211,4570 ,2246 ,2324 ,4570 ,2246 ,0 ,0 ,0 ,2324 
United Republic of Tanzania,Jamhuri ya Muungano wa Tanzania,TZ,Njombe,TZ22,Ludewa,TZ2205,Makonde,TZ2205221,3952 ,1891 ,2061 ,3952 ,1891 ,0 ,0 ,0 ,2061 
United Republic of Tanzania,Jamhuri ya Muungano wa Tanzania,TZ,Njombe,TZ22,Ludewa,TZ2205,Mkongobaki,TZ2205231,3530 ,1694 ,1836 ,3530 ,1694 ,0 ,0 ,0 ,1836 
United Republic of Tanzania,Jamhuri ya Muungano wa Tanzania,TZ,Njombe,TZ22,Ludewa,TZ2205,Lifuma,TZ2205241,2224 ,1042 ,1182 ,2224 ,1042 ,0 ,0 ,0 ,1182 
United Republic of Tanzania,Jamhuri ya Muungano wa Tanzania,TZ,Njombe,TZ22,Ludewa,TZ2205,Ruhuhu,TZ2205251,3821 ,1835 ,1986 ,3821 ,1835 ,0 ,0 ,0 ,1986 
United Republic of Tanzania,Jamhuri ya Muungano wa Tanzania,TZ,Njombe,TZ22,Makambako Township Authority,TZ2206,Ubena,TZ2206013,17691 ,8430 ,9261 ,448 ,199 ,17243 ,8231 ,9012 ,249 
United Republic of Tanzania,Jamhuri ya Muungano wa Tanzania,TZ,Njombe,TZ22,Makambako Township Authority,TZ2206,Mjimwema,TZ2206022,28998 ,13262 ,15736 ,0 ,0 ,28998 ,13262 ,15736 ,0 
United Republic of Tanzania,Jamhuri ya Muungano wa Tanzania,TZ,Njombe,TZ22,Makambako Township Authority,TZ2206,Mlowa,TZ2206031,5712 ,2723 ,2989 ,5712 ,2723 ,0 ,0 ,0 ,2989 
United Republic of Tanzania,Jamhuri ya Muungano wa Tanzania,TZ,Njombe,TZ22,Makambako Township Authority,TZ2206,Lyamkena,TZ2206043,9383 ,4392 ,4991 ,5718 ,2635 ,3665 ,1757 ,1908 ,3083 
United Republic of Tanzania,Jamhuri ya Muungano wa Tanzania,TZ,Njombe,TZ22,Makambako Township Authority,TZ2206,Mwembetogwa,TZ2206052,7382 ,3500 ,3882 ,0 ,0 ,7382 ,3500 ,3882 ,0 
United Republic of Tanzania,Jamhuri ya Muungano wa Tanzania,TZ,Njombe,TZ22,Makambako Township Authority,TZ2206,Mahongole,TZ2206061,9222 ,4401 ,4821 ,9222 ,4401 ,0 ,0 ,0 ,4821 
United Republic of Tanzania,Jamhuri ya Muungano wa Tanzania,TZ,Njombe,TZ22,Makambako Township Authority,TZ2206,Kitandililo,TZ2206071,6842 ,3229 ,3613 ,6842 ,3229 ,0 ,0 ,0 ,3613 
United Republic of Tanzania,Jamhuri ya Muungano wa Tanzania,TZ,Njombe,TZ22,Makambako Township Authority,TZ2206,Utengule,TZ2206081,8597 ,4094 ,4503 ,8597 ,4094 ,0 ,0 ,0 ,4503 
United Republic of Tanzania,Jamhuri ya Muungano wa Tanzania,TZ,Katavi,TZ23,Mpanda Urban,TZ2301,Kakese,TZ2301011,21360 ,10745 ,10615 ,21360 ,10745 ,0 ,0 ,0 ,10615 
United Republic of Tanzania,Jamhuri ya Muungano wa Tanzania,TZ,Katavi,TZ23,Mpanda Urban,TZ2301,Misunkumilo,TZ2301022,3396 ,1689 ,1707 ,0 ,0 ,3396 ,1689 ,1707 ,0 
United Republic of Tanzania,Jamhuri ya Muungano wa Tanzania,TZ,Katavi,TZ23,Mpanda Urban,TZ2301,Shanwe,TZ2301032,7361 ,3583 ,3778 ,0 ,0 ,7361 ,3583 ,3778 ,0 
United Republic of Tanzania,Jamhuri ya Muungano wa Tanzania,TZ,Katavi,TZ23,Mpanda Urban,TZ2301,Makanyagio,TZ2301042,10375 ,5032 ,5343 ,0 ,0 ,10375 ,5032 ,5343 ,0 
United Republic of Tanzania,Jamhuri ya Muungano wa Tanzania,TZ,Katavi,TZ23,Mpanda Urban,TZ2301,Kashaulili,TZ2301052,13009 ,6330 ,6679 ,0 ,0 ,13009 ,6330 ,6679 ,0 
United Republic of Tanzania,Jamhuri ya Muungano wa Tanzania,TZ,Katavi,TZ23,Mpanda Urban,TZ2301,Mpanda Hotel,TZ2301062,11527 ,5751 ,5776 ,0 ,0 ,11527 ,5751 ,5776 ,0 
United Republic of Tanzania,Jamhuri ya Muungano wa Tanzania,TZ,Katavi,TZ23,Mpanda Urban,TZ2301,Kawajense,TZ2301072,15373 ,7416 ,7957 ,0 ,0 ,15373 ,7416 ,7957 ,0 
United Republic of Tanzania,Jamhuri ya Muungano wa Tanzania,TZ,Katavi,TZ23,Mpanda Urban,TZ2301,Nsemulwa,TZ2301082,17166 ,8318 ,8848 ,0 ,0 ,17166 ,8318 ,8848 ,0 
United Republic of Tanzania,Jamhuri ya Muungano wa Tanzania,TZ,Katavi,TZ23,Mpanda Urban,TZ2301,Ilembo,TZ2301092,3333 ,1573 ,1760 ,0 ,0 ,3333 ,1573 ,1760 ,0 
United Republic of Tanzania,Jamhuri ya Muungano wa Tanzania,TZ,Katavi,TZ23,Mpanda,TZ2302,Mishamo,TZ2302013,61017 ,29541 ,31476 ,0 ,0 ,61017 ,29541 ,31476 ,0 
United Republic of Tanzania,Jamhuri ya Muungano wa Tanzania,TZ,Katavi,TZ23,Mpanda,TZ2302,Mpanda Ndogo,TZ2302021,25293 ,12745 ,12548 ,25293 ,12745 ,0 ,0 ,0 ,12548 
United Republic of Tanzania,Jamhuri ya Muungano wa Tanzania,TZ,Katavi,TZ23,Mpanda,TZ2302,Mwese,TZ2302031,7520 ,3847 ,3673 ,7520 ,3847 ,0 ,0 ,0 ,3673 
United Republic of Tanzania,Jamhuri ya Muungano wa Tanzania,TZ,Katavi,TZ23,Mpanda,TZ2302,Katuma,TZ2302041,9470 ,4921 ,4549 ,9470 ,4921 ,0 ,0 ,0 ,4549 
United Republic of Tanzania,Jamhuri ya Muungano wa Tanzania,TZ,Katavi,TZ23,Mpanda,TZ2302,Kabungu,TZ2302051,22676 ,11401 ,11275 ,22676 ,11401 ,0 ,0 ,0 ,11275 
United Republic of Tanzania,Jamhuri ya Muungano wa Tanzania,TZ,Katavi,TZ23,Mpanda,TZ2302,Sibwesa,TZ2302061,19183 ,9709 ,9474 ,19183 ,9709 ,0 ,0 ,0 ,9474 
United Republic of Tanzania,Jamhuri ya Muungano wa Tanzania,TZ,Katavi,TZ23,Mpanda,TZ2302,Ikola,TZ2302071,17659 ,8798 ,8861 ,17659 ,8798 ,0 ,0 ,0 ,8861 
United Republic of Tanzania,Jamhuri ya Muungano wa Tanzania,TZ,Katavi,TZ23,Mpanda,TZ2302,Karema,TZ2302083,7465 ,3830 ,3635 ,2136 ,1114 ,5329 ,2716 ,2613 ,1022 
United Republic of Tanzania,Jamhuri ya Muungano wa Tanzania,TZ,Katavi,TZ23,Mpanda,TZ2302,Kapalamsenga,TZ2302091,8853 ,4473 ,4380 ,8853 ,4473 ,0 ,0 ,0 ,4380 
United Republic of Tanzania,Jamhuri ya Muungano wa Tanzania,TZ,Katavi,TZ23,Mlele,TZ2303,Kasokola,TZ2303011,3967 ,1917 ,2050 ,3967 ,1917 ,0 ,0 ,0 ,2050 
United Republic of Tanzania,Jamhuri ya Muungano wa Tanzania,TZ,Katavi,TZ23,Mlele,TZ2303,Ugala,TZ2303021,8559 ,4360 ,4199 ,8559 ,4360 ,0 ,0 ,0 ,4199 
United Republic of Tanzania,Jamhuri ya Muungano wa Tanzania,TZ,Katavi,TZ23,Mlele,TZ2303,Litapunga,TZ2303031,70854 ,34124 ,36730 ,70854 ,34124 ,0 ,0 ,0 ,36730 
United Republic of Tanzania,Jamhuri ya Muungano wa Tanzania,TZ,Katavi,TZ23,Mlele,TZ2303,Mtapenda,TZ2303041,4811 ,2399 ,2412 ,4811 ,2399 ,0 ,0 ,0 ,2412 
United Republic of Tanzania,Jamhuri ya Muungano wa Tanzania,TZ,Katavi,TZ23,Mlele,TZ2303,Inyonga,TZ2303053,11127 ,5540 ,5587 ,7660 ,3826 ,3467 ,1714 ,1753 ,3834 
United Republic of Tanzania,Jamhuri ya Muungano wa Tanzania,TZ,Katavi,TZ23,Mlele,TZ2303,Ilunde,TZ2303061,3719 ,1989 ,1730 ,3719 ,1989 ,0 ,0 ,0 ,1730 
United Republic of Tanzania,Jamhuri ya Muungano wa Tanzania,TZ,Katavi,TZ23,Mlele,TZ2303,Ilela,TZ2303071,6229 ,3174 ,3055 ,6229 ,3174 ,0 ,0 ,0 ,3055 
United Republic of Tanzania,Jamhuri ya Muungano wa Tanzania,TZ,Katavi,TZ23,Mlele,TZ2303,Utende,TZ2303081,7615 ,3864 ,3751 ,7615 ,3864 ,0 ,0 ,0 ,3751 
United Republic of Tanzania,Jamhuri ya Muungano wa Tanzania,TZ,Katavi,TZ23,Mlele,TZ2303,Mamba,TZ2303091,21545 ,10488 ,11057 ,21545 ,10488 ,0 ,0 ,0 ,11057 
United Republic of Tanzania,Jamhuri ya Muungano wa Tanzania,TZ,Katavi,TZ23,Mlele,TZ2303,Mbede,TZ2303101,10538 ,5145 ,5393 ,10538 ,5145 ,0 ,0 ,0 ,5393 
United Republic of Tanzania,Jamhuri ya Muungano wa Tanzania,TZ,Katavi,TZ23,Mlele,TZ2303,Urwira,TZ2303111,6124 ,3071 ,3053 ,6124 ,3071 ,0 ,0 ,0 ,3053 
United Republic of Tanzania,Jamhuri ya Muungano wa Tanzania,TZ,Katavi,TZ23,Mlele,TZ2303,Nsimbo,TZ2303121,7104 ,3544 ,3560 ,7104 ,3544 ,0 ,0 ,0 ,3560 
United Republic of Tanzania,Jamhuri ya Muungano wa Tanzania,TZ,Katavi,TZ23,Mlele,TZ2303,Magamba,TZ2303131,3186 ,1586 ,1600 ,3186 ,1586 ,0 ,0 ,0 ,1600 
United Republic of Tanzania,Jamhuri ya Muungano wa Tanzania,TZ,Katavi,TZ23,Mlele,TZ2303,Sitalike,TZ2303141,9638 ,5071 ,4567 ,9638 ,5071 ,0 ,0 ,0 ,4567 
United Republic of Tanzania,Jamhuri ya Muungano wa Tanzania,TZ,Katavi,TZ23,Mlele,TZ2303,Usevya,TZ2303153,8824 ,4296 ,4528 ,3105 ,1473 ,5719 ,2823 ,2896 ,1632 
United Republic of Tanzania,Jamhuri ya Muungano wa Tanzania,TZ,Katavi,TZ23,Mlele,TZ2303,Kibaoni,TZ2303161,12391 ,6049 ,6342 ,12391 ,6049 ,0 ,0 ,0 ,6342 
United Republic of Tanzania,Jamhuri ya Muungano wa Tanzania,TZ,Katavi,TZ23,Mlele,TZ2303,Machimboni,TZ2303171,9372 ,5037 ,4335 ,9372 ,5037 ,0 ,0 ,0 ,4335 
United Republic of Tanzania,Jamhuri ya Muungano wa Tanzania,TZ,Katavi,TZ23,Mlele,TZ2303,Kapalala,TZ2303181,4508 ,2213 ,2295 ,4508 ,2213 ,0 ,0 ,0 ,2295 
United Republic of Tanzania,Jamhuri ya Muungano wa Tanzania,TZ,Katavi,TZ23,Mlele,TZ2303,Itenka,TZ2303191,16122 ,8106 ,8016 ,16122 ,8106 ,0 ,0 ,0 ,8016 
United Republic of Tanzania,Jamhuri ya Muungano wa Tanzania,TZ,Katavi,TZ23,Mlele,TZ2303,Ikuba,TZ2303201,7982 ,3904 ,4078 ,7982 ,3904 ,0 ,0 ,0 ,4078 
United Republic of Tanzania,Jamhuri ya Muungano wa Tanzania,TZ,Katavi,TZ23,Mlele,TZ2303,Mwamapuli,TZ2303211,16249 ,8113 ,8136 ,16249 ,8113 ,0 ,0 ,0 ,8136 
United Republic of Tanzania,Jamhuri ya Muungano wa Tanzania,TZ,Katavi,TZ23,Mlele,TZ2303,Majimoto,TZ2303221,18166 ,9008 ,9158 ,18166 ,9008 ,0 ,0 ,0 ,9158 
United Republic of Tanzania,Jamhuri ya Muungano wa Tanzania,TZ,Katavi,TZ23,Mlele,TZ2303,Kasansa,TZ2303231,7930 ,3981 ,3949 ,7930 ,3981 ,0 ,0 ,0 ,3949 
United Republic of Tanzania,Jamhuri ya Muungano wa Tanzania,TZ,Katavi,TZ23,Mlele,TZ2303,Nsenkwa,TZ2303241,6008 ,3001 ,3007 ,6008 ,3001 ,0 ,0 ,0 ,3007 
United Republic of Tanzania,Jamhuri ya Muungano wa Tanzania,TZ,Simiyu,TZ24,Bariadi,TZ2401,Nkindwabiye,TZ2401011,13948 ,6683 ,7265 ,13948 ,6683 ,0 ,0 ,0 ,7265 
United Republic of Tanzania,Jamhuri ya Muungano wa Tanzania,TZ,Simiyu,TZ24,Bariadi,TZ2401,Mwaubinge,TZ2401021,15780 ,7488 ,8292 ,15780 ,7488 ,0 ,0 ,0 ,8292 
United Republic of Tanzania,Jamhuri ya Muungano wa Tanzania,TZ,Simiyu,TZ24,Bariadi,TZ2401,Nkololo,TZ2401033,21776 ,10241 ,11535 ,16194 ,7679 ,5582 ,2562 ,3020 ,8515 
United Republic of Tanzania,Jamhuri ya Muungano wa Tanzania,TZ,Simiyu,TZ24,Bariadi,TZ2401,Mwaumatondo,TZ2401041,25748 ,12136 ,13612 ,25748 ,12136 ,0 ,0 ,0 ,13612 
United Republic of Tanzania,Jamhuri ya Muungano wa Tanzania,TZ,Simiyu,TZ24,Bariadi,TZ2401,Madobana,TZ2401051,10489 ,4925 ,5564 ,3239 ,1590 ,7250 ,3335 ,3915 ,1649 
United Republic of Tanzania,Jamhuri ya Muungano wa Tanzania,TZ,Simiyu,TZ24,Bariadi,TZ2401,Nyangokolwa,TZ2401061,22557 ,10755 ,11802 ,22557 ,10755 ,0 ,0 ,0 ,11802 
United Republic of Tanzania,Jamhuri ya Muungano wa Tanzania,TZ,Simiyu,TZ24,Bariadi,TZ2401,Somanda,TZ2401073,16592 ,8005 ,8587 ,13583 ,6519 ,3009 ,1486 ,1523 ,7064 
United Republic of Tanzania,Jamhuri ya Muungano wa Tanzania,TZ,Simiyu,TZ24,Bariadi,TZ2401,Bunamhala,TZ2401081,28301 ,13470 ,14831 ,28301 ,13470 ,0 ,0 ,0 ,14831 
United Republic of Tanzania,Jamhuri ya Muungano wa Tanzania,TZ,Simiyu,TZ24,Bariadi,TZ2401,Sakwe,TZ2401091,25676 ,12092 ,13584 ,25676 ,12092 ,0 ,0 ,0 ,13584 
United Republic of Tanzania,Jamhuri ya Muungano wa Tanzania,TZ,Simiyu,TZ24,Bariadi,TZ2401,Ngulyati,TZ2401103,11462 ,5530 ,5932 ,6923 ,3369 ,4539 ,2161 ,2378 ,3554 
United Republic of Tanzania,Jamhuri ya Muungano wa Tanzania,TZ,Simiyu,TZ24,Bariadi,TZ2401,Mhango,TZ2401111,11835 ,5544 ,6291 ,11835 ,5544 ,0 ,0 ,0 ,6291 
United Republic of Tanzania,Jamhuri ya Muungano wa Tanzania,TZ,Simiyu,TZ24,Bariadi,TZ2401,Kilalo,TZ2401121,9953 ,4924 ,5029 ,9953 ,4924 ,0 ,0 ,0 ,5029 
United Republic of Tanzania,Jamhuri ya Muungano wa Tanzania,TZ,Simiyu,TZ24,Bariadi,TZ2401,Kasoli,TZ2401131,14442 ,7026 ,7416 ,14442 ,7026 ,0 ,0 ,0 ,7416 
United Republic of Tanzania,Jamhuri ya Muungano wa Tanzania,TZ,Simiyu,TZ24,Bariadi,TZ2401,Gambosi,TZ2401141,15047 ,7332 ,7715 ,15047 ,7332 ,0 ,0 ,0 ,7715 
United Republic of Tanzania,Jamhuri ya Muungano wa Tanzania,TZ,Simiyu,TZ24,Bariadi,TZ2401,Guduwi,TZ2401151,10550 ,5069 ,5481 ,10550 ,5069 ,0 ,0 ,0 ,5481 
United Republic of Tanzania,Jamhuri ya Muungano wa Tanzania,TZ,Simiyu,TZ24,Bariadi,TZ2401,Ikungulyabashashi,TZ2401161,10153 ,4929 ,5224 ,10153 ,4929 ,0 ,0 ,0 ,5224 
United Republic of Tanzania,Jamhuri ya Muungano wa Tanzania,TZ,Simiyu,TZ24,Bariadi,TZ2401,Nyakabindi,TZ2401173,19723 ,9465 ,10258 ,18415 ,8839 ,1308 ,626 ,682 ,9576 
United Republic of Tanzania,Jamhuri ya Muungano wa Tanzania,TZ,Simiyu,TZ24,Bariadi,TZ2401,Dutwa,TZ2401183,15792 ,7696 ,8096 ,12936 ,6334 ,2856 ,1362 ,1494 ,6602 
United Republic of Tanzania,Jamhuri ya Muungano wa Tanzania,TZ,Simiyu,TZ24,Bariadi,TZ2401,Sapiwi,TZ2401191,19356 ,9292 ,10064 ,19356 ,9292 ,0 ,0 ,0 ,10064 
United Republic of Tanzania,Jamhuri ya Muungano wa Tanzania,TZ,Simiyu,TZ24,Bariadi,TZ2401,Matongo,TZ2401201,12623 ,6013 ,6610 ,12623 ,6013 ,0 ,0 ,0 ,6610 
United Republic of Tanzania,Jamhuri ya Muungano wa Tanzania,TZ,Simiyu,TZ24,Bariadi,TZ2401,Gilya,TZ2401211,16118 ,7658 ,8460 ,16118 ,7658 ,0 ,0 ,0 ,8460 
United Republic of Tanzania,Jamhuri ya Muungano wa Tanzania,TZ,Simiyu,TZ24,Bariadi,TZ2401,Isanga,TZ2401221,11354 ,5263 ,6091 ,11354 ,5263 ,0 ,0 ,0 ,6091 
United Republic of Tanzania,Jamhuri ya Muungano wa Tanzania,TZ,Simiyu,TZ24,Bariadi,TZ2401,Bariadi,TZ2401233,11248 ,5226 ,6022 ,2765 ,1351 ,8483 ,3875 ,4608 ,1414 
United Republic of Tanzania,Jamhuri ya Muungano wa Tanzania,TZ,Simiyu,TZ24,Bariadi,TZ2401,Malambo,TZ2401243,16445 ,7948 ,8497 ,11822 ,5792 ,4623 ,2156 ,2467 ,6030 
United Republic of Tanzania,Jamhuri ya Muungano wa Tanzania,TZ,Simiyu,TZ24,Bariadi,TZ2401,Sima,TZ2401253,13553 ,6363 ,7190 ,0 ,0 ,13553 ,6363 ,7190 ,0 
United Republic of Tanzania,Jamhuri ya Muungano wa Tanzania,TZ,Simiyu,TZ24,Itilima,TZ2402,Bumera,TZ2402011,13861 ,6552 ,7309 ,13861 ,6552 ,0 ,0 ,0 ,7309 
United Republic of Tanzania,Jamhuri ya Muungano wa Tanzania,TZ,Simiyu,TZ24,Itilima,TZ2402,Ikindiro,TZ2402021,13037 ,6150 ,6887 ,13037 ,6150 ,0 ,0 ,0 ,6887 
United Republic of Tanzania,Jamhuri ya Muungano wa Tanzania,TZ,Simiyu,TZ24,Itilima,TZ2402,Mwamtani,TZ2402031,10648 ,5001 ,5647 ,10648 ,5001 ,0 ,0 ,0 ,5647 
United Republic of Tanzania,Jamhuri ya Muungano wa Tanzania,TZ,Simiyu,TZ24,Itilima,TZ2402,Sagata,TZ2402041,18650 ,8667 ,9983 ,18650 ,8667 ,0 ,0 ,0 ,9983 
United Republic of Tanzania,Jamhuri ya Muungano wa Tanzania,TZ,Simiyu,TZ24,Itilima,TZ2402,Mwaswale,TZ2402051,14411 ,6717 ,7694 ,14411 ,6717 ,0 ,0 ,0 ,7694 
United Republic of Tanzania,Jamhuri ya Muungano wa Tanzania,TZ,Simiyu,TZ24,Itilima,TZ2402,Nkuyu,TZ2402061,11337 ,5397 ,5940 ,11337 ,5397 ,0 ,0 ,0 ,5940 
United Republic of Tanzania,Jamhuri ya Muungano wa Tanzania,TZ,Simiyu,TZ24,Itilima,TZ2402,Mhunze,TZ2402071,20655 ,9532 ,11123 ,20655 ,9532 ,0 ,0 ,0 ,11123 
United Republic of Tanzania,Jamhuri ya Muungano wa Tanzania,TZ,Simiyu,TZ24,Itilima,TZ2402,Migato,TZ2402081,16821 ,8114 ,8707 ,16821 ,8114 ,0 ,0 ,0 ,8707 
United Republic of Tanzania,Jamhuri ya Muungano wa Tanzania,TZ,Simiyu,TZ24,Itilima,TZ2402,Chinamili,TZ2402091,15393 ,7244 ,8149 ,15393 ,7244 ,0 ,0 ,0 ,8149 
United Republic of Tanzania,Jamhuri ya Muungano wa Tanzania,TZ,Simiyu,TZ24,Itilima,TZ2402,Ndolelezi,TZ2402101,13645 ,6380 ,7265 ,13645 ,6380 ,0 ,0 ,0 ,7265 
United Republic of Tanzania,Jamhuri ya Muungano wa Tanzania,TZ,Simiyu,TZ24,Itilima,TZ2402,Lagangabilili,TZ2402111,12909 ,6078 ,6831 ,12909 ,6078 ,0 ,0 ,0 ,6831 
United Republic of Tanzania,Jamhuri ya Muungano wa Tanzania,TZ,Simiyu,TZ24,Itilima,TZ2402,Budalabujiga,TZ2402121,11250 ,5191 ,6059 ,11250 ,5191 ,0 ,0 ,0 ,6059 
United Republic of Tanzania,Jamhuri ya Muungano wa Tanzania,TZ,Simiyu,TZ24,Itilima,TZ2402,Nkoma,TZ2402131,21450 ,10015 ,11435 ,21450 ,10015 ,0 ,0 ,0 ,11435 
United Republic of Tanzania,Jamhuri ya Muungano wa Tanzania,TZ,Simiyu,TZ24,Itilima,TZ2402,Mwalushu,TZ2402141,13758 ,6648 ,7110 ,13758 ,6648 ,0 ,0 ,0 ,7110 
United Republic of Tanzania,Jamhuri ya Muungano wa Tanzania,TZ,Simiyu,TZ24,Itilima,TZ2402,Mwamapalala,TZ2402153,16091 ,7791 ,8300 ,13987 ,6786 ,2104 ,1005 ,1099 ,7201 
United Republic of Tanzania,Jamhuri ya Muungano wa Tanzania,TZ,Simiyu,TZ24,Itilima,TZ2402,Nyamalapa,TZ2402161,13603 ,6393 ,7210 ,13603 ,6393 ,0 ,0 ,0 ,7210 
United Republic of Tanzania,Jamhuri ya Muungano wa Tanzania,TZ,Simiyu,TZ24,Itilima,TZ2402,Lugulu,TZ2402173,18328 ,8769 ,9559 ,15397 ,7364 ,2931 ,1405 ,1526 ,8033 
United Republic of Tanzania,Jamhuri ya Muungano wa Tanzania,TZ,Simiyu,TZ24,Itilima,TZ2402,Nhobora,TZ2402181,13101 ,6202 ,6899 ,13101 ,6202 ,0 ,0 ,0 ,6899 
United Republic of Tanzania,Jamhuri ya Muungano wa Tanzania,TZ,Simiyu,TZ24,Itilima,TZ2402,Zagayu,TZ2402191,14737 ,7145 ,7592 ,14737 ,7145 ,0 ,0 ,0 ,7592 
United Republic of Tanzania,Jamhuri ya Muungano wa Tanzania,TZ,Simiyu,TZ24,Itilima,TZ2402,Kinang'weli,TZ2402201,12315 ,6085 ,6230 ,12315 ,6085 ,0 ,0 ,0 ,6230 
United Republic of Tanzania,Jamhuri ya Muungano wa Tanzania,TZ,Simiyu,TZ24,Itilima,TZ2402,Mbita,TZ2402211,11253 ,5307 ,5946 ,11253 ,5307 ,0 ,0 ,0 ,5946 
United Republic of Tanzania,Jamhuri ya Muungano wa Tanzania,TZ,Simiyu,TZ24,Itilima,TZ2402,Sawida,TZ2402221,10263 ,4988 ,5275 ,10263 ,4988 ,0 ,0 ,0 ,5275 
United Republic of Tanzania,Jamhuri ya Muungano wa Tanzania,TZ,Simiyu,TZ24,Meatu,TZ2403,Mwanhuzi,TZ2403013,20175 ,9747 ,10428 ,7803 ,3792 ,12372 ,5955 ,6417 ,4011 
United Republic of Tanzania,Jamhuri ya Muungano wa Tanzania,TZ,Simiyu,TZ24,Meatu,TZ2403,Nkoma,TZ2403021,8526 ,4046 ,4480 ,8526 ,4046 ,0 ,0 ,0 ,4480 
United Republic of Tanzania,Jamhuri ya Muungano wa Tanzania,TZ,Simiyu,TZ24,Meatu,TZ2403,Kimali,TZ2403031,9394 ,4498 ,4896 ,9394 ,4498 ,0 ,0 ,0 ,4896 
United Republic of Tanzania,Jamhuri ya Muungano wa Tanzania,TZ,Simiyu,TZ24,Meatu,TZ2403,Mwamishali,TZ2403041,12909 ,6317 ,6592 ,12909 ,6317 ,0 ,0 ,0 ,6592 
United Republic of Tanzania,Jamhuri ya Muungano wa Tanzania,TZ,Simiyu,TZ24,Meatu,TZ2403,Itinje,TZ2403051,14836 ,7228 ,7608 ,14836 ,7228 ,0 ,0 ,0 ,7608 
United Republic of Tanzania,Jamhuri ya Muungano wa Tanzania,TZ,Simiyu,TZ24,Meatu,TZ2403,Kisesa,TZ2403061,19509 ,9119 ,10390 ,19509 ,9119 ,0 ,0 ,0 ,10390 
United Republic of Tanzania,Jamhuri ya Muungano wa Tanzania,TZ,Simiyu,TZ24,Meatu,TZ2403,Mwandoya,TZ2403071,17720 ,8373 ,9347 ,17720 ,8373 ,0 ,0 ,0 ,9347 
United Republic of Tanzania,Jamhuri ya Muungano wa Tanzania,TZ,Simiyu,TZ24,Meatu,TZ2403,Lingeka,TZ2403081,6803 ,3225 ,3578 ,6803 ,3225 ,0 ,0 ,0 ,3578 
United Republic of Tanzania,Jamhuri ya Muungano wa Tanzania,TZ,Simiyu,TZ24,Meatu,TZ2403,Sakasaka,TZ2403091,11756 ,5619 ,6137 ,11756 ,5619 ,0 ,0 ,0 ,6137 
United Republic of Tanzania,Jamhuri ya Muungano wa Tanzania,TZ,Simiyu,TZ24,Meatu,TZ2403,Imalaseko,TZ2403101,6587 ,3215 ,3372 ,6587 ,3215 ,0 ,0 ,0 ,3372 
United Republic of Tanzania,Jamhuri ya Muungano wa Tanzania,TZ,Simiyu,TZ24,Meatu,TZ2403,Mwabuzo,TZ2403111,25778 ,12083 ,13695 ,25778 ,12083 ,0 ,0 ,0 ,13695 
United Republic of Tanzania,Jamhuri ya Muungano wa Tanzania,TZ,Simiyu,TZ24,Meatu,TZ2403,Mwamalole,TZ2403121,9546 ,4757 ,4789 ,9546 ,4757 ,0 ,0 ,0 ,4789 
United Republic of Tanzania,Jamhuri ya Muungano wa Tanzania,TZ,Simiyu,TZ24,Meatu,TZ2403,Mwanjolo,TZ2403131,11955 ,5628 ,6327 ,11955 ,5628 ,0 ,0 ,0 ,6327 
United Republic of Tanzania,Jamhuri ya Muungano wa Tanzania,TZ,Simiyu,TZ24,Meatu,TZ2403,Mwabuma,TZ2403141,11894 ,5723 ,6171 ,11894 ,5723 ,0 ,0 ,0 ,6171 
United Republic of Tanzania,Jamhuri ya Muungano wa Tanzania,TZ,Simiyu,TZ24,Meatu,TZ2403,Mwabusalu,TZ2403151,12272 ,5910 ,6362 ,12272 ,5910 ,0 ,0 ,0 ,6362 
United Republic of Tanzania,Jamhuri ya Muungano wa Tanzania,TZ,Simiyu,TZ24,Meatu,TZ2403,Lubiga,TZ2403161,16351 ,7839 ,8512 ,16351 ,7839 ,0 ,0 ,0 ,8512 
United Republic of Tanzania,Jamhuri ya Muungano wa Tanzania,TZ,Simiyu,TZ24,Meatu,TZ2403,Mwamanongu,TZ2403171,7961 ,3873 ,4088 ,7961 ,3873 ,0 ,0 ,0 ,4088 
United Republic of Tanzania,Jamhuri ya Muungano wa Tanzania,TZ,Simiyu,TZ24,Meatu,TZ2403,Nghoboko,TZ2403181,12087 ,5913 ,6174 ,12087 ,5913 ,0 ,0 ,0 ,6174 
United Republic of Tanzania,Jamhuri ya Muungano wa Tanzania,TZ,Simiyu,TZ24,Meatu,TZ2403,Bukundi,TZ2403191,10759 ,5242 ,5517 ,10759 ,5242 ,0 ,0 ,0 ,5517 
United Republic of Tanzania,Jamhuri ya Muungano wa Tanzania,TZ,Simiyu,TZ24,Meatu,TZ2403,Mwasengela,TZ2403201,13002 ,5915 ,7087 ,13002 ,5915 ,0 ,0 ,0 ,7087 
United Republic of Tanzania,Jamhuri ya Muungano wa Tanzania,TZ,Simiyu,TZ24,Meatu,TZ2403,Mwamanimba,TZ2403211,4781 ,2276 ,2505 ,4781 ,2276 ,0 ,0 ,0 ,2505 
United Republic of Tanzania,Jamhuri ya Muungano wa Tanzania,TZ,Simiyu,TZ24,Meatu,TZ2403,Tindabuligi,TZ2403221,12034 ,5647 ,6387 ,12034 ,5647 ,0 ,0 ,0 ,6387 
United Republic of Tanzania,Jamhuri ya Muungano wa Tanzania,TZ,Simiyu,TZ24,Meatu,TZ2403,Mwakisandu,TZ2403231,8941 ,4131 ,4810 ,8941 ,4131 ,0 ,0 ,0 ,4810 
United Republic of Tanzania,Jamhuri ya Muungano wa Tanzania,TZ,Simiyu,TZ24,Meatu,TZ2403,Mwangundo,TZ2403241,12270 ,6088 ,6182 ,12270 ,6088 ,0 ,0 ,0 ,6182 
United Republic of Tanzania,Jamhuri ya Muungano wa Tanzania,TZ,Simiyu,TZ24,Meatu,TZ2403,Mwanyahina,TZ2403251,11974 ,5902 ,6072 ,11974 ,5902 ,0 ,0 ,0 ,6072 
United Republic of Tanzania,Jamhuri ya Muungano wa Tanzania,TZ,Simiyu,TZ24,Maswa,TZ2404,Ng'wigwa,TZ2404011,10005 ,4923 ,5082 ,10005 ,4923 ,0 ,0 ,0 ,5082 
United Republic of Tanzania,Jamhuri ya Muungano wa Tanzania,TZ,Simiyu,TZ24,Maswa,TZ2404,Nguliguli,TZ2404021,6914 ,3355 ,3559 ,6914 ,3355 ,0 ,0 ,0 ,3559 
United Republic of Tanzania,Jamhuri ya Muungano wa Tanzania,TZ,Simiyu,TZ24,Maswa,TZ2404,Ipililo,TZ2404031,18894 ,9083 ,9811 ,18894 ,9083 ,0 ,0 ,0 ,9811 
United Republic of Tanzania,Jamhuri ya Muungano wa Tanzania,TZ,Simiyu,TZ24,Maswa,TZ2404,Senani,TZ2404041,11873 ,5641 ,6232 ,11873 ,5641 ,0 ,0 ,0 ,6232 
United Republic of Tanzania,Jamhuri ya Muungano wa Tanzania,TZ,Simiyu,TZ24,Maswa,TZ2404,Mwamanenge,TZ2404051,8686 ,4110 ,4576 ,8686 ,4110 ,0 ,0 ,0 ,4576 
United Republic of Tanzania,Jamhuri ya Muungano wa Tanzania,TZ,Simiyu,TZ24,Maswa,TZ2404,Sukuma,TZ2404061,9912 ,4880 ,5032 ,9912 ,4880 ,0 ,0 ,0 ,5032 
United Republic of Tanzania,Jamhuri ya Muungano wa Tanzania,TZ,Simiyu,TZ24,Maswa,TZ2404,Mpindo,TZ2404071,15577 ,7338 ,8239 ,15577 ,7338 ,0 ,0 ,0 ,8239 
United Republic of Tanzania,Jamhuri ya Muungano wa Tanzania,TZ,Simiyu,TZ24,Maswa,TZ2404,Dakama,TZ2404081,14596 ,7040 ,7556 ,14596 ,7040 ,0 ,0 ,0 ,7556 
United Republic of Tanzania,Jamhuri ya Muungano wa Tanzania,TZ,Simiyu,TZ24,Maswa,TZ2404,Lalago,TZ2404093,23391 ,11459 ,11932 ,21589 ,10596 ,1802 ,863 ,939 ,10993 
United Republic of Tanzania,Jamhuri ya Muungano wa Tanzania,TZ,Simiyu,TZ24,Maswa,TZ2404,Budekwa,TZ2404101,13630 ,6631 ,6999 ,13630 ,6631 ,0 ,0 ,0 ,6999 
United Republic of Tanzania,Jamhuri ya Muungano wa Tanzania,TZ,Simiyu,TZ24,Maswa,TZ2404,Busilili,TZ2404111,15797 ,7729 ,8068 ,15797 ,7729 ,0 ,0 ,0 ,8068 
United Republic of Tanzania,Jamhuri ya Muungano wa Tanzania,TZ,Simiyu,TZ24,Maswa,TZ2404,Sengwa,TZ2404121,10544 ,5137 ,5407 ,10544 ,5137 ,0 ,0 ,0 ,5407 
United Republic of Tanzania,Jamhuri ya Muungano wa Tanzania,TZ,Simiyu,TZ24,Maswa,TZ2404,Masela,TZ2404131,26267 ,12760 ,13507 ,26267 ,12760 ,0 ,0 ,0 ,13507 
United Republic of Tanzania,Jamhuri ya Muungano wa Tanzania,TZ,Simiyu,TZ24,Maswa,TZ2404,Isanga,TZ2404141,17036 ,8284 ,8752 ,17036 ,8284 ,0 ,0 ,0 ,8752 
United Republic of Tanzania,Jamhuri ya Muungano wa Tanzania,TZ,Simiyu,TZ24,Maswa,TZ2404,Zanzui,TZ2404151,5458 ,2663 ,2795 ,5458 ,2663 ,0 ,0 ,0 ,2795 
United Republic of Tanzania,Jamhuri ya Muungano wa Tanzania,TZ,Simiyu,TZ24,Maswa,TZ2404,Mwamashimba,TZ2404161,9421 ,4601 ,4820 ,9421 ,4601 ,0 ,0 ,0 ,4820 
United Republic of Tanzania,Jamhuri ya Muungano wa Tanzania,TZ,Simiyu,TZ24,Maswa,TZ2404,Buchambi,TZ2404171,13520 ,6635 ,6885 ,13520 ,6635 ,0 ,0 ,0 ,6885 
United Republic of Tanzania,Jamhuri ya Muungano wa Tanzania,TZ,Simiyu,TZ24,Maswa,TZ2404,Kadoto,TZ2404181,11916 ,5771 ,6145 ,11916 ,5771 ,0 ,0 ,0 ,6145 
United Republic of Tanzania,Jamhuri ya Muungano wa Tanzania,TZ,Simiyu,TZ24,Maswa,TZ2404,Shishiyu,TZ2404191,24695 ,11913 ,12782 ,24695 ,11913 ,0 ,0 ,0 ,12782 
United Republic of Tanzania,Jamhuri ya Muungano wa Tanzania,TZ,Simiyu,TZ24,Maswa,TZ2404,Nyabubinza,TZ2404201,9913 ,5093 ,4820 ,9913 ,5093 ,0 ,0 ,0 ,4820 
United Republic of Tanzania,Jamhuri ya Muungano wa Tanzania,TZ,Simiyu,TZ24,Maswa,TZ2404,Mwang'honoli,TZ2404211,9877 ,4841 ,5036 ,9877 ,4841 ,0 ,0 ,0 ,5036 
United Republic of Tanzania,Jamhuri ya Muungano wa Tanzania,TZ,Simiyu,TZ24,Maswa,TZ2404,Kulimi,TZ2404221,14383 ,6851 ,7532 ,14383 ,6851 ,0 ,0 ,0 ,7532 
United Republic of Tanzania,Jamhuri ya Muungano wa Tanzania,TZ,Simiyu,TZ24,Maswa,TZ2404,Malampaka,TZ2404233,17084 ,8326 ,8758 ,17084 ,8326 ,0 ,0 ,0 ,8758 
United Republic of Tanzania,Jamhuri ya Muungano wa Tanzania,TZ,Simiyu,TZ24,Maswa,TZ2404,Badi,TZ2404241,16131 ,7890 ,8241 ,16131 ,7890 ,0 ,0 ,0 ,8241 
United Republic of Tanzania,Jamhuri ya Muungano wa Tanzania,TZ,Simiyu,TZ24,Maswa,TZ2404,Nyalikungu,TZ2404253,14354 ,6855 ,7499 ,3889 ,1878 ,10465 ,4977 ,5488 ,2011 
United Republic of Tanzania,Jamhuri ya Muungano wa Tanzania,TZ,Simiyu,TZ24,Maswa,TZ2404,Binza,TZ2404263,12243 ,6099 ,6144 ,4443 ,2228 ,7800 ,3871 ,3929 ,2215 
United Republic of Tanzania,Jamhuri ya Muungano wa Tanzania,TZ,Simiyu,TZ24,Busega,TZ2405,Shigala,TZ2405011,12974 ,6361 ,6613 ,12974 ,6361 ,0 ,0 ,0 ,6613 
United Republic of Tanzania,Jamhuri ya Muungano wa Tanzania,TZ,Simiyu,TZ24,Busega,TZ2405,Badugu,TZ2405021,13571 ,6587 ,6984 ,13571 ,6587 ,0 ,0 ,0 ,6984 
United Republic of Tanzania,Jamhuri ya Muungano wa Tanzania,TZ,Simiyu,TZ24,Busega,TZ2405,Nyaluhande,TZ2405031,9688 ,4797 ,4891 ,9688 ,4797 ,0 ,0 ,0 ,4891 
United Republic of Tanzania,Jamhuri ya Muungano wa Tanzania,TZ,Simiyu,TZ24,Busega,TZ2405,Kiloleli,TZ2405041,19396 ,9360 ,10036 ,19396 ,9360 ,0 ,0 ,0 ,10036 
United Republic of Tanzania,Jamhuri ya Muungano wa Tanzania,TZ,Simiyu,TZ24,Busega,TZ2405,Mwamanyili,TZ2405051,15224 ,7270 ,7954 ,15224 ,7270 ,0 ,0 ,0 ,7954 
United Republic of Tanzania,Jamhuri ya Muungano wa Tanzania,TZ,Simiyu,TZ24,Busega,TZ2405,Kabita,TZ2405063,22772 ,10754 ,12018 ,13867 ,6611 ,8905 ,4143 ,4762 ,7256 
United Republic of Tanzania,Jamhuri ya Muungano wa Tanzania,TZ,Simiyu,TZ24,Busega,TZ2405,Kalemela,TZ2405073,10928 ,5297 ,5631 ,8849 ,4326 ,2079 ,971 ,1108 ,4523 
United Republic of Tanzania,Jamhuri ya Muungano wa Tanzania,TZ,Simiyu,TZ24,Busega,TZ2405,Lamadi,TZ2405083,22062 ,10625 ,11437 ,11205 ,5502 ,10857 ,5123 ,5734 ,5703 
United Republic of Tanzania,Jamhuri ya Muungano wa Tanzania,TZ,Simiyu,TZ24,Busega,TZ2405,Lutubiga,TZ2405091,11721 ,5826 ,5895 ,11721 ,5826 ,0 ,0 ,0 ,5895 
United Republic of Tanzania,Jamhuri ya Muungano wa Tanzania,TZ,Simiyu,TZ24,Busega,TZ2405,Mkula,TZ2405101,12111 ,5914 ,6197 ,12111 ,5914 ,0 ,0 ,0 ,6197 
United Republic of Tanzania,Jamhuri ya Muungano wa Tanzania,TZ,Simiyu,TZ24,Busega,TZ2405,Ngasamo,TZ2405111,18935 ,9353 ,9582 ,18935 ,9353 ,0 ,0 ,0 ,9582 
United Republic of Tanzania,Jamhuri ya Muungano wa Tanzania,TZ,Simiyu,TZ24,Busega,TZ2405,Malili,TZ2405121,12380 ,6056 ,6324 ,12380 ,6056 ,0 ,0 ,0 ,6324 
United Republic of Tanzania,Jamhuri ya Muungano wa Tanzania,TZ,Simiyu,TZ24,Busega,TZ2405,Igalukilo,TZ2405131,12421 ,6030 ,6391 ,12421 ,6030 ,0 ,0 ,0 ,6391 
United Republic of Tanzania,Jamhuri ya Muungano wa Tanzania,TZ,Geita,TZ25,Geita,TZ2501,Kagu,TZ2501011,24920 ,12379 ,12541 ,24920 ,12379 ,0 ,0 ,0 ,12541 
United Republic of Tanzania,Jamhuri ya Muungano wa Tanzania,TZ,Geita,TZ25,Geita,TZ2501,Bugulula,TZ2501021,21578 ,10734 ,10844 ,21578 ,10734 ,0 ,0 ,0 ,10844 
United Republic of Tanzania,Jamhuri ya Muungano wa Tanzania,TZ,Geita,TZ25,Geita,TZ2501,Senga,TZ2501031,22402 ,11138 ,11264 ,22402 ,11138 ,0 ,0 ,0 ,11264 
United Republic of Tanzania,Jamhuri ya Muungano wa Tanzania,TZ,Geita,TZ25,Geita,TZ2501,Kakubilo,TZ2501041,16133 ,7942 ,8191 ,16133 ,7942 ,0 ,0 ,0 ,8191 
United Republic of Tanzania,Jamhuri ya Muungano wa Tanzania,TZ,Geita,TZ25,Geita,TZ2501,Nkome,TZ2501053,32726 ,16419 ,16307 ,21471 ,10874 ,11255 ,5545 ,5710 ,10597 
United Republic of Tanzania,Jamhuri ya Muungano wa Tanzania,TZ,Geita,TZ25,Geita,TZ2501,Katoma,TZ2501061,19635 ,9904 ,9731 ,19635 ,9904 ,0 ,0 ,0 ,9731 
United Republic of Tanzania,Jamhuri ya Muungano wa Tanzania,TZ,Geita,TZ25,Geita,TZ2501,Nzera,TZ2501071,20321 ,10135 ,10186 ,20321 ,10135 ,0 ,0 ,0 ,10186 
United Republic of Tanzania,Jamhuri ya Muungano wa Tanzania,TZ,Geita,TZ25,Geita,TZ2501,Lwezera,TZ2501081,24137 ,11988 ,12149 ,24137 ,11988 ,0 ,0 ,0 ,12149 
United Republic of Tanzania,Jamhuri ya Muungano wa Tanzania,TZ,Geita,TZ25,Geita,TZ2501,Kamhanga,TZ2501091,16727 ,8414 ,8313 ,16727 ,8414 ,0 ,0 ,0 ,8313 
United Republic of Tanzania,Jamhuri ya Muungano wa Tanzania,TZ,Geita,TZ25,Geita,TZ2501,Bugalama,TZ2501101,14213 ,6983 ,7230 ,14213 ,6983 ,0 ,0 ,0 ,7230 
United Republic of Tanzania,Jamhuri ya Muungano wa Tanzania,TZ,Geita,TZ25,Geita,TZ2501,Lubanga,TZ2501111,11980 ,5995 ,5985 ,11980 ,5995 ,0 ,0 ,0 ,5985 
United Republic of Tanzania,Jamhuri ya Muungano wa Tanzania,TZ,Geita,TZ25,Geita,TZ2501,Isulwabutunde,TZ2501121,11623 ,5676 ,5947 ,11623 ,5676 ,0 ,0 ,0 ,5947 
United Republic of Tanzania,Jamhuri ya Muungano wa Tanzania,TZ,Geita,TZ25,Geita,TZ2501,Kasamwa,TZ2501133,24461 ,11996 ,12465 ,12494 ,6285 ,11967 ,5711 ,6256 ,6209 
United Republic of Tanzania,Jamhuri ya Muungano wa Tanzania,TZ,Geita,TZ25,Geita,TZ2501,Bung'wangoko,TZ2501141,8587 ,4295 ,4292 ,8587 ,4295 ,0 ,0 ,0 ,4292 
United Republic of Tanzania,Jamhuri ya Muungano wa Tanzania,TZ,Geita,TZ25,Geita,TZ2501,Bulela,TZ2501151,15269 ,7527 ,7742 ,15269 ,7527 ,0 ,0 ,0 ,7742 
United Republic of Tanzania,Jamhuri ya Muungano wa Tanzania,TZ,Geita,TZ25,Geita,TZ2501,Ihanamilo,TZ2501161,9710 ,4843 ,4867 ,9710 ,4843 ,0 ,0 ,0 ,4867 
United Republic of Tanzania,Jamhuri ya Muungano wa Tanzania,TZ,Geita,TZ25,Geita,TZ2501,Nyanguku,TZ2501171,9658 ,4652 ,5006 ,9658 ,4652 ,0 ,0 ,0 ,5006 
United Republic of Tanzania,Jamhuri ya Muungano wa Tanzania,TZ,Geita,TZ25,Geita,TZ2501,Kamena,TZ2501181,21700 ,10702 ,10998 ,21700 ,10702 ,0 ,0 ,0 ,10998 
United Republic of Tanzania,Jamhuri ya Muungano wa Tanzania,TZ,Geita,TZ25,Geita,TZ2501,Nyamalimbe,TZ2501191,15761 ,7895 ,7866 ,15761 ,7895 ,0 ,0 ,0 ,7866 
United Republic of Tanzania,Jamhuri ya Muungano wa Tanzania,TZ,Geita,TZ25,Geita,TZ2501,Bujula,TZ2501201,9223 ,4647 ,4576 ,9223 ,4647 ,0 ,0 ,0 ,4576 
United Republic of Tanzania,Jamhuri ya Muungano wa Tanzania,TZ,Geita,TZ25,Geita,TZ2501,Bukoli,TZ2501211,16345 ,8071 ,8274 ,16345 ,8071 ,0 ,0 ,0 ,8274 
United Republic of Tanzania,Jamhuri ya Muungano wa Tanzania,TZ,Geita,TZ25,Geita,TZ2501,Butobela,TZ2501221,11809 ,6036 ,5773 ,11809 ,6036 ,0 ,0 ,0 ,5773 
United Republic of Tanzania,Jamhuri ya Muungano wa Tanzania,TZ,Geita,TZ25,Geita,TZ2501,Nyarugusu,TZ2501231,40588 ,20567 ,20021 ,40588 ,20567 ,0 ,0 ,0 ,20021 
United Republic of Tanzania,Jamhuri ya Muungano wa Tanzania,TZ,Geita,TZ25,Geita,TZ2501,Nyakamwaga,TZ2501241,19618 ,9897 ,9721 ,19618 ,9897 ,0 ,0 ,0 ,9721 
United Republic of Tanzania,Jamhuri ya Muungano wa Tanzania,TZ,Geita,TZ25,Geita,TZ2501,Lwamgasa,TZ2501251,29148 ,14479 ,14669 ,29148 ,14479 ,0 ,0 ,0 ,14669 
United Republic of Tanzania,Jamhuri ya Muungano wa Tanzania,TZ,Geita,TZ25,Geita,TZ2501,Kaseme,TZ2501261,24957 ,12404 ,12553 ,24957 ,12404 ,0 ,0 ,0 ,12553 
United Republic of Tanzania,Jamhuri ya Muungano wa Tanzania,TZ,Geita,TZ25,Geita,TZ2501,Busanda,TZ2501271,15490 ,7541 ,7949 ,15490 ,7541 ,0 ,0 ,0 ,7949 
United Republic of Tanzania,Jamhuri ya Muungano wa Tanzania,TZ,Geita,TZ25,Geita,TZ2501,Katoro,TZ2501283,70317 ,33553 ,36764 ,26174 ,12586 ,44143 ,20967 ,23176 ,13588 
United Republic of Tanzania,Jamhuri ya Muungano wa Tanzania,TZ,Geita,TZ25,Geita,TZ2501,Nyamigota,TZ2501291,16515 ,8076 ,8439 ,16515 ,8076 ,0 ,0 ,0 ,8439 
United Republic of Tanzania,Jamhuri ya Muungano wa Tanzania,TZ,Geita,TZ25,Geita,TZ2501,Nyakagomba,TZ2501301,19206 ,9689 ,9517 ,19206 ,9689 ,0 ,0 ,0 ,9517 
United Republic of Tanzania,Jamhuri ya Muungano wa Tanzania,TZ,Geita,TZ25,Geita,TZ2501,Nyachiluluma,TZ2501311,19898 ,10128 ,9770 ,19898 ,10128 ,0 ,0 ,0 ,9770 
United Republic of Tanzania,Jamhuri ya Muungano wa Tanzania,TZ,Geita,TZ25,Geita,TZ2501,Bukondo,TZ2501321,13371 ,6871 ,6500 ,13371 ,6871 ,0 ,0 ,0 ,6500 
United Republic of Tanzania,Jamhuri ya Muungano wa Tanzania,TZ,Geita,TZ25,Geita,TZ2501,Chigunga,TZ2501331,27456 ,13640 ,13816 ,27456 ,13640 ,0 ,0 ,0 ,13816 
United Republic of Tanzania,Jamhuri ya Muungano wa Tanzania,TZ,Geita,TZ25,Geita,TZ2501,Mtakuja,TZ2501341,25227 ,12963 ,12264 ,25227 ,12963 ,0 ,0 ,0 ,12264 
United Republic of Tanzania,Jamhuri ya Muungano wa Tanzania,TZ,Geita,TZ25,Geita,TZ2501,Kalangalala,TZ2501352,99795 ,48831 ,50964 ,0 ,0 ,99795 ,48831 ,50964 ,0 
United Republic of Tanzania,Jamhuri ya Muungano wa Tanzania,TZ,Geita,TZ25,Nyang'hwale,TZ2502,Shabaka,TZ2502011,14341 ,7256 ,7085 ,14341 ,7256 ,0 ,0 ,0 ,7085 
United Republic of Tanzania,Jamhuri ya Muungano wa Tanzania,TZ,Geita,TZ25,Nyang'hwale,TZ2502,Busolwa,TZ2502021,16894 ,8307 ,8587 ,16894 ,8307 ,0 ,0 ,0 ,8587 
United Republic of Tanzania,Jamhuri ya Muungano wa Tanzania,TZ,Geita,TZ25,Nyang'hwale,TZ2502,Kakura,TZ2502031,23248 ,11407 ,11841 ,23248 ,11407 ,0 ,0 ,0 ,11841 
United Republic of Tanzania,Jamhuri ya Muungano wa Tanzania,TZ,Geita,TZ25,Nyang'hwale,TZ2502,Nyugwa,TZ2502041,12742 ,6299 ,6443 ,12742 ,6299 ,0 ,0 ,0 ,6443 
United Republic of Tanzania,Jamhuri ya Muungano wa Tanzania,TZ,Geita,TZ25,Nyang'hwale,TZ2502,Bukwimba,TZ2502051,17335 ,8542 ,8793 ,17335 ,8542 ,0 ,0 ,0 ,8793 
United Republic of Tanzania,Jamhuri ya Muungano wa Tanzania,TZ,Geita,TZ25,Nyang'hwale,TZ2502,Kafita,TZ2502061,11846 ,5913 ,5933 ,11846 ,5913 ,0 ,0 ,0 ,5933 
United Republic of Tanzania,Jamhuri ya Muungano wa Tanzania,TZ,Geita,TZ25,Nyang'hwale,TZ2502,Kharumwa,TZ2502071,13480 ,6546 ,6934 ,13480 ,6546 ,0 ,0 ,0 ,6934 
United Republic of Tanzania,Jamhuri ya Muungano wa Tanzania,TZ,Geita,TZ25,Nyang'hwale,TZ2502,Izunya,TZ2502081,6521 ,3207 ,3314 ,6521 ,3207 ,0 ,0 ,0 ,3314 
United Republic of Tanzania,Jamhuri ya Muungano wa Tanzania,TZ,Geita,TZ25,Nyang'hwale,TZ2502,Mwingiro,TZ2502091,8382 ,4219 ,4163 ,8382 ,4219 ,0 ,0 ,0 ,4163 
United Republic of Tanzania,Jamhuri ya Muungano wa Tanzania,TZ,Geita,TZ25,Nyang'hwale,TZ2502,Nyabulanda,TZ2502101,9285 ,4626 ,4659 ,9285 ,4626 ,0 ,0 ,0 ,4659 
United Republic of Tanzania,Jamhuri ya Muungano wa Tanzania,TZ,Geita,TZ25,Nyang'hwale,TZ2502,Nyang'hwale,TZ2502111,9355 ,4600 ,4755 ,9355 ,4600 ,0 ,0 ,0 ,4755 
United Republic of Tanzania,Jamhuri ya Muungano wa Tanzania,TZ,Geita,TZ25,Nyang'hwale,TZ2502,Nyijundu,TZ2502121,12006 ,5815 ,6191 ,12006 ,5815 ,0 ,0 ,0 ,6191 
United Republic of Tanzania,Jamhuri ya Muungano wa Tanzania,TZ,Geita,TZ25,Mbogwe,TZ2503,Nanda,TZ2503011,7788 ,3852 ,3936 ,7788 ,3852 ,0 ,0 ,0 ,3936 
United Republic of Tanzania,Jamhuri ya Muungano wa Tanzania,TZ,Geita,TZ25,Mbogwe,TZ2503,Ikobe,TZ2503021,10350 ,4999 ,5351 ,10350 ,4999 ,0 ,0 ,0 ,5351 
United Republic of Tanzania,Jamhuri ya Muungano wa Tanzania,TZ,Geita,TZ25,Mbogwe,TZ2503,Lulembela,TZ2503031,18191 ,8727 ,9464 ,18191 ,8727 ,0 ,0 ,0 ,9464 
United Republic of Tanzania,Jamhuri ya Muungano wa Tanzania,TZ,Geita,TZ25,Mbogwe,TZ2503,Ikunguigazi,TZ2503041,8053 ,3948 ,4105 ,8053 ,3948 ,0 ,0 ,0 ,4105 
United Republic of Tanzania,Jamhuri ya Muungano wa Tanzania,TZ,Geita,TZ25,Mbogwe,TZ2503,Isebya,TZ2503051,9064 ,4581 ,4483 ,9064 ,4581 ,0 ,0 ,0 ,4483 
United Republic of Tanzania,Jamhuri ya Muungano wa Tanzania,TZ,Geita,TZ25,Mbogwe,TZ2503,Ilolangulu,TZ2503061,11703 ,5705 ,5998 ,11703 ,5705 ,0 ,0 ,0 ,5998 
United Republic of Tanzania,Jamhuri ya Muungano wa Tanzania,TZ,Geita,TZ25,Mbogwe,TZ2503,Mbogwe,TZ2503071,9935 ,4904 ,5031 ,9935 ,4904 ,0 ,0 ,0 ,5031 
United Republic of Tanzania,Jamhuri ya Muungano wa Tanzania,TZ,Geita,TZ25,Mbogwe,TZ2503,Mgemo,TZ2503081,9193 ,4428 ,4765 ,9193 ,4428 ,0 ,0 ,0 ,4765 
United Republic of Tanzania,Jamhuri ya Muungano wa Tanzania,TZ,Geita,TZ25,Mbogwe,TZ2503,Ushirika,TZ2503091,11622 ,5692 ,5930 ,11622 ,5692 ,0 ,0 ,0 ,5930 
United Republic of Tanzania,Jamhuri ya Muungano wa Tanzania,TZ,Geita,TZ25,Mbogwe,TZ2503,Nyasato,TZ2503101,11039 ,5437 ,5602 ,11039 ,5437 ,0 ,0 ,0 ,5602 
United Republic of Tanzania,Jamhuri ya Muungano wa Tanzania,TZ,Geita,TZ25,Mbogwe,TZ2503,Lugunga,TZ2503113,14982 ,7459 ,7523 ,12601 ,6289 ,2381 ,1170 ,1211 ,6312 
United Republic of Tanzania,Jamhuri ya Muungano wa Tanzania,TZ,Geita,TZ25,Mbogwe,TZ2503,Nyakafulu,TZ2503123,21900 ,10514 ,11386 ,17083 ,8254 ,4817 ,2260 ,2557 ,8829 
United Republic of Tanzania,Jamhuri ya Muungano wa Tanzania,TZ,Geita,TZ25,Mbogwe,TZ2503,Bukandwe,TZ2503131,11338 ,5576 ,5762 ,11338 ,5576 ,0 ,0 ,0 ,5762 
United Republic of Tanzania,Jamhuri ya Muungano wa Tanzania,TZ,Geita,TZ25,Mbogwe,TZ2503,Ng'homolwa,TZ2503141,6631 ,3281 ,3350 ,6631 ,3281 ,0 ,0 ,0 ,3350 
United Republic of Tanzania,Jamhuri ya Muungano wa Tanzania,TZ,Geita,TZ25,Mbogwe,TZ2503,Masumbwe,TZ2503153,18716 ,9315 ,9401 ,13474 ,6779 ,5242 ,2536 ,2706 ,6695 
United Republic of Tanzania,Jamhuri ya Muungano wa Tanzania,TZ,Geita,TZ25,Mbogwe,TZ2503,Iponya,TZ2503161,13417 ,6665 ,6752 ,13417 ,6665 ,0 ,0 ,0 ,6752 
United Republic of Tanzania,Jamhuri ya Muungano wa Tanzania,TZ,Geita,TZ25,Bukombe,TZ2504,Runzewe Mashariki,TZ2504011,16095 ,7949 ,8146 ,16095 ,7949 ,0 ,0 ,0 ,8146 
United Republic of Tanzania,Jamhuri ya Muungano wa Tanzania,TZ,Geita,TZ25,Bukombe,TZ2504,Runzewe Magharibi,TZ2504021,11990 ,5923 ,6067 ,11990 ,5923 ,0 ,0 ,0 ,6067 
United Republic of Tanzania,Jamhuri ya Muungano wa Tanzania,TZ,Geita,TZ25,Bukombe,TZ2504,Namonge,TZ2504031,30654 ,15303 ,15351 ,30654 ,15303 ,0 ,0 ,0 ,15351 
United Republic of Tanzania,Jamhuri ya Muungano wa Tanzania,TZ,Geita,TZ25,Bukombe,TZ2504,Uyovu,TZ2504043,29909 ,14763 ,15146 ,18953 ,9310 ,10956 ,5453 ,5503 ,9643 
United Republic of Tanzania,Jamhuri ya Muungano wa Tanzania,TZ,Geita,TZ25,Bukombe,TZ2504,Busonzo,TZ2504051,10296 ,5246 ,5050 ,10296 ,5246 ,0 ,0 ,0 ,5050 
United Republic of Tanzania,Jamhuri ya Muungano wa Tanzania,TZ,Geita,TZ25,Bukombe,TZ2504,Ng'anzo,TZ2504061,22442 ,11105 ,11337 ,22442 ,11105 ,0 ,0 ,0 ,11337 
United Republic of Tanzania,Jamhuri ya Muungano wa Tanzania,TZ,Geita,TZ25,Bukombe,TZ2504,Butinzya,TZ2504071,18107 ,9007 ,9100 ,18107 ,9007 ,0 ,0 ,0 ,9100 
United Republic of Tanzania,Jamhuri ya Muungano wa Tanzania,TZ,Geita,TZ25,Bukombe,TZ2504,Ushirombo,TZ2504081,6040 ,3024 ,3016 ,6040 ,3024 ,0 ,0 ,0 ,3016 
United Republic of Tanzania,Jamhuri ya Muungano wa Tanzania,TZ,Geita,TZ25,Bukombe,TZ2504,Lyambamgongo,TZ2504091,6314 ,3181 ,3133 ,6314 ,3181 ,0 ,0 ,0 ,3133 
United Republic of Tanzania,Jamhuri ya Muungano wa Tanzania,TZ,Geita,TZ25,Bukombe,TZ2504,Bukombe,TZ2504101,11706 ,5700 ,6006 ,11706 ,5700 ,0 ,0 ,0 ,6006 
United Republic of Tanzania,Jamhuri ya Muungano wa Tanzania,TZ,Geita,TZ25,Bukombe,TZ2504,Bugelenga,TZ2504111,8463 ,4216 ,4247 ,8463 ,4216 ,0 ,0 ,0 ,4247 
United Republic of Tanzania,Jamhuri ya Muungano wa Tanzania,TZ,Geita,TZ25,Bukombe,TZ2504,Iyogelo,TZ2504121,7910 ,3923 ,3987 ,7910 ,3923 ,0 ,0 ,0 ,3987 
United Republic of Tanzania,Jamhuri ya Muungano wa Tanzania,TZ,Geita,TZ25,Bukombe,TZ2504,Igulwa,TZ2504133,44616 ,21517 ,23099 ,8797 ,4304 ,35819 ,17213 ,18606 ,4493 
United Republic of Tanzania,Jamhuri ya Muungano wa Tanzania,TZ,Geita,TZ25,Chato,TZ2505,Muganza,TZ2505013,27245 ,13099 ,14146 ,21212 ,10232 ,6033 ,2867 ,3166 ,10980 
United Republic of Tanzania,Jamhuri ya Muungano wa Tanzania,TZ,Geita,TZ25,Chato,TZ2505,Bwongera,TZ2505021,11395 ,5807 ,5588 ,11395 ,5807 ,0 ,0 ,0 ,5588 
United Republic of Tanzania,Jamhuri ya Muungano wa Tanzania,TZ,Geita,TZ25,Chato,TZ2505,Kigongo,TZ2505031,23718 ,11873 ,11845 ,23718 ,11873 ,0 ,0 ,0 ,11845 
United Republic of Tanzania,Jamhuri ya Muungano wa Tanzania,TZ,Geita,TZ25,Chato,TZ2505,Nyamirembe,TZ2505041,15643 ,7874 ,7769 ,15643 ,7874 ,0 ,0 ,0 ,7769 
United Republic of Tanzania,Jamhuri ya Muungano wa Tanzania,TZ,Geita,TZ25,Chato,TZ2505,Ichwankima,TZ2505051,7307 ,3672 ,3635 ,7307 ,3672 ,0 ,0 ,0 ,3635 
United Republic of Tanzania,Jamhuri ya Muungano wa Tanzania,TZ,Geita,TZ25,Chato,TZ2505,Kachwamba,TZ2505061,6996 ,3532 ,3464 ,6996 ,3532 ,0 ,0 ,0 ,3464 
United Republic of Tanzania,Jamhuri ya Muungano wa Tanzania,TZ,Geita,TZ25,Chato,TZ2505,Kasenga,TZ2505071,16863 ,8470 ,8393 ,16863 ,8470 ,0 ,0 ,0 ,8393 
United Republic of Tanzania,Jamhuri ya Muungano wa Tanzania,TZ,Geita,TZ25,Chato,TZ2505,Ilemela,TZ2505081,9099 ,4615 ,4484 ,9099 ,4615 ,0 ,0 ,0 ,4484 
United Republic of Tanzania,Jamhuri ya Muungano wa Tanzania,TZ,Geita,TZ25,Chato,TZ2505,Chato,TZ2505093,17508 ,8343 ,9165 ,8287 ,3993 ,9221 ,4350 ,4871 ,4294 
United Republic of Tanzania,Jamhuri ya Muungano wa Tanzania,TZ,Geita,TZ25,Chato,TZ2505,Muungano,TZ2505103,12816 ,6278 ,6538 ,9146 ,4568 ,3670 ,1710 ,1960 ,4578 
United Republic of Tanzania,Jamhuri ya Muungano wa Tanzania,TZ,Geita,TZ25,Chato,TZ2505,Bwina,TZ2505113,8422 ,4209 ,4213 ,2978 ,1451 ,5444 ,2758 ,2686 ,1527 
United Republic of Tanzania,Jamhuri ya Muungano wa Tanzania,TZ,Geita,TZ25,Chato,TZ2505,Katende,TZ2505121,4139 ,2029 ,2110 ,4139 ,2029 ,0 ,0 ,0 ,2110 
United Republic of Tanzania,Jamhuri ya Muungano wa Tanzania,TZ,Geita,TZ25,Chato,TZ2505,Ilyamchele,TZ2505131,5966 ,2912 ,3054 ,5966 ,2912 ,0 ,0 ,0 ,3054 
United Republic of Tanzania,Jamhuri ya Muungano wa Tanzania,TZ,Geita,TZ25,Chato,TZ2505,Bukome,TZ2505141,16933 ,8574 ,8359 ,16933 ,8574 ,0 ,0 ,0 ,8359 
United Republic of Tanzania,Jamhuri ya Muungano wa Tanzania,TZ,Geita,TZ25,Chato,TZ2505,Buziku,TZ2505153,15757 ,7786 ,7971 ,7080 ,3516 ,8677 ,4270 ,4407 ,3564 
United Republic of Tanzania,Jamhuri ya Muungano wa Tanzania,TZ,Geita,TZ25,Chato,TZ2505,Nyarutembo,TZ2505161,16619 ,8227 ,8392 ,16619 ,8227 ,0 ,0 ,0 ,8392 
United Republic of Tanzania,Jamhuri ya Muungano wa Tanzania,TZ,Geita,TZ25,Chato,TZ2505,Makurugusi,TZ2505171,28772 ,14411 ,14361 ,28772 ,14411 ,0 ,0 ,0 ,14361 
United Republic of Tanzania,Jamhuri ya Muungano wa Tanzania,TZ,Geita,TZ25,Chato,TZ2505,Buseresere,TZ2505183,29055 ,14249 ,14806 ,17777 ,8860 ,11278 ,5389 ,5889 ,8917 
United Republic of Tanzania,Jamhuri ya Muungano wa Tanzania,TZ,Geita,TZ25,Chato,TZ2505,Butengorumasa,TZ2505191,14036 ,7002 ,7034 ,14036 ,7002 ,0 ,0 ,0 ,7034 
United Republic of Tanzania,Jamhuri ya Muungano wa Tanzania,TZ,Geita,TZ25,Chato,TZ2505,Iparamasa,TZ2505201,30378 ,15146 ,15232 ,30378 ,15146 ,0 ,0 ,0 ,15232 
United Republic of Tanzania,Jamhuri ya Muungano wa Tanzania,TZ,Geita,TZ25,Chato,TZ2505,Bwanga,TZ2505213,36763 ,18449 ,18314 ,28643 ,14531 ,8120 ,3918 ,4202 ,14112 
United Republic of Tanzania,Jamhuri ya Muungano wa Tanzania,TZ,Geita,TZ25,Chato,TZ2505,Bwera,TZ2505221,9697 ,4811 ,4886 ,9697 ,4811 ,0 ,0 ,0 ,4886 
United Republic of Tanzania,Jamhuri ya Muungano wa Tanzania,TZ,Songwe,TZ26,Songwe,TZ2601,Kanga,TZ2601131,9430 ,4549 ,4881 ,9430 ,4549 ,0 ,0 ,0 ,4881 
United Republic of Tanzania,Jamhuri ya Muungano wa Tanzania,TZ,Songwe,TZ26,Songwe,TZ2601,Galula,TZ2601141,8440 ,4135 ,4305 ,8440 ,4135 ,0 ,0 ,0 ,4305 
United Republic of Tanzania,Jamhuri ya Muungano wa Tanzania,TZ,Songwe,TZ26,Songwe,TZ2601,Mbuyuni,TZ2601151,17318 ,8334 ,8984 ,17318 ,8334 ,0 ,0 ,0 ,8984 
United Republic of Tanzania,Jamhuri ya Muungano wa Tanzania,TZ,Songwe,TZ26,Songwe,TZ2601,Totowe,TZ2601161,11643 ,5544 ,6099 ,11643 ,5544 ,0 ,0 ,0 ,6099 
United Republic of Tanzania,Jamhuri ya Muungano wa Tanzania,TZ,Songwe,TZ26,Songwe,TZ2601,Namkukwe,TZ2601171,14323 ,6907 ,7416 ,14323 ,6907 ,0 ,0 ,0 ,7416 
United Republic of Tanzania,Jamhuri ya Muungano wa Tanzania,TZ,Songwe,TZ26,Songwe,TZ2601,Mkwajuni,TZ2601183,15292 ,7329 ,7963 ,3303 ,1649 ,11989 ,5680 ,6309 ,1654 
United Republic of Tanzania,Jamhuri ya Muungano wa Tanzania,TZ,Songwe,TZ26,Songwe,TZ2601,Mbangala,TZ2601191,5622 ,3023 ,2599 ,5622 ,3023 ,0 ,0 ,0 ,2599 
United Republic of Tanzania,Jamhuri ya Muungano wa Tanzania,TZ,Songwe,TZ26,Songwe,TZ2601,Kapalala,TZ2601201,8089 ,4177 ,3912 ,8089 ,4177 ,0 ,0 ,0 ,3912 
United Republic of Tanzania,Jamhuri ya Muungano wa Tanzania,TZ,Songwe,TZ26,Songwe,TZ2601,Gua,TZ2601211,6533 ,3414 ,3119 ,6533 ,3414 ,0 ,0 ,0 ,3119 
United Republic of Tanzania,Jamhuri ya Muungano wa Tanzania,TZ,Songwe,TZ26,Songwe,TZ2601,Ngwala,TZ2601221,3017 ,1653 ,1364 ,3017 ,1653 ,0 ,0 ,0 ,1364 
United Republic of Tanzania,Jamhuri ya Muungano wa Tanzania,TZ,Songwe,TZ26,Songwe,TZ2601,Ifyenkenya,TZ2601241,7876 ,3835 ,4041 ,7876 ,3835 ,0 ,0 ,0 ,4041 
United Republic of Tanzania,Jamhuri ya Muungano wa Tanzania,TZ,Songwe,TZ26,Songwe,TZ2601,Magamba,TZ2601251,10489 ,5055 ,5434 ,10489 ,5055 ,0 ,0 ,0 ,5434 
United Republic of Tanzania,Jamhuri ya Muungano wa Tanzania,TZ,Songwe,TZ26,Songwe,TZ2601,Saza,TZ2601261,6708 ,3671 ,3037 ,6708 ,3671 ,0 ,0 ,0 ,3037 
United Republic of Tanzania,Jamhuri ya Muungano wa Tanzania,TZ,Songwe,TZ26,Songwe,TZ2601,Mwambani,TZ2601271,8912 ,4463 ,4449 ,8912 ,4463 ,0 ,0 ,0 ,4449 
United Republic of Tanzania,Jamhuri ya Muungano wa Tanzania,TZ,Songwe,TZ26,Ileje,TZ2605,Itumba,TZ2605013,10186 ,4688 ,5498 ,5789 ,2677 ,4397 ,2011 ,2386 ,3112 
United Republic of Tanzania,Jamhuri ya Muungano wa Tanzania,TZ,Songwe,TZ26,Ileje,TZ2605,Itale,TZ2605021,7609 ,3542 ,4067 ,7609 ,3542 ,0 ,0 ,0 ,4067 
United Republic of Tanzania,Jamhuri ya Muungano wa Tanzania,TZ,Songwe,TZ26,Ileje,TZ2605,Ibaba,TZ2605031,8058 ,3686 ,4372 ,8058 ,3686 ,0 ,0 ,0 ,4372 
United Republic of Tanzania,Jamhuri ya Muungano wa Tanzania,TZ,Songwe,TZ26,Ileje,TZ2605,Ndola,TZ2605041,6820 ,3175 ,3645 ,6820 ,3175 ,0 ,0 ,0 ,3645 
United Republic of Tanzania,Jamhuri ya Muungano wa Tanzania,TZ,Songwe,TZ26,Ileje,TZ2605,Luswisi,TZ2605051,4632 ,2175 ,2457 ,4632 ,2175 ,0 ,0 ,0 ,2457 
United Republic of Tanzania,Jamhuri ya Muungano wa Tanzania,TZ,Songwe,TZ26,Ileje,TZ2605,Ngulilo,TZ2605061,4659 ,2232 ,2427 ,4659 ,2232 ,0 ,0 ,0 ,2427 
United Republic of Tanzania,Jamhuri ya Muungano wa Tanzania,TZ,Songwe,TZ26,Ileje,TZ2605,Lubanda,TZ2605071,8582 ,4071 ,4511 ,8582 ,4071 ,0 ,0 ,0 ,4511 
United Republic of Tanzania,Jamhuri ya Muungano wa Tanzania,TZ,Songwe,TZ26,Ileje,TZ2605,Ngulugulu,TZ2605081,4927 ,2434 ,2493 ,4927 ,2434 ,0 ,0 ,0 ,2493 
United Republic of Tanzania,Jamhuri ya Muungano wa Tanzania,TZ,Songwe,TZ26,Ileje,TZ2605,Sange,TZ2605091,4757 ,2296 ,2461 ,4757 ,2296 ,0 ,0 ,0 ,2461 
United Republic of Tanzania,Jamhuri ya Muungano wa Tanzania,TZ,Songwe,TZ26,Ileje,TZ2605,Ikinga,TZ2605101,7824 ,3694 ,4130 ,7824 ,3694 ,0 ,0 ,0 ,4130 
United Republic of Tanzania,Jamhuri ya Muungano wa Tanzania,TZ,Songwe,TZ26,Ileje,TZ2605,Kafule,TZ2605111,7450 ,3432 ,4018 ,7450 ,3432 ,0 ,0 ,0 ,4018 
United Republic of Tanzania,Jamhuri ya Muungano wa Tanzania,TZ,Songwe,TZ26,Ileje,TZ2605,Malangali,TZ2605121,6485 ,3037 ,3448 ,6485 ,3037 ,0 ,0 ,0 ,3448 
United Republic of Tanzania,Jamhuri ya Muungano wa Tanzania,TZ,Songwe,TZ26,Ileje,TZ2605,Bupigu,TZ2605131,6145 ,2935 ,3210 ,6145 ,2935 ,0 ,0 ,0 ,3210 
United Republic of Tanzania,Jamhuri ya Muungano wa Tanzania,TZ,Songwe,TZ26,Ileje,TZ2605,Isongole,TZ2605143,9893 ,4650 ,5243 ,4336 ,2055 ,5557 ,2595 ,2962 ,2281 
United Republic of Tanzania,Jamhuri ya Muungano wa Tanzania,TZ,Songwe,TZ26,Ileje,TZ2605,Chitete,TZ2605151,8673 ,4052 ,4621 ,8673 ,4052 ,0 ,0 ,0 ,4621 
United Republic of Tanzania,Jamhuri ya Muungano wa Tanzania,TZ,Songwe,TZ26,Ileje,TZ2605,Mbebe,TZ2605161,9282 ,4426 ,4856 ,9282 ,4426 ,0 ,0 ,0 ,4856 
United Republic of Tanzania,Jamhuri ya Muungano wa Tanzania,TZ,Songwe,TZ26,Ileje,TZ2605,Mlale,TZ2605171,4896 ,2256 ,2640 ,4896 ,2256 ,0 ,0 ,0 ,2640 
United Republic of Tanzania,Jamhuri ya Muungano wa Tanzania,TZ,Songwe,TZ26,Ileje,TZ2605,Kalembo,TZ2605181,3573 ,1682 ,1891 ,3573 ,1682 ,0 ,0 ,0 ,1891 
United Republic of Tanzania,Jamhuri ya Muungano wa Tanzania,TZ,Songwe,TZ26,Mbozi,TZ2606,Ihanda,TZ2606011,21355 ,10088 ,11267 ,21355 ,10088 ,0 ,0 ,0 ,11267 
United Republic of Tanzania,Jamhuri ya Muungano wa Tanzania,TZ,Songwe,TZ26,Mbozi,TZ2606,Bara,TZ2606021,20106 ,9591 ,10515 ,20106 ,9591 ,0 ,0 ,0 ,10515 
United Republic of Tanzania,Jamhuri ya Muungano wa Tanzania,TZ,Songwe,TZ26,Mbozi,TZ2606,Nanyala,TZ2606031,8914 ,4149 ,4765 ,8914 ,4149 ,0 ,0 ,0 ,4765 
United Republic of Tanzania,Jamhuri ya Muungano wa Tanzania,TZ,Songwe,TZ26,Mbozi,TZ2606,Nambinzo,TZ2606041,25951 ,12610 ,13341 ,25951 ,12610 ,0 ,0 ,0 ,13341 
United Republic of Tanzania,Jamhuri ya Muungano wa Tanzania,TZ,Songwe,TZ26,Mbozi,TZ2606,Itaka,TZ2606051,21032 ,10264 ,10768 ,21032 ,10264 ,0 ,0 ,0 ,10768 
United Republic of Tanzania,Jamhuri ya Muungano wa Tanzania,TZ,Songwe,TZ26,Mbozi,TZ2606,Isansa,TZ2606061,42891 ,20464 ,22427 ,42891 ,20464 ,0 ,0 ,0 ,22427 
United Republic of Tanzania,Jamhuri ya Muungano wa Tanzania,TZ,Songwe,TZ26,Mbozi,TZ2606,Ruanda,TZ2606071,8604 ,4136 ,4468 ,8604 ,4136 ,0 ,0 ,0 ,4468 
United Republic of Tanzania,Jamhuri ya Muungano wa Tanzania,TZ,Songwe,TZ26,Mbozi,TZ2606,Iyula,TZ2606081,30784 ,14766 ,16018 ,30784 ,14766 ,0 ,0 ,0 ,16018 
United Republic of Tanzania,Jamhuri ya Muungano wa Tanzania,TZ,Songwe,TZ26,Mbozi,TZ2606,Nyambili,TZ2606091,23903 ,11485 ,12418 ,23903 ,11485 ,0 ,0 ,0 ,12418 
United Republic of Tanzania,Jamhuri ya Muungano wa Tanzania,TZ,Songwe,TZ26,Mbozi,TZ2606,Mlangali,TZ2606101,19539 ,9459 ,10080 ,19539 ,9459 ,0 ,0 ,0 ,10080 
United Republic of Tanzania,Jamhuri ya Muungano wa Tanzania,TZ,Songwe,TZ26,Mbozi,TZ2606,Myovizi,TZ2606111,15738 ,7591 ,8147 ,15738 ,7591 ,0 ,0 ,0 ,8147 
United Republic of Tanzania,Jamhuri ya Muungano wa Tanzania,TZ,Songwe,TZ26,Mbozi,TZ2606,Igamba,TZ2606121,34822 ,16569 ,18253 ,34822 ,16569 ,0 ,0 ,0 ,18253 
United Republic of Tanzania,Jamhuri ya Muungano wa Tanzania,TZ,Songwe,TZ26,Mbozi,TZ2606,Halungu,TZ2606131,27151 ,13023 ,14128 ,27151 ,13023 ,0 ,0 ,0 ,14128 
United Republic of Tanzania,Jamhuri ya Muungano wa Tanzania,TZ,Songwe,TZ26,Mbozi,TZ2606,Msia,TZ2606141,27361 ,13319 ,14042 ,27361 ,13319 ,0 ,0 ,0 ,14042 
United Republic of Tanzania,Jamhuri ya Muungano wa Tanzania,TZ,Songwe,TZ26,Mbozi,TZ2606,Mlowo,TZ2606153,38016 ,17978 ,20038 ,16416 ,7834 ,21600 ,10144 ,11456 ,8582 
United Republic of Tanzania,Jamhuri ya Muungano wa Tanzania,TZ,Songwe,TZ26,Mbozi,TZ2606,Ipunga,TZ2606161,9367 ,4401 ,4966 ,9367 ,4401 ,0 ,0 ,0 ,4966 
United Republic of Tanzania,Jamhuri ya Muungano wa Tanzania,TZ,Songwe,TZ26,Mbozi,TZ2606,Isandula,TZ2606171,14549 ,6952 ,7597 ,14549 ,6952 ,0 ,0 ,0 ,7597 
United Republic of Tanzania,Jamhuri ya Muungano wa Tanzania,TZ,Songwe,TZ26,Mbozi,TZ2606,Vwawa,TZ2606182,56256 ,26372 ,29884 ,0 ,0 ,56256 ,26372 ,29884 ,0 
United Republic of Tanzania,Jamhuri ya Muungano wa Tanzania,TZ,Songwe,TZ26,Momba,TZ2609,Chilulumo,TZ2609011,11177 ,5281 ,5896 ,11177 ,5281 ,0 ,0 ,0 ,5896 
United Republic of Tanzania,Jamhuri ya Muungano wa Tanzania,TZ,Songwe,TZ26,Momba,TZ2609,Kamsamba,TZ2609021,17055 ,8297 ,8758 ,17055 ,8297 ,0 ,0 ,0 ,8758 
United Republic of Tanzania,Jamhuri ya Muungano wa Tanzania,TZ,Songwe,TZ26,Momba,TZ2609,Ivuna,TZ2609031,31254 ,14883 ,16371 ,31254 ,14883 ,0 ,0 ,0 ,16371 
United Republic of Tanzania,Jamhuri ya Muungano wa Tanzania,TZ,Songwe,TZ26,Momba,TZ2609,Mpapa,TZ2609041,6512 ,3024 ,3488 ,6512 ,3024 ,0 ,0 ,0 ,3488 
United Republic of Tanzania,Jamhuri ya Muungano wa Tanzania,TZ,Songwe,TZ26,Momba,TZ2609,Mkulwe,TZ2609051,9337 ,4517 ,4820 ,9337 ,4517 ,0 ,0 ,0 ,4820 
United Republic of Tanzania,Jamhuri ya Muungano wa Tanzania,TZ,Songwe,TZ26,Momba,TZ2609,Chitete,TZ2609061,19431 ,9292 ,10139 ,19431 ,9292 ,0 ,0 ,0 ,10139 
United Republic of Tanzania,Jamhuri ya Muungano wa Tanzania,TZ,Songwe,TZ26,Momba,TZ2609,Msangano,TZ2609071,15770 ,7689 ,8081 ,15770 ,7689 ,0 ,0 ,0 ,8081 
United Republic of Tanzania,Jamhuri ya Muungano wa Tanzania,TZ,Songwe,TZ26,Momba,TZ2609,Chiwezi,TZ2609083,25060 ,12006 ,13054 ,10884 ,5264 ,14176 ,6742 ,7434 ,5620 
United Republic of Tanzania,Jamhuri ya Muungano wa Tanzania,TZ,Songwe,TZ26,Momba,TZ2609,Nkangamo,TZ2609091,12996 ,6235 ,6761 ,12996 ,6235 ,0 ,0 ,0 ,6761 
United Republic of Tanzania,Jamhuri ya Muungano wa Tanzania,TZ,Songwe,TZ26,Momba,TZ2609,Ndalembo,TZ2609101,11693 ,5532 ,6161 ,11693 ,5532 ,0 ,0 ,0 ,6161 
United Republic of Tanzania,Jamhuri ya Muungano wa Tanzania,TZ,Songwe,TZ26,Momba,TZ2609,Kapele,TZ2609111,11690 ,5594 ,6096 ,11690 ,5594 ,0 ,0 ,0 ,6096 
United Republic of Tanzania,Jamhuri ya Muungano wa Tanzania,TZ,Songwe,TZ26,Momba,TZ2609,Nzoka,TZ2609121,13252 ,6276 ,6976 ,13252 ,6276 ,0 ,0 ,0 ,6976 
United Republic of Tanzania,Jamhuri ya Muungano wa Tanzania,TZ,Songwe,TZ26,Momba,TZ2609,Myunga,TZ2609131,11591 ,5631 ,5960 ,11591 ,5631 ,0 ,0 ,0 ,5960 
United Republic of Tanzania,Jamhuri ya Muungano wa Tanzania,TZ,Songwe,TZ26,Tunduma,TZ2610,Tunduma,TZ2610012,97562 ,46854 ,50708 ,0 ,0 ,97562 ,46854 ,50708 ,0 
United Republic of Tanzania,Jamhuri ya Muungano wa Tanzania,TZ,Kaskazini Unguja,TZ51,Kaskazini A,TZ5101,Mkokotoni,TZ5101013,2803 ,1400 ,1403 ,1842 ,919 ,961 ,481 ,480 ,923 
United Republic of Tanzania,Jamhuri ya Muungano wa Tanzania,TZ,Kaskazini Unguja,TZ51,Kaskazini A,TZ5101,Mto wa Pwani,TZ5101021,1074 ,516 ,558 ,1074 ,516 ,0 ,0 ,0 ,558 
United Republic of Tanzania,Jamhuri ya Muungano wa Tanzania,TZ,Kaskazini Unguja,TZ51,Kaskazini A,TZ5101,Pale,TZ5101031,1216 ,616 ,600 ,1216 ,616 ,0 ,0 ,0 ,600 
United Republic of Tanzania,Jamhuri ya Muungano wa Tanzania,TZ,Kaskazini Unguja,TZ51,Kaskazini A,TZ5101,Kivunge,TZ5101041,4199 ,2012 ,2187 ,4199 ,2012 ,0 ,0 ,0 ,2187 
United Republic of Tanzania,Jamhuri ya Muungano wa Tanzania,TZ,Kaskazini Unguja,TZ51,Kaskazini A,TZ5101,Tumbatu Gomani,TZ5101051,4990 ,2412 ,2578 ,4990 ,2412 ,0 ,0 ,0 ,2578 
United Republic of Tanzania,Jamhuri ya Muungano wa Tanzania,TZ,Kaskazini Unguja,TZ51,Kaskazini A,TZ5101,Jongowe,TZ5101061,3262 ,1482 ,1780 ,3262 ,1482 ,0 ,0 ,0 ,1780 
United Republic of Tanzania,Jamhuri ya Muungano wa Tanzania,TZ,Kaskazini Unguja,TZ51,Kaskazini A,TZ5101,Mkwajuni,TZ5101071,3509 ,1651 ,1858 ,3509 ,1651 ,0 ,0 ,0 ,1858 
United Republic of Tanzania,Jamhuri ya Muungano wa Tanzania,TZ,Kaskazini Unguja,TZ51,Kaskazini A,TZ5101,Kibeni,TZ5101081,2799 ,1345 ,1454 ,2799 ,1345 ,0 ,0 ,0 ,1454 
United Republic of Tanzania,Jamhuri ya Muungano wa Tanzania,TZ,Kaskazini Unguja,TZ51,Kaskazini A,TZ5101,Muwange,TZ5101091,2022 ,998 ,1024 ,2022 ,998 ,0 ,0 ,0 ,1024 
United Republic of Tanzania,Jamhuri ya Muungano wa Tanzania,TZ,Kaskazini Unguja,TZ51,Kaskazini A,TZ5101,Pitanazako,TZ5101101,4027 ,1945 ,2082 ,4027 ,1945 ,0 ,0 ,0 ,2082 
United Republic of Tanzania,Jamhuri ya Muungano wa Tanzania,TZ,Kaskazini Unguja,TZ51,Kaskazini A,TZ5101,Potowa,TZ5101111,2326 ,1112 ,1214 ,2326 ,1112 ,0 ,0 ,0 ,1214 
United Republic of Tanzania,Jamhuri ya Muungano wa Tanzania,TZ,Kaskazini Unguja,TZ51,Kaskazini A,TZ5101,Fukuchani,TZ5101121,2208 ,1062 ,1146 ,2208 ,1062 ,0 ,0 ,0 ,1146 
United Republic of Tanzania,Jamhuri ya Muungano wa Tanzania,TZ,Kaskazini Unguja,TZ51,Kaskazini A,TZ5101,Kidoti,TZ5101131,2973 ,1436 ,1537 ,2973 ,1436 ,0 ,0 ,0 ,1537 
United Republic of Tanzania,Jamhuri ya Muungano wa Tanzania,TZ,Kaskazini Unguja,TZ51,Kaskazini A,TZ5101,Tazari,TZ5101141,3084 ,1530 ,1554 ,3084 ,1530 ,0 ,0 ,0 ,1554 
United Republic of Tanzania,Jamhuri ya Muungano wa Tanzania,TZ,Kaskazini Unguja,TZ51,Kaskazini A,TZ5101,Kigunda,TZ5101151,1813 ,872 ,941 ,1813 ,872 ,0 ,0 ,0 ,941 
United Republic of Tanzania,Jamhuri ya Muungano wa Tanzania,TZ,Kaskazini Unguja,TZ51,Kaskazini A,TZ5101,Nungwi,TZ5101162,10392 ,5113 ,5279 ,0 ,0 ,10392 ,5113 ,5279 ,0 
United Republic of Tanzania,Jamhuri ya Muungano wa Tanzania,TZ,Kaskazini Unguja,TZ51,Kaskazini A,TZ5101,Matemwe,TZ5101171,5014 ,2502 ,2512 ,5014 ,2502 ,0 ,0 ,0 ,2512 
United Republic of Tanzania,Jamhuri ya Muungano wa Tanzania,TZ,Kaskazini Unguja,TZ51,Kaskazini A,TZ5101,Kijini,TZ5101181,3369 ,1670 ,1699 ,3369 ,1670 ,0 ,0 ,0 ,1699 
United Republic of Tanzania,Jamhuri ya Muungano wa Tanzania,TZ,Kaskazini Unguja,TZ51,Kaskazini A,TZ5101,Pwani Mchangani,TZ5101191,3441 ,1740 ,1701 ,3441 ,1740 ,0 ,0 ,0 ,1701 
United Republic of Tanzania,Jamhuri ya Muungano wa Tanzania,TZ,Kaskazini Unguja,TZ51,Kaskazini A,TZ5101,Gamba,TZ5101203,3401 ,1594 ,1807 ,2561 ,1217 ,840 ,377 ,463 ,1344 
United Republic of Tanzania,Jamhuri ya Muungano wa Tanzania,TZ,Kaskazini Unguja,TZ51,Kaskazini A,TZ5101,Moga,TZ5101211,2089 ,995 ,1094 ,2089 ,995 ,0 ,0 ,0 ,1094 
United Republic of Tanzania,Jamhuri ya Muungano wa Tanzania,TZ,Kaskazini Unguja,TZ51,Kaskazini A,TZ5101,Chaani Masingini,TZ5101221,4562 ,2247 ,2315 ,4562 ,2247 ,0 ,0 ,0 ,2315 
United Republic of Tanzania,Jamhuri ya Muungano wa Tanzania,TZ,Kaskazini Unguja,TZ51,Kaskazini A,TZ5101,Mcheza Shauri,TZ5101231,917 ,443 ,474 ,917 ,443 ,0 ,0 ,0 ,474 
United Republic of Tanzania,Jamhuri ya Muungano wa Tanzania,TZ,Kaskazini Unguja,TZ51,Kaskazini A,TZ5101,Chaani Kubwa,TZ5101241,3030 ,1477 ,1553 ,3030 ,1477 ,0 ,0 ,0 ,1553 
United Republic of Tanzania,Jamhuri ya Muungano wa Tanzania,TZ,Kaskazini Unguja,TZ51,Kaskazini A,TZ5101,Kikobweni,TZ5101251,2757 ,1356 ,1401 ,2757 ,1356 ,0 ,0 ,0 ,1401 
United Republic of Tanzania,Jamhuri ya Muungano wa Tanzania,TZ,Kaskazini Unguja,TZ51,Kaskazini A,TZ5101,Bandamaji,TZ5101261,1616 ,783 ,833 ,1616 ,783 ,0 ,0 ,0 ,833 
United Republic of Tanzania,Jamhuri ya Muungano wa Tanzania,TZ,Kaskazini Unguja,TZ51,Kaskazini A,TZ5101,Kinyasini,TZ5101271,3311 ,1589 ,1722 ,3311 ,1589 ,0 ,0 ,0 ,1722 
United Republic of Tanzania,Jamhuri ya Muungano wa Tanzania,TZ,Kaskazini Unguja,TZ51,Kaskazini A,TZ5101,Kandwi,TZ5101281,1741 ,882 ,859 ,1741 ,882 ,0 ,0 ,0 ,859 
United Republic of Tanzania,Jamhuri ya Muungano wa Tanzania,TZ,Kaskazini Unguja,TZ51,Kaskazini A,TZ5101,Chutama,TZ5101291,1638 ,823 ,815 ,1638 ,823 ,0 ,0 ,0 ,815 
United Republic of Tanzania,Jamhuri ya Muungano wa Tanzania,TZ,Kaskazini Unguja,TZ51,Kaskazini A,TZ5101,Kisongoni,TZ5101301,1539 ,747 ,792 ,1539 ,747 ,0 ,0 ,0 ,792 
United Republic of Tanzania,Jamhuri ya Muungano wa Tanzania,TZ,Kaskazini Unguja,TZ51,Kaskazini A,TZ5101,Kilindi,TZ5101311,1186 ,580 ,606 ,1186 ,580 ,0 ,0 ,0 ,606 
United Republic of Tanzania,Jamhuri ya Muungano wa Tanzania,TZ,Kaskazini Unguja,TZ51,Kaskazini A,TZ5101,Kilimani,TZ5101321,2590 ,1266 ,1324 ,2590 ,1266 ,0 ,0 ,0 ,1324 
United Republic of Tanzania,Jamhuri ya Muungano wa Tanzania,TZ,Kaskazini Unguja,TZ51,Kaskazini A,TZ5101,Uvivini,TZ5101331,4136 ,2015 ,2121 ,4136 ,2015 ,0 ,0 ,0 ,2121 
United Republic of Tanzania,Jamhuri ya Muungano wa Tanzania,TZ,Kaskazini Unguja,TZ51,Kaskazini A,TZ5101,Kidombo,TZ5101341,3147 ,1589 ,1558 ,3147 ,1589 ,0 ,0 ,0 ,1558 
United Republic of Tanzania,Jamhuri ya Muungano wa Tanzania,TZ,Kaskazini Unguja,TZ51,Kaskazini A,TZ5101,Bwereu,TZ5101351,1616 ,778 ,838 ,1616 ,778 ,0 ,0 ,0 ,838 
United Republic of Tanzania,Jamhuri ya Muungano wa Tanzania,TZ,Kaskazini Unguja,TZ51,Kaskazini A,TZ5101,Kigomani,TZ5101361,1983 ,988 ,995 ,1983 ,988 ,0 ,0 ,0 ,995 
United Republic of Tanzania,Jamhuri ya Muungano wa Tanzania,TZ,Kaskazini Unguja,TZ51,Kaskazini B,TZ5102,Misufini,TZ5102011,7986 ,3920 ,4066 ,7986 ,3920 ,0 ,0 ,0 ,4066 
United Republic of Tanzania,Jamhuri ya Muungano wa Tanzania,TZ,Kaskazini Unguja,TZ51,Kaskazini B,TZ5102,Makoba,TZ5102021,3477 ,1725 ,1752 ,3477 ,1725 ,0 ,0 ,0 ,1752 
United Republic of Tanzania,Jamhuri ya Muungano wa Tanzania,TZ,Kaskazini Unguja,TZ51,Kaskazini B,TZ5102,Mangapwani,TZ5102031,2246 ,1145 ,1101 ,2246 ,1145 ,0 ,0 ,0 ,1101 
United Republic of Tanzania,Jamhuri ya Muungano wa Tanzania,TZ,Kaskazini Unguja,TZ51,Kaskazini B,TZ5102,Fujoni,TZ5102041,3147 ,1531 ,1616 ,3147 ,1531 ,0 ,0 ,0 ,1616 
United Republic of Tanzania,Jamhuri ya Muungano wa Tanzania,TZ,Kaskazini Unguja,TZ51,Kaskazini B,TZ5102,Kiomba Mvua,TZ5102051,1938 ,963 ,975 ,1938 ,963 ,0 ,0 ,0 ,975 
United Republic of Tanzania,Jamhuri ya Muungano wa Tanzania,TZ,Kaskazini Unguja,TZ51,Kaskazini B,TZ5102,Donge  Mchangani,TZ5102061,2917 ,1503 ,1414 ,2917 ,1503 ,0 ,0 ,0 ,1414 
United Republic of Tanzania,Jamhuri ya Muungano wa Tanzania,TZ,Kaskazini Unguja,TZ51,Kaskazini B,TZ5102,Mkadini,TZ5102071,2449 ,1219 ,1230 ,2449 ,1219 ,0 ,0 ,0 ,1230 
United Republic of Tanzania,Jamhuri ya Muungano wa Tanzania,TZ,Kaskazini Unguja,TZ51,Kaskazini B,TZ5102,Zingwe Zingwe,TZ5102081,745 ,388 ,357 ,745 ,388 ,0 ,0 ,0 ,357 
United Republic of Tanzania,Jamhuri ya Muungano wa Tanzania,TZ,Kaskazini Unguja,TZ51,Kaskazini B,TZ5102,Kitope,TZ5102091,5582 ,2759 ,2823 ,5582 ,2759 ,0 ,0 ,0 ,2823 
United Republic of Tanzania,Jamhuri ya Muungano wa Tanzania,TZ,Kaskazini Unguja,TZ51,Kaskazini B,TZ5102,Mahonda,TZ5102103,4322 ,2129 ,2193 ,1596 ,797 ,2726 ,1332 ,1394 ,799 
United Republic of Tanzania,Jamhuri ya Muungano wa Tanzania,TZ,Kaskazini Unguja,TZ51,Kaskazini B,TZ5102,Mnyimbi,TZ5102111,1266 ,620 ,646 ,1266 ,620 ,0 ,0 ,0 ,646 
United Republic of Tanzania,Jamhuri ya Muungano wa Tanzania,TZ,Kaskazini Unguja,TZ51,Kaskazini B,TZ5102,Donge Mtambile,TZ5102121,2739 ,1321 ,1418 ,2739 ,1321 ,0 ,0 ,0 ,1418 
United Republic of Tanzania,Jamhuri ya Muungano wa Tanzania,TZ,Kaskazini Unguja,TZ51,Kaskazini B,TZ5102,Kinduni,TZ5102131,2616 ,1222 ,1394 ,2616 ,1222 ,0 ,0 ,0 ,1394 
United Republic of Tanzania,Jamhuri ya Muungano wa Tanzania,TZ,Kaskazini Unguja,TZ51,Kaskazini B,TZ5102,Donge Karange,TZ5102141,1826 ,928 ,898 ,1826 ,928 ,0 ,0 ,0 ,898 
United Republic of Tanzania,Jamhuri ya Muungano wa Tanzania,TZ,Kaskazini Unguja,TZ51,Kaskazini B,TZ5102,Donge Mbiji,TZ5102151,2447 ,1245 ,1202 ,2447 ,1245 ,0 ,0 ,0 ,1202 
United Republic of Tanzania,Jamhuri ya Muungano wa Tanzania,TZ,Kaskazini Unguja,TZ51,Kaskazini B,TZ5102,Donge Kipange,TZ5102161,1070 ,545 ,525 ,1070 ,545 ,0 ,0 ,0 ,525 
United Republic of Tanzania,Jamhuri ya Muungano wa Tanzania,TZ,Kaskazini Unguja,TZ51,Kaskazini B,TZ5102,Donge Vijibweni,TZ5102171,3760 ,1860 ,1900 ,3760 ,1860 ,0 ,0 ,0 ,1900 
United Republic of Tanzania,Jamhuri ya Muungano wa Tanzania,TZ,Kaskazini Unguja,TZ51,Kaskazini B,TZ5102,Upenja,TZ5102181,1978 ,1009 ,969 ,1978 ,1009 ,0 ,0 ,0 ,969 
United Republic of Tanzania,Jamhuri ya Muungano wa Tanzania,TZ,Kaskazini Unguja,TZ51,Kaskazini B,TZ5102,Kiwengwa,TZ5102191,3575 ,1836 ,1739 ,3575 ,1836 ,0 ,0 ,0 ,1739 
United Republic of Tanzania,Jamhuri ya Muungano wa Tanzania,TZ,Kaskazini Unguja,TZ51,Kaskazini B,TZ5102,Pangeni,TZ5102201,1604 ,815 ,789 ,1604 ,815 ,0 ,0 ,0 ,789 
United Republic of Tanzania,Jamhuri ya Muungano wa Tanzania,TZ,Kaskazini Unguja,TZ51,Kaskazini B,TZ5102,Kilombero,TZ5102211,1934 ,934 ,1000 ,1934 ,934 ,0 ,0 ,0 ,1000 
United Republic of Tanzania,Jamhuri ya Muungano wa Tanzania,TZ,Kaskazini Unguja,TZ51,Kaskazini B,TZ5102,Mgambo,TZ5102221,2799 ,1375 ,1424 ,2799 ,1375 ,0 ,0 ,0 ,1424 
United Republic of Tanzania,Jamhuri ya Muungano wa Tanzania,TZ,Kaskazini Unguja,TZ51,Kaskazini B,TZ5102,Muwanda,TZ5102231,950 ,485 ,465 ,950 ,485 ,0 ,0 ,0 ,465 
United Republic of Tanzania,Jamhuri ya Muungano wa Tanzania,TZ,Kaskazini Unguja,TZ51,Kaskazini B,TZ5102,Matetema,TZ5102241,2600 ,1272 ,1328 ,2600 ,1272 ,0 ,0 ,0 ,1328 
United Republic of Tanzania,Jamhuri ya Muungano wa Tanzania,TZ,Kaskazini Unguja,TZ51,Kaskazini B,TZ5102,Kidanzini,TZ5102251,2642 ,1299 ,1343 ,2642 ,1299 ,0 ,0 ,0 ,1343 
United Republic of Tanzania,Jamhuri ya Muungano wa Tanzania,TZ,Kaskazini Unguja,TZ51,Kaskazini B,TZ5102,Mbaleni,TZ5102261,2811 ,1415 ,1396 ,2811 ,1415 ,0 ,0 ,0 ,1396 
United Republic of Tanzania,Jamhuri ya Muungano wa Tanzania,TZ,Kaskazini Unguja,TZ51,Kaskazini B,TZ5102,Mafufuni,TZ5102271,3832 ,1951 ,1881 ,3832 ,1951 ,0 ,0 ,0 ,1881 
United Republic of Tanzania,Jamhuri ya Muungano wa Tanzania,TZ,Kaskazini Unguja,TZ51,Kaskazini B,TZ5102,Mkataleni,TZ5102283,4869 ,2370 ,2499 ,3111 ,1533 ,1758 ,837 ,921 ,1578 
United Republic of Tanzania,Jamhuri ya Muungano wa Tanzania,TZ,Kaskazini Unguja,TZ51,Kaskazini B,TZ5102,Njia ya Mtoni,TZ5102291,1548 ,764 ,784 ,1548 ,764 ,0 ,0 ,0 ,784 
United Republic of Tanzania,Jamhuri ya Muungano wa Tanzania,TZ,Kusini Unguja,TZ52,Kati,TZ5201,Dunga Bweni,TZ5201013,2808 ,1369 ,1439 ,2568 ,1235 ,240 ,134 ,106 ,1333 
United Republic of Tanzania,Jamhuri ya Muungano wa Tanzania,TZ,Kusini Unguja,TZ52,Kati,TZ5201,Ubago,TZ5201021,3936 ,2033 ,1903 ,3936 ,2033 ,0 ,0 ,0 ,1903 
United Republic of Tanzania,Jamhuri ya Muungano wa Tanzania,TZ,Kusini Unguja,TZ52,Kati,TZ5201,Kidimni,TZ5201031,4185 ,2030 ,2155 ,4185 ,2030 ,0 ,0 ,0 ,2155 
United Republic of Tanzania,Jamhuri ya Muungano wa Tanzania,TZ,Kusini Unguja,TZ52,Kati,TZ5201,Machui,TZ5201041,1462 ,806 ,656 ,1462 ,806 ,0 ,0 ,0 ,656 
United Republic of Tanzania,Jamhuri ya Muungano wa Tanzania,TZ,Kusini Unguja,TZ52,Kati,TZ5201,Kiboje Muembeshauri,TZ5201051,1467 ,731 ,736 ,1467 ,731 ,0 ,0 ,0 ,736 
United Republic of Tanzania,Jamhuri ya Muungano wa Tanzania,TZ,Kusini Unguja,TZ52,Kati,TZ5201,Miwani,TZ5201061,2310 ,1116 ,1194 ,2310 ,1116 ,0 ,0 ,0 ,1194 
United Republic of Tanzania,Jamhuri ya Muungano wa Tanzania,TZ,Kusini Unguja,TZ52,Kati,TZ5201,Kiboje Mkwajuni,TZ5201071,1268 ,650 ,618 ,1268 ,650 ,0 ,0 ,0 ,618 
United Republic of Tanzania,Jamhuri ya Muungano wa Tanzania,TZ,Kusini Unguja,TZ52,Kati,TZ5201,Ghana,TZ5201081,1869 ,974 ,895 ,1869 ,974 ,0 ,0 ,0 ,895 
United Republic of Tanzania,Jamhuri ya Muungano wa Tanzania,TZ,Kusini Unguja,TZ52,Kati,TZ5201,Koani,TZ5201093,3091 ,1507 ,1584 ,2534 ,1236 ,557 ,271 ,286 ,1298 
United Republic of Tanzania,Jamhuri ya Muungano wa Tanzania,TZ,Kusini Unguja,TZ52,Kati,TZ5201,Mgeni Haji,TZ5201101,1204 ,610 ,594 ,1204 ,610 ,0 ,0 ,0 ,594 
United Republic of Tanzania,Jamhuri ya Muungano wa Tanzania,TZ,Kusini Unguja,TZ52,Kati,TZ5201,Uzini,TZ5201111,944 ,447 ,497 ,944 ,447 ,0 ,0 ,0 ,497 
United Republic of Tanzania,Jamhuri ya Muungano wa Tanzania,TZ,Kusini Unguja,TZ52,Kati,TZ5201,Mitakawani,TZ5201121,1113 ,562 ,551 ,1113 ,562 ,0 ,0 ,0 ,551 
United Republic of Tanzania,Jamhuri ya Muungano wa Tanzania,TZ,Kusini Unguja,TZ52,Kati,TZ5201,Tunduni,TZ5201131,1054 ,552 ,502 ,1054 ,552 ,0 ,0 ,0 ,502 
United Republic of Tanzania,Jamhuri ya Muungano wa Tanzania,TZ,Kusini Unguja,TZ52,Kati,TZ5201,Bambi,TZ5201141,3028 ,1575 ,1453 ,3028 ,1575 ,0 ,0 ,0 ,1453 
United Republic of Tanzania,Jamhuri ya Muungano wa Tanzania,TZ,Kusini Unguja,TZ52,Kati,TZ5201,Pagali,TZ5201151,720 ,393 ,327 ,720 ,393 ,0 ,0 ,0 ,327 
United Republic of Tanzania,Jamhuri ya Muungano wa Tanzania,TZ,Kusini Unguja,TZ52,Kati,TZ5201,Umbuji,TZ5201161,1402 ,726 ,676 ,1402 ,726 ,0 ,0 ,0 ,676 
United Republic of Tanzania,Jamhuri ya Muungano wa Tanzania,TZ,Kusini Unguja,TZ52,Kati,TZ5201,Mchangani,TZ5201171,2066 ,1056 ,1010 ,2066 ,1056 ,0 ,0 ,0 ,1010 
United Republic of Tanzania,Jamhuri ya Muungano wa Tanzania,TZ,Kusini Unguja,TZ52,Kati,TZ5201,Dunga Kiembeni,TZ5201181,1938 ,998 ,940 ,1938 ,998 ,0 ,0 ,0 ,940 
United Republic of Tanzania,Jamhuri ya Muungano wa Tanzania,TZ,Kusini Unguja,TZ52,Kati,TZ5201,Ndijani Mseweni,TZ5201191,2951 ,1491 ,1460 ,2951 ,1491 ,0 ,0 ,0 ,1460 
United Republic of Tanzania,Jamhuri ya Muungano wa Tanzania,TZ,Kusini Unguja,TZ52,Kati,TZ5201,Jendele,TZ5201201,1939 ,936 ,1003 ,1939 ,936 ,0 ,0 ,0 ,1003 
United Republic of Tanzania,Jamhuri ya Muungano wa Tanzania,TZ,Kusini Unguja,TZ52,Kati,TZ5201,Chwaka,TZ5201211,3196 ,1569 ,1627 ,3196 ,1569 ,0 ,0 ,0 ,1627 
United Republic of Tanzania,Jamhuri ya Muungano wa Tanzania,TZ,Kusini Unguja,TZ52,Kati,TZ5201,Marumbi,TZ5201221,1167 ,590 ,577 ,1167 ,590 ,0 ,0 ,0 ,577 
United Republic of Tanzania,Jamhuri ya Muungano wa Tanzania,TZ,Kusini Unguja,TZ52,Kati,TZ5201,Uroa,TZ5201231,2613 ,1323 ,1290 ,2613 ,1323 ,0 ,0 ,0 ,1290 
United Republic of Tanzania,Jamhuri ya Muungano wa Tanzania,TZ,Kusini Unguja,TZ52,Kati,TZ5201,Pongwe,TZ5201241,800 ,457 ,343 ,800 ,457 ,0 ,0 ,0 ,343 
United Republic of Tanzania,Jamhuri ya Muungano wa Tanzania,TZ,Kusini Unguja,TZ52,Kati,TZ5201,Jumbi,TZ5201253,3905 ,1902 ,2003 ,2818 ,1399 ,1087 ,503 ,584 ,1419 
United Republic of Tanzania,Jamhuri ya Muungano wa Tanzania,TZ,Kusini Unguja,TZ52,Kati,TZ5201,Tunguu,TZ5201261,3563 ,1788 ,1775 ,3563 ,1788 ,0 ,0 ,0 ,1775 
United Republic of Tanzania,Jamhuri ya Muungano wa Tanzania,TZ,Kusini Unguja,TZ52,Kati,TZ5201,Binguni,TZ5201271,1378 ,729 ,649 ,1378 ,729 ,0 ,0 ,0 ,649 
United Republic of Tanzania,Jamhuri ya Muungano wa Tanzania,TZ,Kusini Unguja,TZ52,Kati,TZ5201,Cheju,TZ5201281,2038 ,1040 ,998 ,2038 ,1040 ,0 ,0 ,0 ,998 
United Republic of Tanzania,Jamhuri ya Muungano wa Tanzania,TZ,Kusini Unguja,TZ52,Kati,TZ5201,Bungi,TZ5201291,2518 ,1241 ,1277 ,2518 ,1241 ,0 ,0 ,0 ,1277 
United Republic of Tanzania,Jamhuri ya Muungano wa Tanzania,TZ,Kusini Unguja,TZ52,Kati,TZ5201,Unguja Ukuu Kaepwani,TZ5201301,1563 ,796 ,767 ,1563 ,796 ,0 ,0 ,0 ,767 
United Republic of Tanzania,Jamhuri ya Muungano wa Tanzania,TZ,Kusini Unguja,TZ52,Kati,TZ5201,Kikungwi,TZ5201311,972 ,505 ,467 ,972 ,505 ,0 ,0 ,0 ,467 
United Republic of Tanzania,Jamhuri ya Muungano wa Tanzania,TZ,Kusini Unguja,TZ52,Kati,TZ5201,Uzi,TZ5201321,1801 ,919 ,882 ,1801 ,919 ,0 ,0 ,0 ,882 
United Republic of Tanzania,Jamhuri ya Muungano wa Tanzania,TZ,Kusini Unguja,TZ52,Kati,TZ5201,Ng'ambwa,TZ5201331,901 ,454 ,447 ,901 ,454 ,0 ,0 ,0 ,447 
United Republic of Tanzania,Jamhuri ya Muungano wa Tanzania,TZ,Kusini Unguja,TZ52,Kati,TZ5201,Charawe,TZ5201341,954 ,485 ,469 ,954 ,485 ,0 ,0 ,0 ,469 
United Republic of Tanzania,Jamhuri ya Muungano wa Tanzania,TZ,Kusini Unguja,TZ52,Kati,TZ5201,Ukongoroni,TZ5201351,896 ,447 ,449 ,896 ,447 ,0 ,0 ,0 ,449 
United Republic of Tanzania,Jamhuri ya Muungano wa Tanzania,TZ,Kusini Unguja,TZ52,Kati,TZ5201,Michamvi,TZ5201361,1572 ,895 ,677 ,1572 ,895 ,0 ,0 ,0 ,677 
United Republic of Tanzania,Jamhuri ya Muungano wa Tanzania,TZ,Kusini Unguja,TZ52,Kati,TZ5201,Mpapa,TZ5201371,1746 ,819 ,927 ,1746 ,819 ,0 ,0 ,0 ,927 
United Republic of Tanzania,Jamhuri ya Muungano wa Tanzania,TZ,Kusini Unguja,TZ52,Kati,TZ5201,Unguja Ukuu Kaebona,TZ5201381,1362 ,664 ,698 ,1362 ,664 ,0 ,0 ,0 ,698 
United Republic of Tanzania,Jamhuri ya Muungano wa Tanzania,TZ,Kusini Unguja,TZ52,Kati,TZ5201,Ndijani Muembe Punda,TZ5201391,1486 ,761 ,725 ,1486 ,761 ,0 ,0 ,0 ,725 
United Republic of Tanzania,Jamhuri ya Muungano wa Tanzania,TZ,Kusini Unguja,TZ52,Kati,TZ5201,Tindini,TZ5201401,1160 ,592 ,568 ,1160 ,592 ,0 ,0 ,0 ,568 
United Republic of Tanzania,Jamhuri ya Muungano wa Tanzania,TZ,Kusini Unguja,TZ52,Kusini,TZ5202,Nganani,TZ5202013,2050 ,949 ,1101 ,582 ,253 ,1468 ,696 ,772 ,329 
United Republic of Tanzania,Jamhuri ya Muungano wa Tanzania,TZ,Kusini Unguja,TZ52,Kusini,TZ5202,Kijini,TZ5202022,2634 ,1252 ,1382 ,0 ,0 ,2634 ,1252 ,1382 ,0 
United Republic of Tanzania,Jamhuri ya Muungano wa Tanzania,TZ,Kusini Unguja,TZ52,Kusini,TZ5202,Mzuri,TZ5202031,2120 ,1045 ,1075 ,2120 ,1045 ,0 ,0 ,0 ,1075 
United Republic of Tanzania,Jamhuri ya Muungano wa Tanzania,TZ,Kusini Unguja,TZ52,Kusini,TZ5202,Kajengwa,TZ5202041,2313 ,1112 ,1201 ,2313 ,1112 ,0 ,0 ,0 ,1201 
United Republic of Tanzania,Jamhuri ya Muungano wa Tanzania,TZ,Kusini Unguja,TZ52,Kusini,TZ5202,Jambiani Kikadini,TZ5202051,2691 ,1273 ,1418 ,2691 ,1273 ,0 ,0 ,0 ,1418 
United Republic of Tanzania,Jamhuri ya Muungano wa Tanzania,TZ,Kusini Unguja,TZ52,Kusini,TZ5202,Mtende,TZ5202061,1330 ,656 ,674 ,1330 ,656 ,0 ,0 ,0 ,674 
United Republic of Tanzania,Jamhuri ya Muungano wa Tanzania,TZ,Kusini Unguja,TZ52,Kusini,TZ5202,Kibuteni,TZ5202071,482 ,260 ,222 ,482 ,260 ,0 ,0 ,0 ,222 
United Republic of Tanzania,Jamhuri ya Muungano wa Tanzania,TZ,Kusini Unguja,TZ52,Kusini,TZ5202,Kizimkazi Dimbani,TZ5202081,1760 ,898 ,862 ,1760 ,898 ,0 ,0 ,0 ,862 
United Republic of Tanzania,Jamhuri ya Muungano wa Tanzania,TZ,Kusini Unguja,TZ52,Kusini,TZ5202,Kizimkazi Mkunguni,TZ5202091,2617 ,1243 ,1374 ,2617 ,1243 ,0 ,0 ,0 ,1374 
United Republic of Tanzania,Jamhuri ya Muungano wa Tanzania,TZ,Kusini Unguja,TZ52,Kusini,TZ5202,Muyuni A,TZ5202101,934 ,467 ,467 ,934 ,467 ,0 ,0 ,0 ,467 
United Republic of Tanzania,Jamhuri ya Muungano wa Tanzania,TZ,Kusini Unguja,TZ52,Kusini,TZ5202,Muyuni B,TZ5202111,811 ,407 ,404 ,811 ,407 ,0 ,0 ,0 ,404 
United Republic of Tanzania,Jamhuri ya Muungano wa Tanzania,TZ,Kusini Unguja,TZ52,Kusini,TZ5202,Muyuni C,TZ5202121,1028 ,524 ,504 ,1028 ,524 ,0 ,0 ,0 ,504 
United Republic of Tanzania,Jamhuri ya Muungano wa Tanzania,TZ,Kusini Unguja,TZ52,Kusini,TZ5202,Pete,TZ5202131,1420 ,708 ,712 ,1420 ,708 ,0 ,0 ,0 ,712 
United Republic of Tanzania,Jamhuri ya Muungano wa Tanzania,TZ,Kusini Unguja,TZ52,Kusini,TZ5202,Muungoni,TZ5202141,1629 ,858 ,771 ,1629 ,858 ,0 ,0 ,0 ,771 
United Republic of Tanzania,Jamhuri ya Muungano wa Tanzania,TZ,Kusini Unguja,TZ52,Kusini,TZ5202,Paje,TZ5202151,3245 ,1643 ,1602 ,3245 ,1643 ,0 ,0 ,0 ,1602 
United Republic of Tanzania,Jamhuri ya Muungano wa Tanzania,TZ,Kusini Unguja,TZ52,Kusini,TZ5202,Jambiani Kibigija,TZ5202161,3369 ,1621 ,1748 ,3369 ,1621 ,0 ,0 ,0 ,1748 
United Republic of Tanzania,Jamhuri ya Muungano wa Tanzania,TZ,Kusini Unguja,TZ52,Kusini,TZ5202,Bwejuu,TZ5202171,2050 ,977 ,1073 ,2050 ,977 ,0 ,0 ,0 ,1073 
United Republic of Tanzania,Jamhuri ya Muungano wa Tanzania,TZ,Kusini Unguja,TZ52,Kusini,TZ5202,Kitogani,TZ5202181,1128 ,597 ,531 ,1128 ,597 ,0 ,0 ,0 ,531 
United Republic of Tanzania,Jamhuri ya Muungano wa Tanzania,TZ,Kusini Unguja,TZ52,Kusini,TZ5202,Kiongoni,TZ5202192,1106 ,526 ,580 ,0 ,0 ,1106 ,526 ,580 ,0 
United Republic of Tanzania,Jamhuri ya Muungano wa Tanzania,TZ,Kusini Unguja,TZ52,Kusini,TZ5202,Tasani,TZ5202201,1519 ,768 ,751 ,1519 ,768 ,0 ,0 ,0 ,751 
United Republic of Tanzania,Jamhuri ya Muungano wa Tanzania,TZ,Kusini Unguja,TZ52,Kusini,TZ5202,Dongwe,TZ5202211,3006 ,1558 ,1448 ,3006 ,1558 ,0 ,0 ,0 ,1448 
United Republic of Tanzania,Jamhuri ya Muungano wa Tanzania,TZ,Mjini Magharibi,TZ53,Magharibi,TZ5301,Mwera,TZ5301013,10238 ,4914 ,5324 ,2708 ,1311 ,7530 ,3603 ,3927 ,1397 
United Republic of Tanzania,Jamhuri ya Muungano wa Tanzania,TZ,Mjini Magharibi,TZ53,Magharibi,TZ5301,Mtoni,TZ5301023,6571 ,3160 ,3411 ,296 ,129 ,6275 ,3031 ,3244 ,167 
United Republic of Tanzania,Jamhuri ya Muungano wa Tanzania,TZ,Mjini Magharibi,TZ53,Magharibi,TZ5301,Bububu,TZ5301033,15666 ,7273 ,8393 ,1690 ,775 ,13976 ,6498 ,7478 ,915 
United Republic of Tanzania,Jamhuri ya Muungano wa Tanzania,TZ,Mjini Magharibi,TZ53,Magharibi,TZ5301,Chuini,TZ5301041,6158 ,2868 ,3290 ,6158 ,2868 ,0 ,0 ,0 ,3290 
United Republic of Tanzania,Jamhuri ya Muungano wa Tanzania,TZ,Mjini Magharibi,TZ53,Magharibi,TZ5301,Kama,TZ5301051,2921 ,1450 ,1471 ,2921 ,1450 ,0 ,0 ,0 ,1471 
United Republic of Tanzania,Jamhuri ya Muungano wa Tanzania,TZ,Mjini Magharibi,TZ53,Magharibi,TZ5301,Mfenesini,TZ5301061,2803 ,1316 ,1487 ,2803 ,1316 ,0 ,0 ,0 ,1487 
United Republic of Tanzania,Jamhuri ya Muungano wa Tanzania,TZ,Mjini Magharibi,TZ53,Magharibi,TZ5301,Mwakaje,TZ5301071,2907 ,1490 ,1417 ,2907 ,1490 ,0 ,0 ,0 ,1417 
United Republic of Tanzania,Jamhuri ya Muungano wa Tanzania,TZ,Mjini Magharibi,TZ53,Magharibi,TZ5301,Fuoni Kibondeni,TZ5301083,15400 ,7468 ,7932 ,10243 ,5033 ,5157 ,2435 ,2722 ,5210 
United Republic of Tanzania,Jamhuri ya Muungano wa Tanzania,TZ,Mjini Magharibi,TZ53,Magharibi,TZ5301,Kianga,TZ5301093,9908 ,4759 ,5149 ,8002 ,3870 ,1906 ,889 ,1017 ,4132 
United Republic of Tanzania,Jamhuri ya Muungano wa Tanzania,TZ,Mjini Magharibi,TZ53,Magharibi,TZ5301,Dole,TZ5301101,3933 ,2079 ,1854 ,3933 ,2079 ,0 ,0 ,0 ,1854 
United Republic of Tanzania,Jamhuri ya Muungano wa Tanzania,TZ,Mjini Magharibi,TZ53,Magharibi,TZ5301,Kizimbani,TZ5301111,3304 ,1683 ,1621 ,3304 ,1683 ,0 ,0 ,0 ,1621 
United Republic of Tanzania,Jamhuri ya Muungano wa Tanzania,TZ,Mjini Magharibi,TZ53,Magharibi,TZ5301,Mbuzini,TZ5301121,5856 ,2810 ,3046 ,5856 ,2810 ,0 ,0 ,0 ,3046 
United Republic of Tanzania,Jamhuri ya Muungano wa Tanzania,TZ,Mjini Magharibi,TZ53,Magharibi,TZ5301,Bumbwisudi,TZ5301131,2269 ,1124 ,1145 ,2269 ,1124 ,0 ,0 ,0 ,1145 
United Republic of Tanzania,Jamhuri ya Muungano wa Tanzania,TZ,Mjini Magharibi,TZ53,Magharibi,TZ5301,Maungani,TZ5301141,4048 ,1984 ,2064 ,4048 ,1984 ,0 ,0 ,0 ,2064 
United Republic of Tanzania,Jamhuri ya Muungano wa Tanzania,TZ,Mjini Magharibi,TZ53,Magharibi,TZ5301,Shakani,TZ5301151,2760 ,1351 ,1409 ,2760 ,1351 ,0 ,0 ,0 ,1409 
United Republic of Tanzania,Jamhuri ya Muungano wa Tanzania,TZ,Mjini Magharibi,TZ53,Magharibi,TZ5301,Kiembesamaki,TZ5301163,11760 ,5548 ,6212 ,1518 ,701 ,10242 ,4847 ,5395 ,817 
United Republic of Tanzania,Jamhuri ya Muungano wa Tanzania,TZ,Mjini Magharibi,TZ53,Magharibi,TZ5301,Chukwani,TZ5301173,8298 ,4042 ,4256 ,822 ,396 ,7476 ,3646 ,3830 ,426 
United Republic of Tanzania,Jamhuri ya Muungano wa Tanzania,TZ,Mjini Magharibi,TZ53,Magharibi,TZ5301,Fumba,TZ5301181,981 ,492 ,489 ,981 ,492 ,0 ,0 ,0 ,489 
United Republic of Tanzania,Jamhuri ya Muungano wa Tanzania,TZ,Mjini Magharibi,TZ53,Magharibi,TZ5301,Bweleo,TZ5301191,971 ,488 ,483 ,971 ,488 ,0 ,0 ,0 ,483 
United Republic of Tanzania,Jamhuri ya Muungano wa Tanzania,TZ,Mjini Magharibi,TZ53,Magharibi,TZ5301,Dimani,TZ5301201,2052 ,1019 ,1033 ,2052 ,1019 ,0 ,0 ,0 ,1033 
United Republic of Tanzania,Jamhuri ya Muungano wa Tanzania,TZ,Mjini Magharibi,TZ53,Magharibi,TZ5301,Kombeni,TZ5301211,3162 ,1580 ,1582 ,3162 ,1580 ,0 ,0 ,0 ,1582 
United Republic of Tanzania,Jamhuri ya Muungano wa Tanzania,TZ,Mjini Magharibi,TZ53,Magharibi,TZ5301,Mwanakwerekwe,TZ5301222,20215 ,9530 ,10685 ,0 ,0 ,20215 ,9530 ,10685 ,0 
United Republic of Tanzania,Jamhuri ya Muungano wa Tanzania,TZ,Mjini Magharibi,TZ53,Magharibi,TZ5301,Mtopepo,TZ5301233,16440 ,7968 ,8472 ,247 ,127 ,16193 ,7841 ,8352 ,120 
United Republic of Tanzania,Jamhuri ya Muungano wa Tanzania,TZ,Mjini Magharibi,TZ53,Magharibi,TZ5301,Magogoni,TZ5301242,14928 ,7215 ,7713 ,0 ,0 ,14928 ,7215 ,7713 ,0 
United Republic of Tanzania,Jamhuri ya Muungano wa Tanzania,TZ,Mjini Magharibi,TZ53,Magharibi,TZ5301,Mtoni Kidatu,TZ5301253,16612 ,8029 ,8583 ,1199 ,590 ,15413 ,7439 ,7974 ,609 
United Republic of Tanzania,Jamhuri ya Muungano wa Tanzania,TZ,Mjini Magharibi,TZ53,Magharibi,TZ5301,Mwanyanya,TZ5301263,9683 ,4548 ,5135 ,1043 ,475 ,8640 ,4073 ,4567 ,568 
United Republic of Tanzania,Jamhuri ya Muungano wa Tanzania,TZ,Mjini Magharibi,TZ53,Magharibi,TZ5301,Fuoni Kijito Upele,TZ5301273,19374 ,8944 ,10430 ,1674 ,777 ,17700 ,8167 ,9533 ,897 
United Republic of Tanzania,Jamhuri ya Muungano wa Tanzania,TZ,Mjini Magharibi,TZ53,Magharibi,TZ5301,Tomondo,TZ5301283,23254 ,11019 ,12235 ,1504 ,716 ,21750 ,10303 ,11447 ,788 
United Republic of Tanzania,Jamhuri ya Muungano wa Tanzania,TZ,Mjini Magharibi,TZ53,Magharibi,TZ5301,Welezo,TZ5301292,13119 ,6360 ,6759 ,0 ,0 ,13119 ,6360 ,6759 ,0 
United Republic of Tanzania,Jamhuri ya Muungano wa Tanzania,TZ,Mjini Magharibi,TZ53,Magharibi,TZ5301,Mtufaani,TZ5301303,9123 ,4424 ,4699 ,3433 ,1698 ,5690 ,2726 ,2964 ,1735 
United Republic of Tanzania,Jamhuri ya Muungano wa Tanzania,TZ,Mjini Magharibi,TZ53,Magharibi,TZ5301,Sharifumsa,TZ5301313,4975 ,2395 ,2580 ,436 ,219 ,4539 ,2176 ,2363 ,217 
United Republic of Tanzania,Jamhuri ya Muungano wa Tanzania,TZ,Mjini Magharibi,TZ53,Magharibi,TZ5301,Kibweni,TZ5301323,7115 ,3321 ,3794 ,431 ,201 ,6684 ,3120 ,3564 ,230 
United Republic of Tanzania,Jamhuri ya Muungano wa Tanzania,TZ,Mjini Magharibi,TZ53,Magharibi,TZ5301,Kihinani,TZ5301333,14139 ,6688 ,7451 ,3805 ,1817 ,10334 ,4871 ,5463 ,1988 
United Republic of Tanzania,Jamhuri ya Muungano wa Tanzania,TZ,Mjini Magharibi,TZ53,Magharibi,TZ5301,Mombasa,TZ5301342,14492 ,6806 ,7686 ,0 ,0 ,14492 ,6806 ,7686 ,0 
United Republic of Tanzania,Jamhuri ya Muungano wa Tanzania,TZ,Mjini Magharibi,TZ53,Magharibi,TZ5301,Kisauni,TZ5301353,9331 ,4441 ,4890 ,2295 ,1114 ,7036 ,3327 ,3709 ,1181 
United Republic of Tanzania,Jamhuri ya Muungano wa Tanzania,TZ,Mjini Magharibi,TZ53,Magharibi,TZ5301,Melinne,TZ5301362,16984 ,8032 ,8952 ,0 ,0 ,16984 ,8032 ,8952 ,0 
United Republic of Tanzania,Jamhuri ya Muungano wa Tanzania,TZ,Mjini Magharibi,TZ53,Magharibi,TZ5301,Pangawe,TZ5301373,26275 ,12164 ,14111 ,3756 ,1746 ,22519 ,10418 ,12101 ,2010 
United Republic of Tanzania,Jamhuri ya Muungano wa Tanzania,TZ,Mjini Magharibi,TZ53,Magharibi,TZ5301,Kinuni,TZ5301383,11333 ,5527 ,5806 ,1705 ,827 ,9628 ,4700 ,4928 ,878 
United Republic of Tanzania,Jamhuri ya Muungano wa Tanzania,TZ,Mjini Magharibi,TZ53,Magharibi,TZ5301,Nyamanzi,TZ5301391,1287 ,670 ,617 ,1287 ,670 ,0 ,0 ,0 ,617 
United Republic of Tanzania,Jamhuri ya Muungano wa Tanzania,TZ,Mjini Magharibi,TZ53,Mjini,TZ5302,Shangani,TZ5302012,3886 ,1910 ,1976 ,0 ,0 ,3886 ,1910 ,1976 ,0 
United Republic of Tanzania,Jamhuri ya Muungano wa Tanzania,TZ,Mjini Magharibi,TZ53,Mjini,TZ5302,Mkunazini,TZ5302022,3308 ,1573 ,1735 ,0 ,0 ,3308 ,1573 ,1735 ,0 
United Republic of Tanzania,Jamhuri ya Muungano wa Tanzania,TZ,Mjini Magharibi,TZ53,Mjini,TZ5302,Kiponda,TZ5302032,1654 ,819 ,835 ,0 ,0 ,1654 ,819 ,835 ,0 
United Republic of Tanzania,Jamhuri ya Muungano wa Tanzania,TZ,Mjini Magharibi,TZ53,Mjini,TZ5302,Malindi,TZ5302042,3204 ,1719 ,1485 ,0 ,0 ,3204 ,1719 ,1485 ,0 
United Republic of Tanzania,Jamhuri ya Muungano wa Tanzania,TZ,Mjini Magharibi,TZ53,Mjini,TZ5302,Mchangani,TZ5302052,2211 ,1016 ,1195 ,0 ,0 ,2211 ,1016 ,1195 ,0 
United Republic of Tanzania,Jamhuri ya Muungano wa Tanzania,TZ,Mjini Magharibi,TZ53,Mjini,TZ5302,Mlandege,TZ5302062,2070 ,946 ,1124 ,0 ,0 ,2070 ,946 ,1124 ,0 
United Republic of Tanzania,Jamhuri ya Muungano wa Tanzania,TZ,Mjini Magharibi,TZ53,Mjini,TZ5302,Mwembeladu,TZ5302072,2954 ,1376 ,1578 ,0 ,0 ,2954 ,1376 ,1578 ,0 
United Republic of Tanzania,Jamhuri ya Muungano wa Tanzania,TZ,Mjini Magharibi,TZ53,Mjini,TZ5302,Gulioni,TZ5302082,2488 ,1186 ,1302 ,0 ,0 ,2488 ,1186 ,1302 ,0 
United Republic of Tanzania,Jamhuri ya Muungano wa Tanzania,TZ,Mjini Magharibi,TZ53,Mjini,TZ5302,Makadara,TZ5302092,5048 ,2342 ,2706 ,0 ,0 ,5048 ,2342 ,2706 ,0 
United Republic of Tanzania,Jamhuri ya Muungano wa Tanzania,TZ,Mjini Magharibi,TZ53,Mjini,TZ5302,Shaurimoyo,TZ5302102,8335 ,3927 ,4408 ,0 ,0 ,8335 ,3927 ,4408 ,0 
United Republic of Tanzania,Jamhuri ya Muungano wa Tanzania,TZ,Mjini Magharibi,TZ53,Mjini,TZ5302,Mwembe Makumbi,TZ5302112,8354 ,3945 ,4409 ,0 ,0 ,8354 ,3945 ,4409 ,0 
United Republic of Tanzania,Jamhuri ya Muungano wa Tanzania,TZ,Mjini Magharibi,TZ53,Mjini,TZ5302,Chumbuni,TZ5302122,10925 ,5198 ,5727 ,0 ,0 ,10925 ,5198 ,5727 ,0 
United Republic of Tanzania,Jamhuri ya Muungano wa Tanzania,TZ,Mjini Magharibi,TZ53,Mjini,TZ5302,Kwamtipura,TZ5302132,11572 ,5575 ,5997 ,0 ,0 ,11572 ,5575 ,5997 ,0 
United Republic of Tanzania,Jamhuri ya Muungano wa Tanzania,TZ,Mjini Magharibi,TZ53,Mjini,TZ5302,Kilimahewa Juu,TZ5302142,4714 ,2341 ,2373 ,0 ,0 ,4714 ,2341 ,2373 ,0 
United Republic of Tanzania,Jamhuri ya Muungano wa Tanzania,TZ,Mjini Magharibi,TZ53,Mjini,TZ5302,Amani,TZ5302152,6156 ,2880 ,3276 ,0 ,0 ,6156 ,2880 ,3276 ,0 
United Republic of Tanzania,Jamhuri ya Muungano wa Tanzania,TZ,Mjini Magharibi,TZ53,Mjini,TZ5302,Nyerere,TZ5302162,9657 ,4618 ,5039 ,0 ,0 ,9657 ,4618 ,5039 ,0 
United Republic of Tanzania,Jamhuri ya Muungano wa Tanzania,TZ,Mjini Magharibi,TZ53,Mjini,TZ5302,Sebleni,TZ5302172,5102 ,2450 ,2652 ,0 ,0 ,5102 ,2450 ,2652 ,0 
United Republic of Tanzania,Jamhuri ya Muungano wa Tanzania,TZ,Mjini Magharibi,TZ53,Mjini,TZ5302,Magomeni,TZ5302182,6165 ,2906 ,3259 ,0 ,0 ,6165 ,2906 ,3259 ,0 
United Republic of Tanzania,Jamhuri ya Muungano wa Tanzania,TZ,Mjini Magharibi,TZ53,Mjini,TZ5302,Mpendae,TZ5302192,13252 ,6362 ,6890 ,0 ,0 ,13252 ,6362 ,6890 ,0 
United Republic of Tanzania,Jamhuri ya Muungano wa Tanzania,TZ,Mjini Magharibi,TZ53,Mjini,TZ5302,Urusi,TZ5302202,7532 ,3656 ,3876 ,0 ,0 ,7532 ,3656 ,3876 ,0 
United Republic of Tanzania,Jamhuri ya Muungano wa Tanzania,TZ,Mjini Magharibi,TZ53,Mjini,TZ5302,Kilimani,TZ5302212,2911 ,1420 ,1491 ,0 ,0 ,2911 ,1420 ,1491 ,0 
United Republic of Tanzania,Jamhuri ya Muungano wa Tanzania,TZ,Mjini Magharibi,TZ53,Mjini,TZ5302,Miembeni,TZ5302222,6095 ,3023 ,3072 ,0 ,0 ,6095 ,3023 ,3072 ,0 
United Republic of Tanzania,Jamhuri ya Muungano wa Tanzania,TZ,Mjini Magharibi,TZ53,Mjini,TZ5302,Kikwajuni Juu,TZ5302232,2408 ,1062 ,1346 ,0 ,0 ,2408 ,1062 ,1346 ,0 
United Republic of Tanzania,Jamhuri ya Muungano wa Tanzania,TZ,Mjini Magharibi,TZ53,Mjini,TZ5302,Kikwajuni Bondeni,TZ5302242,2257 ,1061 ,1196 ,0 ,0 ,2257 ,1061 ,1196 ,0 
United Republic of Tanzania,Jamhuri ya Muungano wa Tanzania,TZ,Mjini Magharibi,TZ53,Mjini,TZ5302,Kisima Majongoo,TZ5302252,2615 ,1251 ,1364 ,0 ,0 ,2615 ,1251 ,1364 ,0 
United Republic of Tanzania,Jamhuri ya Muungano wa Tanzania,TZ,Mjini Magharibi,TZ53,Mjini,TZ5302,Vikokotoni,TZ5302262,1872 ,918 ,954 ,0 ,0 ,1872 ,918 ,954 ,0 
United Republic of Tanzania,Jamhuri ya Muungano wa Tanzania,TZ,Mjini Magharibi,TZ53,Mjini,TZ5302,Muembetanga,TZ5302272,2610 ,1167 ,1443 ,0 ,0 ,2610 ,1167 ,1443 ,0 
United Republic of Tanzania,Jamhuri ya Muungano wa Tanzania,TZ,Mjini Magharibi,TZ53,Mjini,TZ5302,Muembeshauri,TZ5302282,1933 ,894 ,1039 ,0 ,0 ,1933 ,894 ,1039 ,0 
United Republic of Tanzania,Jamhuri ya Muungano wa Tanzania,TZ,Mjini Magharibi,TZ53,Mjini,TZ5302,Rahaleo,TZ5302292,1950 ,926 ,1024 ,0 ,0 ,1950 ,926 ,1024 ,0 
United Republic of Tanzania,Jamhuri ya Muungano wa Tanzania,TZ,Mjini Magharibi,TZ53,Mjini,TZ5302,Kwaalimsha,TZ5302302,3479 ,1630 ,1849 ,0 ,0 ,3479 ,1630 ,1849 ,0 
United Republic of Tanzania,Jamhuri ya Muungano wa Tanzania,TZ,Mjini Magharibi,TZ53,Mjini,TZ5302,Mikunguni,TZ5302312,2984 ,1361 ,1623 ,0 ,0 ,2984 ,1361 ,1623 ,0 
United Republic of Tanzania,Jamhuri ya Muungano wa Tanzania,TZ,Mjini Magharibi,TZ53,Mjini,TZ5302,Mkele,TZ5302322,7140 ,3394 ,3746 ,0 ,0 ,7140 ,3394 ,3746 ,0 
United Republic of Tanzania,Jamhuri ya Muungano wa Tanzania,TZ,Mjini Magharibi,TZ53,Mjini,TZ5302,Muungano,TZ5302332,5304 ,2492 ,2812 ,0 ,0 ,5304 ,2492 ,2812 ,0 
United Republic of Tanzania,Jamhuri ya Muungano wa Tanzania,TZ,Mjini Magharibi,TZ53,Mjini,TZ5302,Sogea,TZ5302342,4801 ,2295 ,2506 ,0 ,0 ,4801 ,2295 ,2506 ,0 
United Republic of Tanzania,Jamhuri ya Muungano wa Tanzania,TZ,Mjini Magharibi,TZ53,Mjini,TZ5302,Jang'ombe,TZ5302352,6122 ,2945 ,3177 ,0 ,0 ,6122 ,2945 ,3177 ,0 
United Republic of Tanzania,Jamhuri ya Muungano wa Tanzania,TZ,Mjini Magharibi,TZ53,Mjini,TZ5302,Kidongo Chekundu,TZ5302362,2290 ,1073 ,1217 ,0 ,0 ,2290 ,1073 ,1217 ,0 
United Republic of Tanzania,Jamhuri ya Muungano wa Tanzania,TZ,Mjini Magharibi,TZ53,Mjini,TZ5302,Matarumbeta,TZ5302372,2711 ,1260 ,1451 ,0 ,0 ,2711 ,1260 ,1451 ,0 
United Republic of Tanzania,Jamhuri ya Muungano wa Tanzania,TZ,Mjini Magharibi,TZ53,Mjini,TZ5302,Kwahani,TZ5302382,4815 ,2337 ,2478 ,0 ,0 ,4815 ,2337 ,2478 ,0 
United Republic of Tanzania,Jamhuri ya Muungano wa Tanzania,TZ,Mjini Magharibi,TZ53,Mjini,TZ5302,Kwaalinatu,TZ5302392,5438 ,2680 ,2758 ,0 ,0 ,5438 ,2680 ,2758 ,0 
United Republic of Tanzania,Jamhuri ya Muungano wa Tanzania,TZ,Mjini Magharibi,TZ53,Mjini,TZ5302,Karakana,TZ5302402,8610 ,4076 ,4534 ,0 ,0 ,8610 ,4076 ,4534 ,0 
United Republic of Tanzania,Jamhuri ya Muungano wa Tanzania,TZ,Mjini Magharibi,TZ53,Mjini,TZ5302,Kilimahewa Bondeni,TZ5302412,5116 ,2390 ,2726 ,0 ,0 ,5116 ,2390 ,2726 ,0 
United Republic of Tanzania,Jamhuri ya Muungano wa Tanzania,TZ,Mjini Magharibi,TZ53,Mjini,TZ5302,Kwa Wazee,TZ5302422,6454 ,3063 ,3391 ,0 ,0 ,6454 ,3063 ,3391 ,0 
United Republic of Tanzania,Jamhuri ya Muungano wa Tanzania,TZ,Mjini Magharibi,TZ53,Mjini,TZ5302,Migombani,TZ5302432,7164 ,3674 ,3490 ,0 ,0 ,7164 ,3674 ,3490 ,0 
United Republic of Tanzania,Jamhuri ya Muungano wa Tanzania,TZ,Mjini Magharibi,TZ53,Mjini,TZ5302,Meya,TZ5302442,5777 ,2755 ,3022 ,0 ,0 ,5777 ,2755 ,3022 ,0 
United Republic of Tanzania,Jamhuri ya Muungano wa Tanzania,TZ,Mjini Magharibi,TZ53,Mjini,TZ5302,Kisiwandui,TZ5302452,1590 ,719 ,871 ,0 ,0 ,1590 ,719 ,871 ,0 
United Republic of Tanzania,Jamhuri ya Muungano wa Tanzania,TZ,Kaskazini Pemba,TZ54,Wete,TZ5401,Kipangani,TZ5401012,4241 ,2053 ,2188 ,0 ,0 ,4241 ,2053 ,2188 ,0 
United Republic of Tanzania,Jamhuri ya Muungano wa Tanzania,TZ,Kaskazini Pemba,TZ54,Wete,TZ5401,Mtambwe Kaskazini,TZ5401021,5417 ,2638 ,2779 ,5417 ,2638 ,0 ,0 ,0 ,2779 
United Republic of Tanzania,Jamhuri ya Muungano wa Tanzania,TZ,Kaskazini Pemba,TZ54,Wete,TZ5401,Fundo,TZ5401031,1625 ,816 ,809 ,1625 ,816 ,0 ,0 ,0 ,809 
United Republic of Tanzania,Jamhuri ya Muungano wa Tanzania,TZ,Kaskazini Pemba,TZ54,Wete,TZ5401,Mchanga Mdogo,TZ5401041,3280 ,1569 ,1711 ,3280 ,1569 ,0 ,0 ,0 ,1711 
United Republic of Tanzania,Jamhuri ya Muungano wa Tanzania,TZ,Kaskazini Pemba,TZ54,Wete,TZ5401,Kambini,TZ5401051,3344 ,1609 ,1735 ,3344 ,1609 ,0 ,0 ,0 ,1735 
United Republic of Tanzania,Jamhuri ya Muungano wa Tanzania,TZ,Kaskazini Pemba,TZ54,Wete,TZ5401,Kojani,TZ5401061,2358 ,1165 ,1193 ,2358 ,1165 ,0 ,0 ,0 ,1193 
United Republic of Tanzania,Jamhuri ya Muungano wa Tanzania,TZ,Kaskazini Pemba,TZ54,Wete,TZ5401,Ole,TZ5401071,7018 ,3384 ,3634 ,7018 ,3384 ,0 ,0 ,0 ,3634 
United Republic of Tanzania,Jamhuri ya Muungano wa Tanzania,TZ,Kaskazini Pemba,TZ54,Wete,TZ5401,Kangagani,TZ5401081,3135 ,1503 ,1632 ,3135 ,1503 ,0 ,0 ,0 ,1632 
United Republic of Tanzania,Jamhuri ya Muungano wa Tanzania,TZ,Kaskazini Pemba,TZ54,Wete,TZ5401,Kiuyu Minungwini,TZ5401091,3133 ,1579 ,1554 ,3133 ,1579 ,0 ,0 ,0 ,1554 
United Republic of Tanzania,Jamhuri ya Muungano wa Tanzania,TZ,Kaskazini Pemba,TZ54,Wete,TZ5401,Piki,TZ5401101,3274 ,1582 ,1692 ,3274 ,1582 ,0 ,0 ,0 ,1692 
United Republic of Tanzania,Jamhuri ya Muungano wa Tanzania,TZ,Kaskazini Pemba,TZ54,Wete,TZ5401,Kisiwani,TZ5401111,3236 ,1611 ,1625 ,3236 ,1611 ,0 ,0 ,0 ,1625 
United Republic of Tanzania,Jamhuri ya Muungano wa Tanzania,TZ,Kaskazini Pemba,TZ54,Wete,TZ5401,Gando,TZ5401121,2210 ,1111 ,1099 ,2210 ,1111 ,0 ,0 ,0 ,1099 
United Republic of Tanzania,Jamhuri ya Muungano wa Tanzania,TZ,Kaskazini Pemba,TZ54,Wete,TZ5401,Ukunjwi,TZ5401131,2769 ,1379 ,1390 ,2769 ,1379 ,0 ,0 ,0 ,1390 
United Republic of Tanzania,Jamhuri ya Muungano wa Tanzania,TZ,Kaskazini Pemba,TZ54,Wete,TZ5401,Pandani,TZ5401141,5895 ,2835 ,3060 ,5895 ,2835 ,0 ,0 ,0 ,3060 
United Republic of Tanzania,Jamhuri ya Muungano wa Tanzania,TZ,Kaskazini Pemba,TZ54,Wete,TZ5401,Shengejuu,TZ5401151,1753 ,863 ,890 ,1753 ,863 ,0 ,0 ,0 ,890 
United Republic of Tanzania,Jamhuri ya Muungano wa Tanzania,TZ,Kaskazini Pemba,TZ54,Wete,TZ5401,Bopwe,TZ5401162,5212 ,2450 ,2762 ,0 ,0 ,5212 ,2450 ,2762 ,0 
United Republic of Tanzania,Jamhuri ya Muungano wa Tanzania,TZ,Kaskazini Pemba,TZ54,Wete,TZ5401,Utaani,TZ5401172,3829 ,1762 ,2067 ,0 ,0 ,3829 ,1762 ,2067 ,0 
United Republic of Tanzania,Jamhuri ya Muungano wa Tanzania,TZ,Kaskazini Pemba,TZ54,Wete,TZ5401,Mtambwe Kusini,TZ5401181,3791 ,1901 ,1890 ,3791 ,1901 ,0 ,0 ,0 ,1890 
United Republic of Tanzania,Jamhuri ya Muungano wa Tanzania,TZ,Kaskazini Pemba,TZ54,Wete,TZ5401,Selem,TZ5401192,2603 ,1196 ,1407 ,0 ,0 ,2603 ,1196 ,1407 ,0 
United Republic of Tanzania,Jamhuri ya Muungano wa Tanzania,TZ,Kaskazini Pemba,TZ54,Wete,TZ5401,Kinyikani,TZ5401201,2296 ,1106 ,1190 ,2296 ,1106 ,0 ,0 ,0 ,1190 
United Republic of Tanzania,Jamhuri ya Muungano wa Tanzania,TZ,Kaskazini Pemba,TZ54,Wete,TZ5401,Chwale,TZ5401211,1698 ,838 ,860 ,1698 ,838 ,0 ,0 ,0 ,860 
United Republic of Tanzania,Jamhuri ya Muungano wa Tanzania,TZ,Kaskazini Pemba,TZ54,Wete,TZ5401,Maziwani,TZ5401221,2051 ,976 ,1075 ,2051 ,976 ,0 ,0 ,0 ,1075 
United Republic of Tanzania,Jamhuri ya Muungano wa Tanzania,TZ,Kaskazini Pemba,TZ54,Wete,TZ5401,Mpambani,TZ5401231,2178 ,1104 ,1074 ,2178 ,1104 ,0 ,0 ,0 ,1074 
United Republic of Tanzania,Jamhuri ya Muungano wa Tanzania,TZ,Kaskazini Pemba,TZ54,Wete,TZ5401,Mjini Ole,TZ5401241,3531 ,1744 ,1787 ,3531 ,1744 ,0 ,0 ,0 ,1787 
United Republic of Tanzania,Jamhuri ya Muungano wa Tanzania,TZ,Kaskazini Pemba,TZ54,Wete,TZ5401,Kiuyu Kigongoni,TZ5401251,2703 ,1332 ,1371 ,2703 ,1332 ,0 ,0 ,0 ,1371 
United Republic of Tanzania,Jamhuri ya Muungano wa Tanzania,TZ,Kaskazini Pemba,TZ54,Wete,TZ5401,Mzambarauni Takao,TZ5401261,2001 ,983 ,1018 ,2001 ,983 ,0 ,0 ,0 ,1018 
United Republic of Tanzania,Jamhuri ya Muungano wa Tanzania,TZ,Kaskazini Pemba,TZ54,Wete,TZ5401,Junguni,TZ5401271,2547 ,1257 ,1290 ,2547 ,1257 ,0 ,0 ,0 ,1290 
United Republic of Tanzania,Jamhuri ya Muungano wa Tanzania,TZ,Kaskazini Pemba,TZ54,Wete,TZ5401,Kiungoni,TZ5401281,3112 ,1513 ,1599 ,3112 ,1513 ,0 ,0 ,0 ,1599 
United Republic of Tanzania,Jamhuri ya Muungano wa Tanzania,TZ,Kaskazini Pemba,TZ54,Wete,TZ5401,Pembeni,TZ5401291,1689 ,844 ,845 ,1689 ,844 ,0 ,0 ,0 ,845 
United Republic of Tanzania,Jamhuri ya Muungano wa Tanzania,TZ,Kaskazini Pemba,TZ54,Wete,TZ5401,Kizimbani,TZ5401302,5875 ,2826 ,3049 ,0 ,0 ,5875 ,2826 ,3049 ,0 
United Republic of Tanzania,Jamhuri ya Muungano wa Tanzania,TZ,Kaskazini Pemba,TZ54,Wete,TZ5401,Limbani,TZ5401312,3919 ,1897 ,2022 ,0 ,0 ,3919 ,1897 ,2022 ,0 
United Republic of Tanzania,Jamhuri ya Muungano wa Tanzania,TZ,Kaskazini Pemba,TZ54,Wete,TZ5401,Jadida,TZ5401322,6193 ,2922 ,3271 ,0 ,0 ,6193 ,2922 ,3271 ,0 
United Republic of Tanzania,Jamhuri ya Muungano wa Tanzania,TZ,Kaskazini Pemba,TZ54,Micheweni,TZ5402,Micheweni,TZ5402013,6197 ,3134 ,3063 ,4857 ,2435 ,1340 ,699 ,641 ,2422 
United Republic of Tanzania,Jamhuri ya Muungano wa Tanzania,TZ,Kaskazini Pemba,TZ54,Micheweni,TZ5402,Msuka Mashariki,TZ5402021,4260 ,2018 ,2242 ,4260 ,2018 ,0 ,0 ,0 ,2242 
United Republic of Tanzania,Jamhuri ya Muungano wa Tanzania,TZ,Kaskazini Pemba,TZ54,Micheweni,TZ5402,Kinowe,TZ5402031,4380 ,2096 ,2284 ,4380 ,2096 ,0 ,0 ,0 ,2284 
United Republic of Tanzania,Jamhuri ya Muungano wa Tanzania,TZ,Kaskazini Pemba,TZ54,Micheweni,TZ5402,Tumbe Mashariki,TZ5402041,4679 ,2292 ,2387 ,4679 ,2292 ,0 ,0 ,0 ,2387 
United Republic of Tanzania,Jamhuri ya Muungano wa Tanzania,TZ,Kaskazini Pemba,TZ54,Micheweni,TZ5402,Mgogoni,TZ5402051,2482 ,1235 ,1247 ,2482 ,1235 ,0 ,0 ,0 ,1247 
United Republic of Tanzania,Jamhuri ya Muungano wa Tanzania,TZ,Kaskazini Pemba,TZ54,Micheweni,TZ5402,Shumba Viamboni,TZ5402061,2580 ,1238 ,1342 ,2580 ,1238 ,0 ,0 ,0 ,1342 
United Republic of Tanzania,Jamhuri ya Muungano wa Tanzania,TZ,Kaskazini Pemba,TZ54,Micheweni,TZ5402,Finya,TZ5402071,2608 ,1251 ,1357 ,2608 ,1251 ,0 ,0 ,0 ,1357 
United Republic of Tanzania,Jamhuri ya Muungano wa Tanzania,TZ,Kaskazini Pemba,TZ54,Micheweni,TZ5402,Konde,TZ5402083,8573 ,4106 ,4467 ,4832 ,2344 ,3741 ,1762 ,1979 ,2488 
United Republic of Tanzania,Jamhuri ya Muungano wa Tanzania,TZ,Kaskazini Pemba,TZ54,Micheweni,TZ5402,Wingwi Mapofu,TZ5402091,4504 ,2194 ,2310 ,4504 ,2194 ,0 ,0 ,0 ,2310 
United Republic of Tanzania,Jamhuri ya Muungano wa Tanzania,TZ,Kaskazini Pemba,TZ54,Micheweni,TZ5402,Kiuyu Mbuyuni,TZ5402101,6416 ,3089 ,3327 ,6416 ,3089 ,0 ,0 ,0 ,3327 
United Republic of Tanzania,Jamhuri ya Muungano wa Tanzania,TZ,Kaskazini Pemba,TZ54,Micheweni,TZ5402,Makangale,TZ5402111,2645 ,1348 ,1297 ,2645 ,1348 ,0 ,0 ,0 ,1297 
United Republic of Tanzania,Jamhuri ya Muungano wa Tanzania,TZ,Kaskazini Pemba,TZ54,Micheweni,TZ5402,Wingwi Njuguni,TZ5402121,2052 ,984 ,1068 ,2052 ,984 ,0 ,0 ,0 ,1068 
United Republic of Tanzania,Jamhuri ya Muungano wa Tanzania,TZ,Kaskazini Pemba,TZ54,Micheweni,TZ5402,Shumba Mjini,TZ5402131,4763 ,2412 ,2351 ,4763 ,2412 ,0 ,0 ,0 ,2351 
United Republic of Tanzania,Jamhuri ya Muungano wa Tanzania,TZ,Kaskazini Pemba,TZ54,Micheweni,TZ5402,Majenzi,TZ5402142,2370 ,1166 ,1204 ,0 ,0 ,2370 ,1166 ,1204 ,0 
United Republic of Tanzania,Jamhuri ya Muungano wa Tanzania,TZ,Kaskazini Pemba,TZ54,Micheweni,TZ5402,Mjini Wingwi,TZ5402151,4521 ,2305 ,2216 ,4521 ,2305 ,0 ,0 ,0 ,2216 
United Republic of Tanzania,Jamhuri ya Muungano wa Tanzania,TZ,Kaskazini Pemba,TZ54,Micheweni,TZ5402,Msuka Magharibi,TZ5402161,4274 ,2094 ,2180 ,4274 ,2094 ,0 ,0 ,0 ,2180 
United Republic of Tanzania,Jamhuri ya Muungano wa Tanzania,TZ,Kaskazini Pemba,TZ54,Micheweni,TZ5402,Chimba,TZ5402171,3080 ,1567 ,1513 ,3080 ,1567 ,0 ,0 ,0 ,1513 
United Republic of Tanzania,Jamhuri ya Muungano wa Tanzania,TZ,Kaskazini Pemba,TZ54,Micheweni,TZ5402,Tumbe Magharibi,TZ5402181,4228 ,2077 ,2151 ,4228 ,2077 ,0 ,0 ,0 ,2151 
United Republic of Tanzania,Jamhuri ya Muungano wa Tanzania,TZ,Kaskazini Pemba,TZ54,Micheweni,TZ5402,Sizini,TZ5402191,5284 ,2586 ,2698 ,5284 ,2586 ,0 ,0 ,0 ,2698 
United Republic of Tanzania,Jamhuri ya Muungano wa Tanzania,TZ,Kaskazini Pemba,TZ54,Micheweni,TZ5402,Kinyasini,TZ5402201,3188 ,1541 ,1647 ,3188 ,1541 ,0 ,0 ,0 ,1647 
United Republic of Tanzania,Jamhuri ya Muungano wa Tanzania,TZ,Kaskazini Pemba,TZ54,Micheweni,TZ5402,Mihogoni,TZ5402211,2596 ,1259 ,1337 ,2596 ,1259 ,0 ,0 ,0 ,1337 
United Republic of Tanzania,Jamhuri ya Muungano wa Tanzania,TZ,Kaskazini Pemba,TZ54,Micheweni,TZ5402,Kifundi,TZ5402221,2796 ,1363 ,1433 ,2796 ,1363 ,0 ,0 ,0 ,1433 
United Republic of Tanzania,Jamhuri ya Muungano wa Tanzania,TZ,Kaskazini Pemba,TZ54,Micheweni,TZ5402,Maziwa Ng'ombe,TZ5402231,5820 ,2859 ,2961 ,5820 ,2859 ,0 ,0 ,0 ,2961 
United Republic of Tanzania,Jamhuri ya Muungano wa Tanzania,TZ,Kaskazini Pemba,TZ54,Micheweni,TZ5402,Tondooni,TZ5402241,2705 ,1335 ,1370 ,2705 ,1335 ,0 ,0 ,0 ,1370 
United Republic of Tanzania,Jamhuri ya Muungano wa Tanzania,TZ,Kaskazini Pemba,TZ54,Micheweni,TZ5402,Mtemani,TZ5402251,3017 ,1461 ,1556 ,3017 ,1461 ,0 ,0 ,0 ,1556 
United Republic of Tanzania,Jamhuri ya Muungano wa Tanzania,TZ,Kaskazini Pemba,TZ54,Micheweni,TZ5402,Wingwi Mjananza,TZ5402261,1702 ,856 ,846 ,1702 ,856 ,0 ,0 ,0 ,846 
United Republic of Tanzania,Jamhuri ya Muungano wa Tanzania,TZ,Kaskazini Pemba,TZ54,Micheweni,TZ5402,Mlindo,TZ5402271,2096 ,1008 ,1088 ,2096 ,1008 ,0 ,0 ,0 ,1088 
United Republic of Tanzania,Jamhuri ya Muungano wa Tanzania,TZ,Kusini Pemba,TZ55,Chake Chake,TZ5501,Chanjaani,TZ5501013,3311 ,1560 ,1751 ,448 ,209 ,2863 ,1351 ,1512 ,239 
United Republic of Tanzania,Jamhuri ya Muungano wa Tanzania,TZ,Kusini Pemba,TZ55,Chake Chake,TZ5501,Wawi,TZ5501021,5615 ,2690 ,2925 ,5615 ,2690 ,0 ,0 ,0 ,2925 
United Republic of Tanzania,Jamhuri ya Muungano wa Tanzania,TZ,Kusini Pemba,TZ55,Chake Chake,TZ5501,Pujini,TZ5501031,4066 ,1980 ,2086 ,4066 ,1980 ,0 ,0 ,0 ,2086 
United Republic of Tanzania,Jamhuri ya Muungano wa Tanzania,TZ,Kusini Pemba,TZ55,Chake Chake,TZ5501,Ziwani,TZ5501041,4023 ,1892 ,2131 ,4023 ,1892 ,0 ,0 ,0 ,2131 
United Republic of Tanzania,Jamhuri ya Muungano wa Tanzania,TZ,Kusini Pemba,TZ55,Chake Chake,TZ5501,Ndagoni,TZ5501051,3905 ,1875 ,2030 ,3905 ,1875 ,0 ,0 ,0 ,2030 
United Republic of Tanzania,Jamhuri ya Muungano wa Tanzania,TZ,Kusini Pemba,TZ55,Chake Chake,TZ5501,Kwale,TZ5501061,3780 ,1835 ,1945 ,3780 ,1835 ,0 ,0 ,0 ,1945 
United Republic of Tanzania,Jamhuri ya Muungano wa Tanzania,TZ,Kusini Pemba,TZ55,Chake Chake,TZ5501,Vitongoji,TZ5501071,4517 ,2175 ,2342 ,4517 ,2175 ,0 ,0 ,0 ,2342 
United Republic of Tanzania,Jamhuri ya Muungano wa Tanzania,TZ,Kusini Pemba,TZ55,Chake Chake,TZ5501,Ng'ambwa,TZ5501083,6133 ,2901 ,3232 ,2429 ,1205 ,3704 ,1696 ,2008 ,1224 
United Republic of Tanzania,Jamhuri ya Muungano wa Tanzania,TZ,Kusini Pemba,TZ55,Chake Chake,TZ5501,Shungi,TZ5501091,2488 ,1235 ,1253 ,2488 ,1235 ,0 ,0 ,0 ,1253 
United Republic of Tanzania,Jamhuri ya Muungano wa Tanzania,TZ,Kusini Pemba,TZ55,Chake Chake,TZ5501,Chonga,TZ5501101,3319 ,1560 ,1759 ,3319 ,1560 ,0 ,0 ,0 ,1759 
United Republic of Tanzania,Jamhuri ya Muungano wa Tanzania,TZ,Kusini Pemba,TZ55,Chake Chake,TZ5501,Mgelema,TZ5501111,1250 ,640 ,610 ,1250 ,640 ,0 ,0 ,0 ,610 
United Republic of Tanzania,Jamhuri ya Muungano wa Tanzania,TZ,Kusini Pemba,TZ55,Chake Chake,TZ5501,Kilindi,TZ5501121,3947 ,1923 ,2024 ,3947 ,1923 ,0 ,0 ,0 ,2024 
United Republic of Tanzania,Jamhuri ya Muungano wa Tanzania,TZ,Kusini Pemba,TZ55,Chake Chake,TZ5501,Tibirinzi,TZ5501132,4041 ,1923 ,2118 ,0 ,0 ,4041 ,1923 ,2118 ,0 
United Republic of Tanzania,Jamhuri ya Muungano wa Tanzania,TZ,Kusini Pemba,TZ55,Chake Chake,TZ5501,Chachani,TZ5501142,974 ,467 ,507 ,0 ,0 ,974 ,467 ,507 ,0 
United Republic of Tanzania,Jamhuri ya Muungano wa Tanzania,TZ,Kusini Pemba,TZ55,Chake Chake,TZ5501,Wara,TZ5501152,3930 ,1765 ,2165 ,0 ,0 ,3930 ,1765 ,2165 ,0 
United Republic of Tanzania,Jamhuri ya Muungano wa Tanzania,TZ,Kusini Pemba,TZ55,Chake Chake,TZ5501,Mvumoni,TZ5501161,2463 ,1141 ,1322 ,2463 ,1141 ,0 ,0 ,0 ,1322 
United Republic of Tanzania,Jamhuri ya Muungano wa Tanzania,TZ,Kusini Pemba,TZ55,Chake Chake,TZ5501,Matale,TZ5501171,3912 ,1970 ,1942 ,3912 ,1970 ,0 ,0 ,0 ,1942 
United Republic of Tanzania,Jamhuri ya Muungano wa Tanzania,TZ,Kusini Pemba,TZ55,Chake Chake,TZ5501,Wesha,TZ5501181,3893 ,1874 ,2019 ,3893 ,1874 ,0 ,0 ,0 ,2019 
United Republic of Tanzania,Jamhuri ya Muungano wa Tanzania,TZ,Kusini Pemba,TZ55,Chake Chake,TZ5501,Uwandani,TZ5501191,2632 ,1282 ,1350 ,2632 ,1282 ,0 ,0 ,0 ,1350 
United Republic of Tanzania,Jamhuri ya Muungano wa Tanzania,TZ,Kusini Pemba,TZ55,Chake Chake,TZ5501,Madungu,TZ5501202,4252 ,1943 ,2309 ,0 ,0 ,4252 ,1943 ,2309 ,0 
United Republic of Tanzania,Jamhuri ya Muungano wa Tanzania,TZ,Kusini Pemba,TZ55,Chake Chake,TZ5501,Mgogoni,TZ5501211,2598 ,1209 ,1389 ,2598 ,1209 ,0 ,0 ,0 ,1389 
United Republic of Tanzania,Jamhuri ya Muungano wa Tanzania,TZ,Kusini Pemba,TZ55,Chake Chake,TZ5501,Dodo,TZ5501221,4268 ,2110 ,2158 ,4268 ,2110 ,0 ,0 ,0 ,2158 
United Republic of Tanzania,Jamhuri ya Muungano wa Tanzania,TZ,Kusini Pemba,TZ55,Chake Chake,TZ5501,Mbuzini,TZ5501231,2919 ,1428 ,1491 ,2919 ,1428 ,0 ,0 ,0 ,1491 
United Republic of Tanzania,Jamhuri ya Muungano wa Tanzania,TZ,Kusini Pemba,TZ55,Chake Chake,TZ5501,Michungwani,TZ5501241,2457 ,1208 ,1249 ,2457 ,1208 ,0 ,0 ,0 ,1249 
United Republic of Tanzania,Jamhuri ya Muungano wa Tanzania,TZ,Kusini Pemba,TZ55,Chake Chake,TZ5501,Kibokoni,TZ5501251,2584 ,1263 ,1321 ,2584 ,1263 ,0 ,0 ,0 ,1321 
United Republic of Tanzania,Jamhuri ya Muungano wa Tanzania,TZ,Kusini Pemba,TZ55,Chake Chake,TZ5501,Kichungwani,TZ5501262,2158 ,959 ,1199 ,0 ,0 ,2158 ,959 ,1199 ,0 
United Republic of Tanzania,Jamhuri ya Muungano wa Tanzania,TZ,Kusini Pemba,TZ55,Chake Chake,TZ5501,Msingini,TZ5501272,2305 ,1025 ,1280 ,0 ,0 ,2305 ,1025 ,1280 ,0 
United Republic of Tanzania,Jamhuri ya Muungano wa Tanzania,TZ,Kusini Pemba,TZ55,Chake Chake,TZ5501,Mkoroshoni,TZ5501282,3473 ,1596 ,1877 ,0 ,0 ,3473 ,1596 ,1877 ,0 
United Republic of Tanzania,Jamhuri ya Muungano wa Tanzania,TZ,Kusini Pemba,TZ55,Chake Chake,TZ5501,Mfikiwa,TZ5501291,2036 ,982 ,1054 ,2036 ,982 ,0 ,0 ,0 ,1054 
United Republic of Tanzania,Jamhuri ya Muungano wa Tanzania,TZ,Kusini Pemba,TZ55,Mkoani,TZ5502,Ng'ombeni,TZ5502012,3159 ,1507 ,1652 ,0 ,0 ,3159 ,1507 ,1652 ,0 
United Republic of Tanzania,Jamhuri ya Muungano wa Tanzania,TZ,Kusini Pemba,TZ55,Mkoani,TZ5502,Makombeni,TZ5502021,1846 ,858 ,988 ,1846 ,858 ,0 ,0 ,0 ,988 
United Republic of Tanzania,Jamhuri ya Muungano wa Tanzania,TZ,Kusini Pemba,TZ55,Mkoani,TZ5502,Makoongwe,TZ5502031,1453 ,705 ,748 ,1453 ,705 ,0 ,0 ,0 ,748 
United Republic of Tanzania,Jamhuri ya Muungano wa Tanzania,TZ,Kusini Pemba,TZ55,Mkoani,TZ5502,Shidi,TZ5502041,982 ,481 ,501 ,982 ,481 ,0 ,0 ,0 ,501 
United Republic of Tanzania,Jamhuri ya Muungano wa Tanzania,TZ,Kusini Pemba,TZ55,Mkoani,TZ5502,Mkanyageni,TZ5502051,3168 ,1465 ,1703 ,3168 ,1465 ,0 ,0 ,0 ,1703 
United Republic of Tanzania,Jamhuri ya Muungano wa Tanzania,TZ,Kusini Pemba,TZ55,Mkoani,TZ5502,Michenzani,TZ5502061,2932 ,1393 ,1539 ,2932 ,1393 ,0 ,0 ,0 ,1539 
United Republic of Tanzania,Jamhuri ya Muungano wa Tanzania,TZ,Kusini Pemba,TZ55,Mkoani,TZ5502,Chokocho,TZ5502071,4539 ,2221 ,2318 ,4539 ,2221 ,0 ,0 ,0 ,2318 
United Republic of Tanzania,Jamhuri ya Muungano wa Tanzania,TZ,Kusini Pemba,TZ55,Mkoani,TZ5502,Kisiwa Panza,TZ5502081,3087 ,1534 ,1553 ,3087 ,1534 ,0 ,0 ,0 ,1553 
United Republic of Tanzania,Jamhuri ya Muungano wa Tanzania,TZ,Kusini Pemba,TZ55,Mkoani,TZ5502,Kangani,TZ5502091,3995 ,1911 ,2084 ,3995 ,1911 ,0 ,0 ,0 ,2084 
United Republic of Tanzania,Jamhuri ya Muungano wa Tanzania,TZ,Kusini Pemba,TZ55,Mkoani,TZ5502,Kengeja,TZ5502103,6967 ,3253 ,3714 ,6217 ,2896 ,750 ,357 ,393 ,3321 
United Republic of Tanzania,Jamhuri ya Muungano wa Tanzania,TZ,Kusini Pemba,TZ55,Mkoani,TZ5502,Muambe,TZ5502111,6662 ,3260 ,3402 ,6662 ,3260 ,0 ,0 ,0 ,3402 
United Republic of Tanzania,Jamhuri ya Muungano wa Tanzania,TZ,Kusini Pemba,TZ55,Mkoani,TZ5502,Kiwani,TZ5502121,3026 ,1491 ,1535 ,3026 ,1491 ,0 ,0 ,0 ,1535 
United Republic of Tanzania,Jamhuri ya Muungano wa Tanzania,TZ,Kusini Pemba,TZ55,Mkoani,TZ5502,Mtambile,TZ5502133,4890 ,2299 ,2591 ,3744 ,1779 ,1146 ,520 ,626 ,1965 
United Republic of Tanzania,Jamhuri ya Muungano wa Tanzania,TZ,Kusini Pemba,TZ55,Mkoani,TZ5502,Mizingani,TZ5502141,1628 ,825 ,803 ,1628 ,825 ,0 ,0 ,0 ,803 
United Republic of Tanzania,Jamhuri ya Muungano wa Tanzania,TZ,Kusini Pemba,TZ55,Mkoani,TZ5502,Ngwachani,TZ5502151,3110 ,1501 ,1609 ,3110 ,1501 ,0 ,0 ,0 ,1609 
United Republic of Tanzania,Jamhuri ya Muungano wa Tanzania,TZ,Kusini Pemba,TZ55,Mkoani,TZ5502,Chambani,TZ5502161,6096 ,2984 ,3112 ,6096 ,2984 ,0 ,0 ,0 ,3112 
United Republic of Tanzania,Jamhuri ya Muungano wa Tanzania,TZ,Kusini Pemba,TZ55,Mkoani,TZ5502,Wambaa,TZ5502171,3271 ,1608 ,1663 ,3271 ,1608 ,0 ,0 ,0 ,1663 
United Republic of Tanzania,Jamhuri ya Muungano wa Tanzania,TZ,Kusini Pemba,TZ55,Mkoani,TZ5502,Mbuguani,TZ5502183,1725 ,832 ,893 ,613 ,315 ,1112 ,517 ,595 ,298 
United Republic of Tanzania,Jamhuri ya Muungano wa Tanzania,TZ,Kusini Pemba,TZ55,Mkoani,TZ5502,Uweleni,TZ5502192,2539 ,1192 ,1347 ,0 ,0 ,2539 ,1192 ,1347 ,0 
United Republic of Tanzania,Jamhuri ya Muungano wa Tanzania,TZ,Kusini Pemba,TZ55,Mkoani,TZ5502,Mtangani,TZ5502201,3198 ,1621 ,1577 ,3198 ,1621 ,0 ,0 ,0 ,1577 
United Republic of Tanzania,Jamhuri ya Muungano wa Tanzania,TZ,Kusini Pemba,TZ55,Mkoani,TZ5502,Ukutini,TZ5502211,2747 ,1299 ,1448 ,2747 ,1299 ,0 ,0 ,0 ,1448 
United Republic of Tanzania,Jamhuri ya Muungano wa Tanzania,TZ,Kusini Pemba,TZ55,Mkoani,TZ5502,Chumbageni,TZ5502221,2579 ,1328 ,1251 ,2579 ,1328 ,0 ,0 ,0 ,1251 
United Republic of Tanzania,Jamhuri ya Muungano wa Tanzania,TZ,Kusini Pemba,TZ55,Mkoani,TZ5502,Mbuyuni,TZ5502232,1883 ,932 ,951 ,0 ,0 ,1883 ,932 ,951 ,0 
United Republic of Tanzania,Jamhuri ya Muungano wa Tanzania,TZ,Kusini Pemba,TZ55,Mkoani,TZ5502,Stahabu,TZ5502241,2369 ,1132 ,1237 ,2369 ,1132 ,0 ,0 ,0 ,1237 
United Republic of Tanzania,Jamhuri ya Muungano wa Tanzania,TZ,Kusini Pemba,TZ55,Mkoani,TZ5502,Kuukuu,TZ5502251,2126 ,1029 ,1097 ,2126 ,1029 ,0 ,0 ,0 ,1097 
United Republic of Tanzania,Jamhuri ya Muungano wa Tanzania,TZ,Kusini Pemba,TZ55,Mkoani,TZ5502,Mjimbini,TZ5502261,2406 ,1172 ,1234 ,2406 ,1172 ,0 ,0 ,0 ,1234 
United Republic of Tanzania,Jamhuri ya Muungano wa Tanzania,TZ,Kusini Pemba,TZ55,Mkoani,TZ5502,Shamiani,TZ5502271,951 ,469 ,482 ,951 ,469 ,0 ,0 ,0 ,482 
United Republic of Tanzania,Jamhuri ya Muungano wa Tanzania,TZ,Kusini Pemba,TZ55,Mkoani,TZ5502,Jombwe,TZ5502281,3013 ,1534 ,1479 ,3013 ,1534 ,0 ,0 ,0 ,1479 
United Republic of Tanzania,Jamhuri ya Muungano wa Tanzania,TZ,Kusini Pemba,TZ55,Mkoani,TZ5502,Kendwa,TZ5502291,4495 ,2161 ,2334 ,4495 ,2161 ,0 ,0 ,0 ,2334 
United Republic of Tanzania,Jamhuri ya Muungano wa Tanzania,TZ,Kusini Pemba,TZ55,Mkoani,TZ5502,Minazini,TZ5502301,1463 ,722 ,741 ,1463 ,722 ,0 ,0 ,0 ,741 
United Republic of Tanzania,Jamhuri ya Muungano wa Tanzania,TZ,Kusini Pemba,TZ55,Mkoani,TZ5502,Mgagadu,TZ5502311,2328 ,1182 ,1146 ,2328 ,1182 ,0 ,0 ,0 ,1146 
United Republic of Tanzania,Jamhuri ya Muungano wa Tanzania,TZ,Kusini Pemba,TZ55,Mkoani,TZ5502,Mkungu,TZ5502321,1372 ,664 ,708 ,1372 ,664 ,0 ,0 ,0 ,708 
United Republic of Tanzania,Jamhuri ya Muungano wa Tanzania,TZ,Kusini Pemba,TZ55,Mkoani,TZ5502,Changaweni,TZ5502333,1862 ,895 ,967 ,936 ,445 ,926 ,450 ,476 ,491 
